провинциа: провинциал
ру: ру
банк: банке
велосипед: велосипед
понима: понимаешь
расскаж: расскажу
домочадц: домочадцы
рассказ: рассказ рассказа
стат: стать статье статьи
стар: старую
рабоч: рабочий
стал: стали
мнен: мнение
вуз: вузов
объясн: объясни
работ: работа работе работы работу
показыва: показывать
зубок: зубок
будьт: будьте
впечатлен: впечатлением
получен: получения
пол: полях
инфраструктур: инфраструктуру инфраструктура
сто: стоит
размеща: размещаем
тб: тб
резолв: резолвятся
критическ: критически
те: тесь
менеджмент: менеджмент
интеграц: интеграцию
разговор: разговор разговоре
стекля: стеклянная
морск: морской
мобильн: мобильных
знакомств: знакомство
теплоносител: теплоносителя
отписа: отписаться
публикац: публикации
скопирова: скопировать
подел: поделиться
благодар: благодаря
котор: которое которому которыми
владелец: владелец
пор: порой
эксперимент: эксперименты
блад: блада
ум: умом
шаг: шаг
уча: учащихся
связа: связанные
обратн: обратную
подкручива: подкручивали
уч: учи
либ: либо
проект: проекте проекты проект проекта проектами
подстав: подставить
связ: связь
недовольн: недовольных
драт: драться
вперв: впервые
относительн: относительному
профил: профиль
дела: делает делать
байт: байт
ребят: ребята
кумулятивн: кумулятивный
верн: верн
устоя: устоявшемся
полага: полагающимися
читальн: читальный
верс: версии версию версия
маркетинг: маркетинг
книг: книг
разобра: разобравшись разобраться
проснул: проснулся
прост: простой простом простые
врем: времена
зал: зал
проверк: проверке
занима: занимаются занимается занимались
ложн: ложное
предупред: предупредить
встреч: встречах
лиц: лицам
совместим: совместимости совместимость
разумеет: разумеется
псб: псб
уровен: уровень
нов: новый нового новой новые новым новое
умеет: умеет
медийн: медийная
част: часть части частью
устро: устроена
невесом: невесомости
слов: словом
микрофронтенд: микрофронтенды микрофронтендах
реплик: реплике
привнес: привнес
модерац: модерации
кана: канал
постоя: постоянно
парен: парень
нны: нные
системн: системное
сдела: сделай сделали сделать сделаю сделал
определен: определения
досуг: досуг
сложн: сложный сложных сложной
демонстрир: демонстрирующий
обманут: обмануть
примен: применить
пут: пути путем
штук: штука
пример: примеров пример примере
хранилищ: хранилища хранилище
посмея: посмеялись
систем: системы системой
персонаж: персонажу персонажи
невероятн: невероятно
узна: узнали узнаем
частн: частных
курс: курса
облада: обладающие
читател: читатель
немедлен: немедленно
машин: машину машинное
лидер: лидер
метод: метод
процесс: процесс
групп: групп группах
приведет: приведет
размест: разместить
нововведен: нововведения
противн: противном
продолжа: продолжаем
подряд: подряд
помоч: помочь
бесплатн: бесплатно
ловк: ловко
помощ: помощью
современ: современных современная
приложен: приложений приложения
спойлер: спойлер спойлеров
разработчик: разработчиком
харизматичн: харизматичный
здоров: здоровье
чувак: чуваки
текст: тексте текста
оговорк: оговорки
будущ: будущее будущем
единожд: единожды
регулирован: регулирование
спокойн: спокойно
прочита: прочитали
интерес: интересам
мнительн: мнительным
пожал: пожалуй
картинк: картинки
закон: законом
легендарн: легендарный
регистрац: регистрация регистрации
фыркан: фырканьем
студенческ: студенческих
найден: найденных
гипотез: гипотез гипотезами
фирм: фирма
поисков: поисковые поисковую
цикл: цикл циклы
каза: казалось
эффект: эффект
счита: считается
причин: причина
цел: целый целом
помня: помнящие
каннингем: каннингема
ослыша: ослышались
кажд: каждой
человечеств: человечества
техлид: техлид
настро: настроить
выходн: выходными
дзен: дзен
множеств: множество
взаимодейств: взаимодействие взаимодействия
сегментац: сегментация
эх: эх
создава: создавать
искусствен: искусственный
отличн: отличная
серьезн: серьезные
использова: использовать
прекрасн: прекрасным
потонет: потонет
достаточн: достаточно
повседневн: повседневных
пройт: пройти
примерн: примерный
указател: указателей
сюд: сюда
список: список
затронул: затронули
фотореалистичн: фотореалистичные
повыша: повышаются
организац: организации организация
дизайн: дизайн дизайне
жарк: жарко
совершенствова: совершенствовать
производительн: производительность
концепц: концепций
попыта: попытаемся
попробова: попробовать
клиент: клиентом клиент клиентов
коротк: короткий
так: такими такого таких таким
общен: общению
сним: снимая
баг: багов
техническ: техническая технических
условн: условному
хран: хранить
фев: фев
заметк: заметки
собира: собирался
бая: баяны
некотор: некоторых некоторые
застав: заставить заставит
рассмотр: рассмотрим рассмотрев
подума: подумал
количеств: количество
соглашен: соглашение
гер: герой
добав: добавил добавить
просмотр: просмотров
содержат: содержат
содержан: содержание
сферическ: сферический
абзац: абзаца
самонаполня: самонаполняемых
цысин: цысиня
интеллект: интеллект
напост: напостили
железн: железную
кластер: кластера
компан: компаний компании
ограничен: ограничения ограничений
программ: программа программы
вчер: вчера
ежедневн: ежедневная ежедневно
действ: действия действий
главн: главная
воздух: воздуха
фундаментальн: фундаментальных
обеспечива: обеспечивает
фич: фичи
привет: привет
йазыгг: йазыгга
недоразвит: недоразвитым
изуч: изучили
созда: создают создается
магазин: магазинов
ран: ранее
кейс: кейс
отдельн: отдельных
гик: гиков гики
интернет: интернет интернета интернете
пилотир: пилотирует
помещен: помещении
бегл: бегло
оптимизац: оптимизация оптимизацию оптимизации
тем: тема тему
применя: применяемым
администрирован: администрирование
знат: знать
приглашен: приглашение
контроллер: контроллера
знан: знаний
комментар: комментарии
сотрудник: сотрудников
прош: прошу
компьютер: компьютере
работа: работаю работает работать
вейер: вейера
продемонстрир: продемонстрирует
песочниц: песочницы песочница
услуг: услуги
резюмир: резюмирую
капита: капитан капитана
выкл: выкл
заинтересова: заинтересованным
высококачествен: высококачественного
блог: блоги блог
необходим: необходимости необходимы
автоматизац: автоматизации
разрез: разрезе
интерфейс: интерфейсы
модел: модели
сложност: сложности
вниман: внимания
автор: авторы авторов автором
снижа: снижается
очеред: очередь
чита: читать читайте читали
остр: острым
локальн: локально
положен: положение
приключен: приключения
температур: температуру температуре
казахста: казахстан
завыш: завышены
тестирован: тестирование тестирования
эксперт: эксперт
тип: типов
перезагружа: перезагружать
характеристик: характеристики характеристикам
удобств: удобство
реш: решил
общ: общем общих общий
объ: объем
недостатк: недостатки
самообслуживан: самообслуживании
геймд: геймдев
поддержива: поддерживать поддерживающими
майкрософт: майкрософт
серг: сергей
удобн: удобно
фантастик: фантастика фантастики
сред: среды
разбирательств: разбирательство
может: можете
редактор: редакторы редакторов
мног: многие многими
люб: любят любое
зависим: зависимостей
хостинг: хостинг
язык: языке языка
происходя: происходящее
ботаник: ботаники
гот: готов
разн: разные
освоен: освоения
отправк: отправки
использу: используем
пакет: пакетов
конкретн: конкретно
открыва: открывать
ожидан: ожидания
сбер: сбер
погруз: погрузились
применен: применения
создан: создания создание
потеря: потерять
вывод: вывода
облак: облаке
прич: причем
конвейер: конвейера конвейеру
волк: волк
запис: записи
любимц: любимцы
финтех: финтех
одн: одна одним
мам: мамы
настольн: настольные
реклам: рекламе реклама рекламы
псевдоним: псевдонима
разбер: разбер разберу
неприемлем: неприемлемо
корпоративн: корпоративных корпоративный
глубж: глубже
шаблон: шаблоне шаблон
инструмент: инструменты
выда: выдает
итак: итак
ведущ: ведущий
команд: команды команд
плюс: плюсов
ознаком: ознакомиться
объединя: объединяет
стек: стеке
корабл: корабля корабль
микроконтроллер: микроконтроллеров
использован: использование использования использовании
платформ: платформа платформу
запрос: запросов
потрат: потратил потратить потратив потратили
поскольк: поскольку
войт: войти
процессор: процессоры
аккаунт: аккаунт
модератор: модератора
благодарн: благодарны
компиляц: компиляцию компиляцией
холодн: холодно
подробн: подробный
репозитор: репозиторий
рекурс: рекурсию
бот: бота
похож: похожие
политкорректн: политкорректности
вполн: вполне
скача: скачать
располага: располагается
выража: выражаются
яндекс: яндекс
университет: университете
новост: новости новость
существ: существуют
перв: первой первыми
достоинств: достоинств
гайд: гайд
поиск: поиск
основ: основе
образовательн: образовательные
наполня: наполняют
как: какие
определ: определ
эдак: эдакий
зимн: зимним
голос: голосов
содерж: содержит
кат: кат катом
встреча: встречают
прошл: прошлой
высок: высокая высокое
сфер: сфера
форм: форм
браузер: браузером браузера браузеров браузеры
продукт: продуктом продуктов продукте продукт продукту
улучшен: улучшений
признак: признаки
рекоменд: рекомендую
найт: найти
провер: проверили
приближ: приближен
информацион: информационная
образ: образ
независим: независимо
ввод: ввода
свалива: сваливается
учет: учетом
дорог: дорогой
предлага: предлагаем
геро: героем героями
появ: появилось появилась появившееся появившиеся
призва: призвать
случа: случае
наподоб: наподобие
практическ: практического практически
доступ: доступом
свал: свалившись
вернут: вернуться
бесконечн: бесконечного
принос: приносила
подсознательн: подсознательный
добра: добрались
д: д
вообщ: вообще
дерзк: дерзкий
и: ии
й: й
личност: личности
п: п
парсинг: парсинг парсингом
централизова: централизованной
дава: давайте
интерпретатор: интерпретатора
сезон: сезон
поэт: поэтому
тейлор: тейлора
мин: мин мини
вариант: варианты
одинок: одинокий
памят: памяти
мир: мир
предприят: предприятий
исследован: исследованиях исследования
совершен: совершенно
безопасн: безопасность
этап: этапы
получ: получили получил получился получится
вложен: вложений
публик: публики
перевод: переводили перевод
хост: хосте
важн: важны важно
списк: списка
ищет: ищет
чат: чат
столкнул: столкнулся
внутр: внутри
млн: млн
прям: прямо
ярк: яркие
специфик: специфика специфике
продуктов: продуктовые продуктовый продуктовом
больш: большие
софт: софт
резолвинг: резолвинга
инженер: инженер инженеров инженерами
энд: энди
игр: игр игры
удел: уделить
телегр: телеграм
развернут: развернуть развернутые
устанавлива: устанавливают
бесспорн: бесспорно
смогл: смогли
расшир: расширяя
демографическ: демографическом
представлен: представленных
мог: могу
пыта: пытаешься
переводчик: переводчика
сотн: сотни
фаворит: фавориты
развива: развивают
основн: основным основном основными
дубл: дубли
бонус: бонусом
обойдет: обойдется
привест: привести
дошл: дошла
решен: решение решении решения
владельц: владельцы
биограф: биографии
входн: входных входными
средн: средний
арабелл: арабелла
домашн: домашнем домашняя
вакуум: вакууме
хаб: хабы
сжат: сжатия
ребр: ребром
сидн: сидней
посетител: посетители
изобил: изобилует
результат: результат
банковск: банковская
продвинут: продвинутый
опыт: опыте
настройк: настройка
дал: далее
олбанск: олбанского
пониман: понимания
документ: документы документов
прочтен: прочтение
предложен: предложениям
ссылк: ссылку
зата: затащим
пенсионер: пенсионеры
дам: дам
дан: данные данных данными
эксплойтинг: эксплойтинг эксплойтинга
дизайнер: дизайнер
раскрыт: раскрытия
код: кода код кодом
осторожн: осторожны
повред: повредить
вредн: вредное
мемасик: мемасики
героическ: героические
обновля: обновлять
формирован: формирование
функц: функции
отказа: отказаться
мся: мся
наруш: нарушить
стреля: стрелять
шахт: шахтах
доступн: доступны доступность
возраст: возраст
оцен: оценить
наруж: наружу
полин: полина
уход: уходя
протагонист: протагонистами
разбор: разбор
превед: превед
ошибк: ошибками ошибка
обнов: обновить обновили обновил обновиться
гончаренк: гончаренко
объект: объекты
разработк: разработкой разработка разработки
закладк: закладки
разработа: разработать
богда: богдан
пуглив: пугливым
продолжен: продолжением
программн: программного программное
руководств: руководстве руководство
релиз: релиз релизе
гарантир: гарантирует
пост: постят посте пост
итог: итоге
практичн: практичным
обеспеч: обеспечить
дел: деле
ближайш: ближайшем ближайшие
рассказа: рассказать
деннис: денниса
внедря: внедрять
внутрен: внутреннего внутреннюю
устройств: устройствами устройство устройств
пришел: пришел
размер: размеров
неудачн: неудачным
купон: купоны
ваш: вашего
ответ: ответом ответил ответ ответов ответы
изучен: изучение
порт: порту порт
семейн: семейное семейные
дельт: дельта
покупк: покупки
алгоритм: алгоритм
дет: дети
снимк: снимков
слыша: слышали
поднима: поднималась
минус: минусов
мегапроект: мегапроекты
стипендиат: стипендиаты
хабр: хабре хабр
разочарован: разочарования
обучен: обучение
бинг: бинг бингом
обща: общается
район: районе
эксплойт: эксплойтить
практик: практики практике
сам: самые самый
качествен: качественно качественных
фантастическ: фантастических
стартап: стартапов стартапам стартапа
туториа: туториал
лентя: лентяй
возлага: возлагал
потребител: потребитель
подобн: подобные
вероятн: вероятно
тыжинженер: тыжинженер
управлен: управление
вед: веду
кирк: кирк
смысл: смысле
вс: вс
популярн: популярным
обивк: обивку
начн: начнем
научн: научное научная научными
фигурирова: фигурировали
поэкспериментирова: поэкспериментировать
сво: сво своим свой
веб: веб
программирован: программирование
нача: начать
реша: решать решает
рисеч: рисече
порог: порог
станов: становятся становится
гк: гк
стипенд: стипендию
явля: являются
появлен: появлению появление
вещ: вещей
старожил: старожилы
развит: развитие
спаст: спасти
компилятор: компилятора
нестабильн: нестабильно
сайт: сайта сайты сайтов
обеспечен: обеспечения обеспечение
научпоп: научпоп
технолог: технологии
предсто: предстоит
задач: задачи задача задач задачей
файл: файлов файлы файлами
спаса: спасайтесь
различн: различные различными
поеха: поехали
сегодняшн: сегодняшнего сегодняшнем
пар: пары пару
тред: тред
базов: базовые
треб: требуют
задума: задумано
истор: историй истории
зовут: зовут
довер: доверие
мышлен: мышление
прова: провал
пробл: проблему
ещ: ещ
сет: сети
конфиденциальн: конфиденциальность
регулятор: регулятор
поляк: поляков
повтор: повтора
урок: уроки уроку
хот: хотим
зябк: зябко
позволя: позволяет
дне: дней
хоч: хочу
неоднократн: неоднократно
дни: дни
рейтинг: рейтинга рейтинг
дом: доме дома
вкл: вкл
способн: способной
структурирова: структурированы
поток: потоки
кратк: кратко
поддержк: поддержка
призна: признаюсь
глубок: глубокими
дня: дня
принцип: принцип
библиотек: библиотеке
пуст: пусть
ид: идей
комплексн: комплексные комплексных
предупрежден: предупреждение
предыдущ: предыдущем предыдущего
ин: иной
наш: нашего нашем
пользовател: пользователи пользователей
плат: платит
авторск: авторский
над: надеюсь
умн: умного
затрат: затрат
сервис: сервисы сервисов
встава: вставала
информац: информацией информация информации
погон: погони
описа: описаны описанных
восторг: восторге
облачн: облачном облачные
английск: английскому
сборк: сборки сборкой
поводок: поводок
бессерверн: бессерверного бессерверным
обработк: обработка
хуж: хуже
кт: кт
собра: собрали
бастион: бастион
дворов: дворовый
черт: чертах
например: например
запута: запутаться
мойофис: мойофис
коллег: коллегам
рекомендац: рекомендации
нагрузк: нагрузка
надежд: надежды
запуск: запуск запуска
соответств: соответствует
нативн: нативные
надежн: надежность надежно
огромн: огромное
лад: лад
лю: лю
познан: познаниями
типаж: типаж типажами
сло: слоем слой
рассмотрел: рассмотрели
рассмотрен: рассмотренных
стран: странно
январ: январе
котл: котла котлу
мо: мо моего моему
сист: систему систем
исходн: исходный
сидел: сидели
качеств: качество
медвед: медведа
пил: пилили
лан: ланит
разочарова: разочарованных
проблем: проблемы
соверша: совершают
сервер: серверам сервером
раздел: разделы
стрижет: стрижет
подростк: подростки
маркировк: маркировки
угроз: угрозами
нек: некий
лучш: лучшие
космическ: космического космический
механизм: механизма
крайн: крайне
оп: опыт
возможн: возможности возможностями возможно
молод: молодые
коробк: коробки
высокотехнологичн: высокотехнологичной
воспоминан: воспоминаний
утр: утром
хочет: хочется хочет
луковиц: луковица
крупн: крупных
неполн: неполных
страниц: страницу странице
загруз: загрузить
прежд: прежде
респондент: респондентов
стабильн: стабильную
взглян: взглянем
отпуск: отпуска
изображен: изображений изображения
контент: контент
воспользова: воспользоваться
ошеломительн: ошеломительным
спасител: спасителем
стандартн: стандартный
откр: открыт открыть
источник: источники источниками
studio: studio
big: big
career: career
ruvd: ruvds
devop: devops
pv: pvs
doubletapp: doubletapp
react: react
swiftbook: swiftbook
santri: santry
ajax: ajax
hadi: hadi
robot: robotic
huggingfac: huggingface
twitter: twitter
autom: automation
jit: jit
electron: electronics
gopro: gopro
api: api
vip: vip
beskrovnaya: beskrovnaya
app: app
shape: shape
io: ios
ai: ai
javascript: javascript
opentherm: opentherm
otu: otus
bosch: bosch
alex: alex
maco: macos
tinder: tinder
aw: aws
epam: epam
habr: habr
dataop: dataops
firstvd: firstvds
engin: engineering
ru: ru
visiolog: visiology
smart: smart
mac: mac
youtub: youtube
myoffic: myoffice
stolyarrr: stolyarrr
notion: notion
proqualitycommun: proqualitycommunity
rss: rss
vite: vite
arduino: arduino
web: web
turbofan: turbofan
southbridg: southbridge
protagonist: protagonist
ble: ble
typescript: typescript
shadovv: shadovv
map: map
difuk: difuks
facebook: facebook
systemj: systemjs
store: store
polinakamurko: polinakamurko
gfk: gfk
bing: bing
chat: chat
dodo: dodo
apach: apache
open: open
data: data
dii: diy
dn: dns
dstack: dstack
reactj: reactjs
cloud: cloud
webpack: webpack
vitest: vitest
swift: swift
ux: ux
nginx: nginx
chrome: chrome
selectel: selectel
gpt: gpt
usabl: usability
xcode: xcode
amazon: amazon
servic: services
vk: vk
singlespa: singlespa
boi: boy
scienc: science
ignit: ignition
maxrokatanski: maxrokatansky
arkashaerema: arkashaerema
alexkimen: alexkimen
timeweb: timeweb
minio: minio
hiro: hiro
uxuitelno: uxuitelno
kubernet: kubernetes
wave: wave
warehous: warehouse
hous: house
linux: linux
andreycheptsov: andreycheptsov
stabl: stable
rpa: rpa
process: process
spolyakov: spolyakov
start: starting
telegram: telegram
swiftlint: swiftlint
jest: jest
ipso: ipsos
gatoazul: gatoazul
sparkplug: sparkplug
wedmashka: wedmashka
window: windows
zvava: zvava
diffus: diffusers diffusion
