максимальн: ии
найт: местом
готов: содержавших
фамильн: фамильного
провер: захотел
расскаж: туториале франциско
фактическ: игра
образ: образом
найм: найме занимался
стат: стать статье статьи статья
притесня: притеснял
куша: учесть
обычн: обычный
стар: версии воссоздаем
предлага: решения
гибкост: гибкости
обзор: игр
наподоб: ограничения
последств: катастрофические
реализова: снежинок
работ: работа любит работе работы
абориген: уничтожающая
инвазивн: жаб
показыва: показывать многие
дополнительн: дополнительных
доступ: должен
вернут: поддержка
пол: разрешение
лайка: лайкают
человек: человеком
видеоигр: фильм старой
янв: картам
референс: референсами
менеджмент: менеджмент
и: использовании
перенес: тростника
соискател: произносил
то: хватает
н: настолько
мобильн: типографика
проголосова: смогут
должн: ограничений
суд: невозможно
публикац: разделы пару
скопирова: скопировать
карт: удивляться плиточная географические
график: количества анимация игры сгенерированную
ч: успешной
подел: реализовано
показа: приемлема
поэт: поэтому
котор: слова
ув: контрастность
мин: мин
мир: мире
благ: самые
моделирован: занимаюсь
эксперимент: дальнейшие
миф: преимуществах
исследован: исследование исследования
шаг: нулевой
совершен: ним
связа: мифах должности
прав: н
нестандартн: выглядеть
обратн: обратную
этап: этапе
географическ: необычных телеэфира
метаверс: метаверса
почерпнул: полезного
проект: нативные
связ: связь конференции
ушл: теме
феврал: михаил
литер: форм
профил: профиль
дела: делаем
шутк: шутка
провед: согласно
проектн: проектная
получ: проходили желая
прототип: небольшого
перевод: перевод
верс: вернуться улучшенные
провел: янв
маркетинг: маркетинг
списк: среди
разобра: подробно
воспроизведен: генерацию
час: часов
прост: простой простого
раскр: раскрыть
фидбек: фидбек
позвол: интересно
серпинск: треугольника
справ: интеллект
индустр: игровой предлагает
постро: построил
занима: основном прошлом
тенденц: тенденции
движен: захвата
разумеет: разумеется
метавселен: метавселенных
уровен: уровень
нов: создание графика новые новое
ног: профессию
больш: тся
потенциа: потенциал
медийн: корпоративный
анимац: движения компьютерная
мест: удаленное выбор узким
жаб: тростниковые тростниковых
част: часть части
цифров: цифровом доступность
наклон: творческие
карьер: помоги
осво: хотите
слов: иконки
направлен: популярных какие
игр: задниками персонажа графикой
полезн: расскажу полезное
существен: требует
сдела: мультфильм новичкам
ввид: является
сложн: рендеринге сложный ситуация
пробова: направления
генерац: использовал посмотреть
примен: применить
пут: освоить шаг
ост: фактически
пример: приведу обзор
населен: опросу
систем: система
персонаж: моделируем мере концепты
должност: наймом
полноцен: растеризации
узна: узнаете
момент: данный
формулировк: формулировка
слепот: имеющих наподобие
частн: частных
шрифт: разобрал существует
труд: существенного
основн: отлично двадцати
трудн: правде
сожален: сожалению
популяц: целью
курс: любимых понимании
сможет: приложениями
плиточн: мощнее
ресурс: онлайн
миха: связи
процесс: сосредоточенность советовать
выпуска: например
заказыва: заказывали
окружа: диджитализации
решен: решение смотрим
требован: требования
сахарн: прибыльной
создател: создатели
актуальн: причины
средн: средний
комфортн: комфортный
личн: заключался
нужн: наклонности
обраща: единожды
подряд: подряд
помоч: генерации
меня: меняются
советова: начали
хаб: публикации
перенест: найти
нрав: выражения
скажет: работу
отсортирова: отсортировал
помощ: помощи обучиться интернета
современ: современном моделей
художествен: художественно
востребова: становится
любл: люблю
приложен: приложений сайтами
выполня: выполнять
результат: уклоном противоположным
опыт: делимся
дав: комментарий
рынок: выпускаете
настройк: дзен
вклад: личный
дал: далее
генеративн: компьютерную
произнос: дизайнерские
текст: кодинга
контекст: уверенный
пониман: заключается
сортировк: сортировки
документ: компаний
прочтен: прочтение
ссылк: ссылка ссылку
единожд: ко
иммерсивн: иммерсивность
эволюционирова: язык
считыва: текст
шрифтов: тема
жел: знакомые
имел: имели
франциск: сан
дан: специалисты актуальности позволяющий направлений
удивля: изображений
тростников: привезли двести
векторн: векторный векторных
дизайнер: дизайнером профессия дизайнер ресурсов вклад облегчили
протяжен: выражениями
состоя: февраля
ректангл: стандартных
положительн: получили
код: кода
помог: вовлечения
регистрац: войти
опрос: воз
четырех: интерфейсов
угрожа: жуков
извест: протяжении
ситуац: персонажами
снежинок: серпинского
тума: относится
функц: функциях функций функции функциям
причин: темы
утвержден: ободряющее
используем: используемыми
мся: перенес
противоположн: приводить
цел: целях заключалась жабы
построен: построения
понадоб: сложная
новичк: дав
фраз: карьера
наруш: котором
доступн: обеспечить новой
руководител: почерпнул
дзен: яндекс
множеств: великого
вмест: вместе
взаимодейств: взаимодействия
телеэфир: карта
создава: современные
искусствен: понятно
отличн: нестандартно
обнов: обновить
неумолим: ввиду
типографик: ад принцип
разработк: разработке разработка
закладк: закладки
графическ: графическим графический
использова: использовать дней использовали
логик: формата
уверен: улыбался
ворва: краткое
безусловн: момент
руководств: руководство
примерн: насчитывается
мультфильм: новый
учитыва: учитывают
сюд: сделанный
професс: окружающего ворваться научиться
настоя: мся
гарантир: приходит
преимуществ: расскажем
список: список
юзабилит: провели
пост: видеоигре
знаком: обращались
иконок: литер
психическ: физических
итог: итоги
обеспеч: должны
дек: набором
дел: дело объяснять любом
организац: организация
концепт: сгенерировать
вопрос: волнующий
дизайн: связанные свой языке дизайн курсы
рассказа: рассказать
растаскива: растаскивают
невозможн: контекста
стремительн: неумолимо
заряд: масштабироваться
устройств: информация
приемлем: графику
текстов: стандартным
клиент: пробовали взаимодействовали
доск: доскам
ваш: связанных гарантирует
проход: дизайнеры
так: таких
порт: процессе
нико: никоим
творческ: направить
проектирован: проектирования
адаптирова: адаптироваться файл
баз: базу
техническ: языка
условн: дизайна правила покажу насколько
мощн: гораздо
алгоритм: шрифта алгоритмы алгоритме
фев: фев
заметк: заметке
материал: данном
слыша: слышали
двадцат: индустрии
мегапроект: стартапам
описыва: посте
хабр: хабр
уничтожа: чума
аналитик: аналитика
обучен: места
откуд: понять
некотор: той
ад: шрифтовой
клавиатур: клавиатура
глухот: слепоту слепоты
диджитализац: стремительной
количеств: количество возможного
соглашен: документы
добав: добавить
посмотрет: детства
просмотр: устали просмотров
последн: разрешением
сам: одним годы болезни
сан: состоялась
стро: строится
интеллект: искусственный
захотел: прототипа
учест: утверждение
цветов: цветовых цветовые цветовым
тростник: сахарного
контрастн: типографики
настраива: настраивать
виртуальн: интерфейсам
стартап: программы
туториа: туториал
приход: помощь
жанр: графики
выглядет: карты
правильн: сделать
потребител: потребителей
дизайнерск: готовые
поня: дня
рендеринг: речь
образован: инсайты
абсолютн: ноги
подобн: фракталами
компан: компании сайта
ограничен: имеющий психических
программ: образовательные
масштабирова: логике
нашл: обучения
уважа: уважаю
обеспечива: обеспечивают
велик: помощью
кодинг: темные
привел: своим
ободря: самое
элемент: элемента
вовлечен: лучшего
заключа: влияли становления ч
привет: привет
стандарт: изучив
рубеж: образование
популярн: самых популярное четырех
вс: напрямую
покаж: используем
имеют: населения
визуальн: улучшить
научн: научно
цвет: цветами цвета цветов
изуч: пиксель
улыба: соискатель
окажет: анимаций
имеющ: потребностями числе
объясня: задачу
сво: показывают поделюсь
растеризац: алгоритма
веб: веб
взаимодействова: цель
нача: деле дизайнерам
зарплат: зарплату
специалист: востребованной абсолютно
порог: порог
реализ: любопытно
жоп: жопу
станов: дизайнера
подскаж: подскажу
интернет: контента
необычн: опытом
легион: легион
прода: продавший
треугольник: дизайны
явля: безусловно
игров: смоделировать
узк: окажется
туториал: проблем
тем: публикаций темная темной темную
головокружительн: головокружительной
брендинг: брендинг
полн: полный
администрирован: администрирование
пользовательск: пользовательскую
знат: дайте
сайт: устройство сайтов вашими
сгенерирова: показалось перенести
контрол: контроля
научпоп: научпоп
продолж: продолжим
технолог: технологии
комментар: комментарии оставить
задач: основную
файл: индустрия
пользова: пользоваться
хвата: равно
задан: задания
работа: работаю позволит
сильн: инструменты
смогут: опыт
песочниц: хабы песочницы
долж: продукт
пар: написав
услуг: конфиденциальность
русл: нужное
нном: провед
базов: нарушен
треб: пользователям
блог: блог
необходим: совершенно
истор: визуальную истории
числ: любой
обуч: вопрос
логотип: логотипов логотип
интерфейс: интерфейсы юзабилити рекомендации
модел: генеративных
пробл: когнитивных
сложност: сложности
ещ: вс
вступительн: историю
привед: условны
автор: авторы сюда автором
чита: читать
сет: сети
вид: аборигенные
конфиденциальн: соглашение
виде: содержит
аватар: аватар
разрешен: высоким полноценных
привезл: австралию
корпорац: корпорации
доход: высокий
науч: скажет
тестирован: тестирование
оста: оставшаяся
быстр: понадобится работать
реальност: виртуальной
стрем: стремится
влия: клиенты
хот: русло
тип: подобного
стко: стко
позволя: конвейер
дне: последние
хоч: хочу
рейтинг: рейтинг рейтинга
скорост: скоростью
реч: берется
отрасл: данной
визуализац: визуализации
остав: проголосовать
двест: примерно
поток: потоки
кратк: получить
честн: честно
поддержк: техническая поддержку
смотр: материале
чум: инвазивная
набор: текстовым
трудяг: трудяга
яжепрограммист: яжепрограммист
включ: доступен
дня: ушло
родственник: родственников
родн: родню
принцип: базовый
воссозда: типа
соцпакет: соцпакет
любим: нашли
сосредоточен: добавлены
сред: курсов
социальн: социальные
предыдущ: мобильных
ин: имеют
улучш: помочь
мног: многих процесс
пользовател: доступной пользователей
нулев: начать
темн: адаптированным обожаю улучшения шрифтами
уста: сфере
люб: специалист трудное сможет
успешн: конкретная
потреб: проверить профессии
язык: думать настройка страниц
фон: моделированием
содержа: просмотра
таблиц: таблице
сервис: сервисов
стил: стилей
зафинал: зафиналим
жук: популяции
информац: песочница
катастрофическ: результатам
правд: ключевое
негативн: положительный
ключев: хочется
фрактал: эксперименты
удален: доход
математическ: математических
год: потребуются
использу: возможностях
конкретн: судить
ожидан: ожидания
физическ: глухоту форму
берет: откуда
ко: фразой
парочк: парочку
создан: создания необходимо
особ: включая
ремесленник: ремесленник
конвейер: быстрый
привод: намерения
например: труда
волн: путь
инсайт: конференция
одн: голосование
обожа: дек
мар: мар
дайт: списка
согласн: проблемы
светлот: светлоту
реклам: медийная
настольк: эволюционировал
корпоративн: услуги
понятн: жанре
рекомендац: результат
потребн: особыми
нативн: реклама
расширя: расширять
инструмент: ещ
распространя: виды
смоделирова: персонажей
кошмар: воспроизведения
опиш: опишу
команд: руководитель
насчитыва: австралии
сообществ: сообщества
любопытн: примере выражений
австрал: настоящее портфолио
иконк: считывать
когнитивн: физические глухоты
воз: нному
врод: вроде
использован: описывается потребуется использованием
голосован: дизайну
мо: кошмаров
поскольк: поскольку
горазд: примеров
душ: душу
уклон: популярнейших
стилизац: известен
войт: аккаунт
нечт: нечто
тон: тон
конечн: конечных
аккаунт: лучших
деятельн: деятельность
выбор: правильный
наскольк: быстрее
задник: справится
онлайн: образовательных
насыщен: насыщенность
проблем: когнитивные
подробн: предыдущей
намерен: благие
раздел: регистрация
болезн: распространяющая
половин: половина
выражен: условными условные условных
моделиру: команды
яндекс: мегапроекты
новост: новости
лучш: авторов лучшие видео
существ: увы
перв: первой первую
небольш: любопытного
дума: нравится
формат: ректанглах
относ: последствия
облегч: сильно
крайн: крайне
написа: стандарта
поиск: поиск
возможн: максимально место некоторых возможно
изменен: изменения
интересн: фонов
оп: негативный
дальн: привели
заказчик: заказчиков заказчику
прибыльн: угрожавших
равн: дизайнеров
кида: кидают
планир: планирую
направ: возможность
древ: древа
образовательн: проекты множества
хочет: кушать
как: клиентом
пиксел: полу
детств: моего
голос: голосов
страниц: стилизации странице
смешива: смешивать
содерж: реальности
тся: оста
фильм: вступительный
чьи: чьи
прошл: туманном
высок: отрасли видеоигр
портфол: портит
стабильн: стабильную
втор: вторую
добавл: знать
точн: точная
генеалогическ: генеалогического
наверняк: наверняка
становлен: пути
непрозрачн: непрозрачность
контент: цифрового
изображен: географических
сфер: дизайном
стандартн: тему иконок
откр: открыть
способ: способ
форм: сложных иную
мер: большей
захват: данные
напрям: реализуются
продукт: рынок
компьютерн: заряд старую
улучшен: использования создавать
конференц: рубежом ваших
studio: studio
satur: saturation
big: big
css: css
iskro: iskros
ruvd: ruvds
data: data
cgi: cgi
sfjazz: sfjazz
petr: petr
roman: roman
blender: blender
twitter: twitter
dall: dall
msx: msx
limmm: limmm
ui: ui
function: functions
andrewyaremko: andrewyaremko
roboto: roboto
logo: logo
html: html
adob: adobe
alef: alef
python: python
ux: ux
vovalanz: vovalanz
yolarti: yolarty
usabl: usability
click: click
vd: vds
ar: ar
light: lightness
vk: vk
habr: habr
vr: vr
exif: exif
ru: ru
access: accessibility
olga: olga
color: color
vrchat: vrchat
duhathebest: duhathebest
artkulakov: artkulakov
patientzero: patientzero
altspac: altspace
behanc: behance
sour: sour
point: point
fox: fox
youtub: youtube
vga: vga
akshinm: akshinm
deni: denis
nemesi: nemesis
rss: rss
world: worlds
figma: figma
design: design
rko: rko
midjournei: midjourney
ol: ol
stabl: stable
recroom: recroom
center: center
facebook: facebook
telegram: telegram
pinterest: pinterest
xd: xd
getrend: getrender
mrpi: mrpis
lead: leading
refridger: refridgerator
horizon: horizon
materi: material
tutme: tutmee
ibm: ibm
gigamop: gigamops
zarytskii: zarytskiy
opac: opacity
hue: hue
sketch: sketch
zelenykh: zelenykh
diffus: diffusion
