грамматическ: грамматических
обрат: обратить
пупок: подери
рт: ч
оценк: оценка оценки
говор: говорили
банк: альфа
велосипед: катаясь
расскаж: расскажу расскажем
рассказ: рассказ
америк: америки популярность
копирайт: копирайт
успел: успела
стат: стать статью статье статьи
самокат: гиганта своевременным
стар: вернуться
рабоч: бытовой деталь
стал: стали стало
се: сео
окт: окт
предлага: качественныи
обзор: обзор
стад: стадии
успех: успеха успеху
случа: случай
работ: работы нная
сарычев: сарычевой
рекламн: рекламных
показыва: показывать
дополнительн: дополнительных
карун: каруне
вернут: поддержка
коровк: божья
нейминг: нейминг нейминга
впечатлен: впечатление
получен: получения
принос: ржд
сокраща: сокращай
достигнет: еды
рюкзак: розовым
подчеркнут: подчеркнуть
пренебрежен: пренебрежением
вообщ: вообще
менеджмент: менеджмент
и: ии
л: л
неприятн: неприятное
ожида: приносит
изменя: потребителей
ошибок: ошибок
суд: суду
публикац: разделы
скопирова: скопировать
дава: давайте
скромн: скромного
студент: будучи
попрост: попросту
ч: откуда
логическ: логическому
подел: черкасскии
поэт: поэтому
назван: названии
котор: котором
радуг: улыбка
мин: мин
пос: посыла
присоедин: процессы
креатив: креативами
мир: обстоятельствами
перешл: перешло
писа: писать
впечатл: впечатлена
бум: стартовал
шаг: шагов
вест: вести
прав: авторские авторских правила
безопасн: безопасности
отмет: отметить
внезапн: внезапно
либ: либо
скор: скоро зло
почерпнул: почерпнул
проект: проектов проекта нативные
связ: связи
феврал: февраля
упущен: упущенную
быстро: бум
при: процесса
профил: профиль
дела: делали делаем делать
тренд: тренды
ског: европеи
получ: получила права мучились
подер: рт
причастн: причастных
едет: новость
единорог: маскота
произведен: автору
объявлен: объявлениях объявлений
перевод: перевода перевод
читальн: читальный
верс: старую
важн: важнейших важно
провел: провели
нна: удал
маркетинг: маркетинг маркетинга
книг: книга книги
разобра: разобраться
травл: травлю
экономическ: банкротстве
рук: руками
час: часов
чат: чата
прост: простой
прием: приемов
розов: фирменным
компенсац: штрафы
зал: зал
рубл: штраф
прочест: прочесть
занима: занимается занимаемся
вред: пользе
лиц: правонарушения
отпугнут: отпугнуть
уровен: уровень
хх: хх
нов: новый нового новые новых
придума: придумать
обошл: обошла
действительн: действительности
копирайтинг: копирайтинга
больш: приобр большему
контекстн: контекстная
медийн: корпоративный
приговор: приговорам
част: частое
качественны: россиян
даркстор: модули
цифров: цифровых
счет: счет
партнерств: успешное
устро: устроили
осво: даркстора освоить
слов: слов
охраня: объекты
обладател: обладателем
полезн: полезного полезных полезные полезным полезный
фантаст: фантастов
постоя: постоянно
доставк: доставка экспресс
сдела: сделать лица
стартова: сервиса
доставля: месяц
сложн: сложный сложном
прецедент: немалое
поработа: поработать
представлен: вкусы
реализуем: реализуемо
генерац: генерации
примен: применить
виден: видение
активн: активное
пример: примерами примеры
русск: русскими
операцион: освоив
фигурир: фигурируют
формальн: формальности
ильяхов: ильяхова
инвентаризац: заказа
выход: выходить выходишь
мог: могу
персонаж: второстепенный
правонарушен: совершившие
мод: представления
журналист: журналисты журналистов
узна: узнаем
дополн: дополнить
развива: самокат наблюдения
основн: основных основными
бренд: бренда бренд возникают
путешеств: путешествую
мну: мную
рознично: федеральнои
курс: студентом ускоренныи
читател: читателя
сша: революцию
миха: михаил
процесс: операционные процесс присоединился рабочего ребрендинга
пуска: пускай
требован: требованиях
европ: отличие
решен: консолидирован
хотел: хотелось
написан: написании написанию
спино: рюкзаком
средн: средний
личн: личный технологиям
нужн: нужное нужны
удачн: некоторые
случайн: равны
подряд: подряд
помога: помогает
меня: бренды
хаб: публикации
рынк: глобального рынке развивающимся
дуба: дубае
вечер: продажи
продвижен: продвижения
рисова: рассказано
помощ: помощью
ускоренны: прошел
немал: судебной
приложен: приложений приложения
результат: результат ожидаемые
скандал: скандалу
разработчик: разработчики
опыт: личным опыта
заключ: гору
рынок: рынок
довольн: довольных
настройк: дзен
вклад: сюда
дал: далее
явлен: явление
промышлен: промышленный
текст: текстами текст фильмов тексты
зер: суперваи
альф: билайн
пониман: понимание
будуч: питания
документ: компаний
прочтен: прочтение
будущ: будущее будущие будущую
ссылк: ссылку
нуж: нужен
помножен: помноженная
конкуренц: сразу
штраф: платить получить
франциск: франциско
дан: рабочий
копирайтер: копирайтеру копирайтеры копирайтера
векторн: векторный векторных
дизайнер: дизайнер
коммерц: электронную
состоя: состоялась
закон: прав охраняются
конкурентн: изменения
изложен: изложением
вкус: изменяются
рост: темпы
росс: россии
помог: корпораций
осторожн: осторожно
задумыва: задумывался
модул: инвентаризация
регистрац: войти
неточн: неточности
гражданк: гражданка
достоевск: достоевского
ситуац: ситуации
ребрендинг: ребрендинг предпосылки анализ
гигант: основателеи
второ: каналом
виноват: виноваты виноват
обновля: бага
конкурент: конкурентов
цен: цены
отлича: отличается
фраз: фразы
середин: середины
изуча: начинаю
наруш: июл
человечеств: человечества человечеству
кажд: изучая
руководител: руководитель руководителей
возника: среде
вынужд: граждане
оцен: оценим оценить
патент: патента патент
малоизвестн: малоизвестных
российск: оборот конструирования российской
дзен: яндекс
глобальн: прогнозам
мозгов: мозгового
канал: управлению
директор: директор
искусствен: искусственного искусственный
банкротств: объявила
ошибк: выделить
достич: достичь
обнов: обновить
неверн: неверное
преступлен: преступления
объект: вором ответственности
завершен: завершению
разработк: разработкой разработке разработку разработка
закладк: закладки
графическ: графический
использова: использовать
важ: важен
стратег: стратегии стратеги
муч: ним
экспертн: стремительно
второстепен: единорога
шли: дела
учитыва: учитывать
сюд: изменений
настоя: настоящем
карьерн: стремительного
список: список
пост: пост
яв: явью
выдел: помог
итог: итоге итоги итогу
замечательн: замечательную
вездесущ: баг
полгод: спустя
дек: дек
зло: нерушимое
дел: доставщика
вопрос: ответ вопросах
дизайн: дизайна дизайн дизайном
рассказа: рассказать данной
студ: студии
стремительн: растет опытом
внутрен: внутренние
помим: обновляли
попыта: попытались
вскор: коммерцию
устройств: информация
статус: статус
попробова: обязательно
маскот: многим
клиент: клиентом клиентам клиентов
ваш: вашим вашего
проход: проходили
так: такую
изучен: изучение
ответ: дадут
обществ: обществом
никт: никто
москв: велосипеде
полност: полностью
несмотр: намеренно
событ: событий события
баг: нашего сказ
собствен: собственных
течен: зера
консолидирова: ского
техническ: настройка
информативн: информативными
исполнительн: исполнительный
британск: британскому
планирует: планируете
уда: оптимизация
существован: полгода
черкасск: никита
фев: фев
доходчив: доходчивыми
заметк: заметке
товар: прием рынком
собира: собираетесь
мегапроект: стартапам
хабр: хабр
аналитик: аналитика
обучен: обучение
откуд: коровка
некотор: некоторых некоторым пережили
подума: едет
количеств: количество количеству
служб: службы
соглашен: документы
рома: роман
твор: творить
добав: добавить
штурм: штурма
просмотр: просмотров
содержан: содержание
практик: практике
последн: сработал
неносител: неносители
месяц: попробовать доставки
сам: самым
сан: сан
объем: объема
сказ: вопрос
ба: пупок
качествен: качественнее
интеллект: интеллекта интеллект
старинк: старинке
друг: друг другу
стартап: стартапа программы
туториа: туториал
дик: дикие
приход: приходилось
правильн: правильно правильное правильного
потребител: среди
переда: передает
поня: понять
образован: образование
подобн: подобный
посмотр: посмотрим
компан: компании устройство существования
рассказыва: рассказывали рассказываю рассказываем
программ: образовательные
управлен: привело управление
коммуникац: коммуникациям
федерально: второи
разбира: разбираться
делов: деловой деловое деловом
нашл: нашли
социум: социума
антагонист: персонаж
допуска: допускают
низк: низкие
привел: привели вскоре
смысл: смысл
век: века
начина: курса
привет: привет
рубеж: рубежом
млрд: достигнет
популярн: большую популярное
прогноз: экспертным
отдел: отделов
нерушим: вездесущее
научн: научно
улыбк: дрогери
изуч: течение
магазин: магазина сети
созда: создать
интернетизац: интернетизация
сво: своим
объясня: авг
веб: веб
программирован: программирования
гг: гг
отдельн: отдельная
нача: начать
авг: получилось
порог: порог
перспектив: перспективы
станов: участниками
прогнозируем: прогнозируемое
интернет: интернет
предоставля: предоставляет
россия: привычна
позиционируем: позиционируемый
тег: тегов теги
позиционирован: позиционирование позиционировании позиционирования
появлен: самокате
вещ: вещи
оптимизац: клиентская
сработа: объясняющих
помер: померимся
основател: основатель решение
применя: применять применяем
привычн: карьерного
великобритан: великобритании
брендинг: брендинг брендинге
администрирован: администрирование
развит: подробностями развитие
уголовн: уголовный защищать
горбач: горбач
переж: десятилетие
определя: определяет
сайт: сайта сайты сайтов
питан: быстрои
выстраива: партнерство
научпоп: научпоп
технолог: технологий российским
комментар: комментарии комментария
происход: заметить
клиентск: сша
запущен: работа
прощ: проще
сотрудник: сотрудникам
инженерн: инженерной
проч: прочее
нейросет: нейросетей
работа: работаю
сильн: сильный
детал: каждую
песочниц: хабы песочницы
таргетолог: таргетологов
ед: рынка
десятилет: последнее
услуг: товаров конфиденциальность
искусств: искусства
эпичн: эпичное
дадут: ошибки
блог: блог
необходим: приводят
зовут: зовут
истор: зуму истории
логотип: логотипов логотип логотипе
интерфейс: интерфейса интерфейс
модел: модели
легч: легче
исследова: исследовать
сложност: сложности
ещ: ещ
вниман: внимание
фло: флоу
автор: авторы компенсации автор автором вклад автора
непринципиальн: непринципиальны
сен: сен
репутац: репутации
чита: читать читали
лонгрид: лонгрид
вид: вид
сет: розничнои
конфиденциальн: соглашение
виде: видео
зум: ки
попада: попадающие
защит: защитить
фирмен: москве
корпорац: корпорация крупных
чуж: использованию чужую
ранжирован: ранжирования
кодекс: кодекс
быстр: быстрая быстро быстрее
ущерб: ущерб
цепля: цепляющие
бизнес: бизнеса бизнес
влия: влияет
позволя: позволяющий
шейх: шейх
хоч: хочу
внедрен: курс
рейтинг: рейтинг рейтинга
реш: решила
способн: способностях способны
общ: общее общие
обидет: обидеть
остав: оставить
объ: объем
закреплен: закрепленный
курьер: внедрения
сторон: стороной
запустивш: история
поток: потоки
защища: произведения
поддержк: поддержкой техническая
предостав: предоставила
ржд: банк
смотр: америке
образец: образец
суперва: курьера
набор: набор
оптимизатор: оптимизаторов
предпосылк: закону
принцип: принципов
серг: сергей
профессиональн: профессионально
ассортимент: ассортимент
ид: идеи ид идею
никит: мире
сред: конкурентной существующие
им: имена
предыдущ: предыдущий
разбирательств: разбирательство
оборот: запущенный
наш: антагонист
лайфхак: лайфхаки
редактор: редакторы
темп: высокие
пользовател: пользователей
мног: полюбившегося многие многих
полюб: помимо
дигитализац: дигитализация
успешн: заключили
авторск: нарушить объектов
плат: вынуждены
язык: языке языков языка
подрядчик: подрядчику подрядчика
большинств: большинство
заказ: сборка первые
брендир: брендируйтесь
обязательн: подумал
сервис: сервисов предпринимателями появлением сервисах сервисы
безобидн: безобидных
стил: стиль
фактор: факторы
критичн: критичны
вли: влияя
недар: недаром
описа: описать
информац: песочница
облачн: облачных
гор: шли
соверш: случайно
разн: разных
письм: письмо письме
ключев: ключевых
анализ: результаты
замет: услуг
апеллир: апеллирует
люд: людей
философ: философов
спуст: роста
английск: английским английском
объяв: компания
дополнен: дополнение
пет: пет
владен: владения
ки: баи
маркетолог: маркетологи
наказан: наказания
доставщик: радуги
законодательств: законодательство
беспоко: беспокоясь
сборк: товара
парочк: парочку
кс: кс
создан: создания созданием
особ: особый
граждан: становятся
симбиоз: симбиоза
инфостил: инфостиля
привод: приводит одних
прочел: вечером
постара: постараемся
инсайт: инсайты
одн: одну вреде
продаж: продаж выстраивали
картинок: картинок
мар: мария
настольн: настольная
повлечет: повлечет
наблюден: процессе
увеличен: увеличения
реклам: реклама
вставк: вставке
корпоративн: корпоративное услуги
вор: рублей
рекомендац: рекомендации
экспресс: сервис
потребн: потребностей
соответств: соответствуют
запуск: процессу
нативн: медийная
действова: действовать
контекстник: контекстников
роман: роману
инструмент: инструментов
огромн: огромный огромная
команд: команды команда
итак: итак
локализац: локализация
обстоятельств: экономическими
издател: издателей
музык: изображений
польз: моде
иконк: иконку
ответствен: ответственность уголовной
врод: вроде
стран: странах
электрон: изучать
использован: относятся использованием использовании
уровн: уровнем уровня
отлич: млрд
задолг: задолго
регион: региона
четк: четкий
поскольк: поскольку
осваива: осваивать осваиваем
смотрел: смотрели
войт: аккаунт
качеств: качеством
билайн: удачные
своевремен: развивать необходимости
безграничн: безграничных
конечн: конечном
патентован: патентование
аккаунт: лучших
прошел: спинои
предпринимател: российскими
пис: писем
сраз: предлагают
конструирован: развития
онлайн: онлайн
систематическ: систематически
пиш: пиши
но: ноя
подробн: интересными
репутацион: репутационный
намерен: сделавшие
раздел: регистрация
латинск: латинской
плагиат: плагиат
исследовател: исследователи
дрогер: формата
вполн: вполне
яндекс: мегапроекты
новост: прочел новости
лучш: авторов лучшие
заголовк: заголовком заголовке
существ: меняются
нанест: нанести
перв: доставлял
управля: управляющий
достижен: достижения
небольш: небольшой
бож: рисовался
дума: думал
формат: магазинов
относ: лояльно
написа: написать написано написанных
крайн: крайней
поиск: поиски поиск поиске
оп: опыт
возможн: возможности возможностях возможность возможностей возможно
интересн: поделился интересным
изменен: происходят своевременных
равн: законом
разряд: разряда
основ: основе
американск: запуска
фудтех: запустившеи
образовательн: проекты
хочет: хочется
как: какие
участник: прецедентов
крупн: ребрендингов
приобр: месяцев
непосредствен: непосредственно
недостаточн: недостаточный
голос: голосов
крут: круто
страниц: страницы
судебн: текстов судебное
матер: материю
обобщ: обобщить
кат: заказы
рассматрива: рассматривались
площадк: площадками
встреча: встречаем встречаются
фильм: музыки
предсказыв: предсказывая
прошл: прошлом
растет: конкуренция
прежд: прежде
высок: смотря
бывш: бывший
бытов: скорее
креативн: креативная
контент: контент
изображен: чужих
партнер: партнеру партнер
откр: открыть
июл: американском
форм: форма
мер: мере
наход: находится
революц: фудтех
продукт: продуктом продуктов продукт продукта
лояльн: несмотря
конференц: конференции конференция
xx: xx
studio: studio
clickru: clickru
sfjazz: sfjazz
pv: pvs
roman: roman
switcher: switcher
buyk: buyk
egorkotkin: egorkotkin
twitter: twitter
gregori: gregory
latam: latam
yahor: yahor
logo: logo
group: group
alibaba: alibaba
cherkasskynik: cherkasskynik
kpi: kpi
alabama: alabama
osmam: osmam
gpt: gpt
ebai: ebay
markati: markaty
click: click
manag: manager
karuna: karuna
vk: vk
ecommerc: ecommerce
habr: habr
denissergeev: denissergeev
breycher: breycher
code: code
ru: ru
nookino: nookino
youtub: youtube
deni: denis
bt: bts
rss: rss
rooke: rookee
design: design
midjournei: midjourney
alina: alina
seo: seo
gregyku: gregyku
email: email
smokkin: smokkin
process: process
art: art
center: center
facebook: facebook
kt: kts
telegram: telegram
lireat: lireate
lead: leading
hanna: hanna
commerc: commerce
tutme: tutmee
jasiejam: jasiejames
digitalagencyspher: digitalagencysphere
york: york
lub: lub
mena: mena
mercifulcarnifex: mercifulcarnifex
oper: operations
time: times
mariafonshina: mariafonshina
zelenykh: zelenykh
