случ: случились
банк: банка банке
криптограф: криптография
расскаж: расскажу расскажем
стат: стать статье статьи статей статья
экспорт: экспорта
стар: старую
рабоч: рабочую рабочих
юзер: юзеров
стал: стали
се: сей
получател: получателей
таргетирова: таргетированной
един: единая
работ: работа работе работу работы
правок: правок
показыва: показывает показывать
дополнительн: дополнительный
сценар: сценарии сценарий
получен: полученный
инфраструктур: инфраструктуры инфраструктура
критическ: критических
менеджмент: менеджмент
распылен: распыления
арм: армии
мобильн: мобильном мобильного
знакомств: знакомство
публикац: публикаций публикации
скопирова: скопировать
карт: карты
нест: нести
подел: поделились
котор: котором которым которыми
профилактик: профилактики
адресн: адресное
эксперимент: эксперименте
свят: святым
связа: связался связанных
раскро: раскроем
вовс: вовсе
проект: проекты проектов
связ: связи связь
относительн: относительно
базанков: базанкова
опас: опасаясь
профил: профиль
дела: делать
приветств: приветствую
голосов: голосовой голосовую голосовым голосовых
дипфейк: дипфейк дипфейках дипфейки дипфейков
документац: документации
ритейлер: ритейлера
проблемн: проблемных
верс: версий версию
маркетинг: маркетинг
разобра: разобрали
прост: простой простых
нно: нной
типографск: типографской
лиц: лица
вепр: вепрь
позвон: позвонить позвонивших
уровен: уровень
нов: новые новой
внешн: внешней
нож: нож
медийн: медийная
част: часть части частей
отбор: отбора
цифров: цифровых цифровом
слож: сложилась
традицион: традиционно
подделк: подделки
устро: устроена
саппорт: саппортом
журна: журнал
постоя: постоянно
системн: системного системное
нны: нный нные
сдела: сделал
рожден: рождения
особен: особенностями особенность
сложн: сложный сложное
мошенническ: мошенническая
совет: советы
примен: применить
моментальн: моментально
пример: примеров примера
культов: культового
операцион: операционной
тестир: тестирует
джозеф: джозеф джозефу
расположен: расположенном
хранилищ: хранилищ хранилища
систем: системы системам системой системе
генерирова: генерировались
журналист: журналисты
убежда: убеждают
частн: частная частной
персональн: персональным
трудн: трудно
провайдер: провайдеров
перехватчик: перехватчиков
читател: читатель
метод: методы метод методов
машин: машинное
процесс: процесс процессе процесса процессов
групп: группы
архип: архипов
помогут: помогут
нных: нных
подготовлен: подготовленным
разоблач: разоблачить
актуальн: актуальные
продолжа: продолжаем
номер: номер номеру
случайн: случайно
подряд: подряд
помога: помогает
современ: современный современном
помощ: помощи помощью
ассемблерн: ассемблерный
ростелек: ростелеком
гугл: гуглит
приложен: приложению
заключ: заключен
склад: складах
опасн: опасности
вклад: вклад
генеративн: генеративных
произнос: произносил
будущ: будущее
спокойн: спокойно
нул: нулю
визуализирова: визуализировать
интерес: интересов
средств: средства средств
программист: программисту
потребова: потребовалось
идентификац: идентификации
битн: битное битного
фаз: фазу
беспрецедентн: беспрецедентных
росс: россии
регистрац: регистрация
тестирова: тестировали
выявля: выявлять
зим: зимы
ситуац: ситуаций ситуация
цикл: цикла
счита: считается
некорректн: некорректные
цел: целью цели
сообща: сообщает
граал: граалем
кажд: каждым каждого
руководител: руководители
настро: настроить
дзен: дзен
канал: каналы
взаимодейств: взаимодействия
коммерческ: коммерческом
создава: создавать
искусствен: искусственный
утилит: утилита утилиту
частност: частности
загрузчик: загрузчика
использова: использовать использовали
логик: логику
векторизац: векторизация
злоупотребля: злоупотребляли
закономерн: закономерную
сюд: сюда
настоя: настоящий
список: список
импорт: импорта
затронул: затронули затронуло
паразитическ: паразитическим
наглядн: наглядно
тематик: тематику
след: следующим
абонент: абоненте
организац: организации
дизайн: дизайн
производительн: производительность
логистик: логистики
попыта: попытаюсь
клиент: клиентов
коротк: коротких
так: таких
общен: общение
нормальн: нормальную
уязвим: уязвимостей уязвимостях уязвимость уязвимых уязвимости
поменя: поменялась
событ: событий события
течен: течение
баз: базе базу
техническ: техническая
фев: фев
вредоносн: вредоносные
рутин: рутинных
обсуд: обсудить
некотор: некоторые
предпочита: предпочитают
пэп: пэп
авторизац: авторизации
оберега: оберегаем
рассмотр: рассмотрен рассмотрим рассмотрена
потенциальн: потенциальные
количеств: количество
служб: службу служба
соглашен: соглашение
полез: полезен
добав: добавить
щелкнут: щелкнуть
просмотр: просмотров
методик: методика
цепочек: цепочек
дополня: дополняем
пентест: пентеста
друз: друзья
сканирован: сканирования
представля: представляет
синтез: синтез
стро: строить
звон: звонит
интеллект: интеллект
виртуальн: виртуальная
друг: другом друг друга
правильн: правильно
тайн: тайные
сбор: сбора сбор сбору
дракон: дракона
поня: понять
компан: компаний компании
программ: программы
коммуникац: коммуникаций
вчер: вчера
ежедневн: ежедневно
действ: действует
разбира: разбираем разбирали
главн: главным
соответствен: соответственно
страда: страдает
пят: пятью
созд: созда
привет: привет
видеозвонк: видеозвонка видеозвонков
дайджест: дайджесте дайджест
использ: используется используют
изуч: изучить
созда: создать
ран: ранее
кейс: кейс
отдельн: отдельное отдельных
сохранен: сохранением
передач: передачи
интернет: интернета интернете
оригинальн: оригинальная
тел: теле
тем: тема темы теме
применя: применяется
официальн: официальной
пришл: пришло
полн: полной
администрирован: администрирование
анонсирова: анонсировали
комментар: комментарии комментариев
рамк: рамках
сотрудник: сотрудники сотрудникам сотрудников
адрес: адресов адреса
детал: деталей
работа: работал работать
песочниц: песочницы песочница
услуг: услуги
телефон: телефона телефонные
блог: блог
числ: число числе
гражда: граждан
чист: чистую
модел: модели
сложност: сложности
исправля: исправляют исправлять
автор: авторы автор автором авторов
футпринтинг: футпринтингом
чита: читать читайте
виде: видео
локальн: локальной
подход: подход
попада: попадаются попадалась
намер: намерен
экосистем: экосистеме
расписа: расписаться
быстр: быстрого быстро
пользу: пользуемся
спрос: спросил
типичн: типичный
бизнес: бизнесе
тип: тип
бумаг: бумаги
инцидент: инцидента инцидентов инциденты
аутентифицир: аутентифицирует
внедрен: внедрения
портативн: портативный
статическ: статически
распространен: распространение
печа: печать
реч: речь
реш: решил
лаборатор: лаборатория
общ: общем
перечисл: перечислим
недел: неделе
автопроизводител: автопроизводители
повод: поводу
оператор: оператор операторов
сред: среду
социальн: социальные
лайфхак: лайфхаками
может: можете
посвящен: посвященное
люб: любого любые любой
язык: языка
натуралистичн: натуралистичности
таблиц: таблиц
мониторинг: мониторинга
злоумышленник: злоумышленник злоумышленников
разн: разные
образц: образцу
документооборот: документообороте документооборота документооборот
отсканирова: отсканировать
люд: людей
выявлен: выявления
отправк: отправка
год: годы
подписан: подписанием
экспертиз: экспертиза
критер: критерий
парол: пароль пароля
законодательств: законодательство
погруз: погрузиться
применен: применением
взламыва: взламывали
создан: создание
вывод: вывода
запис: записи
подп: подпись
мар: мар
согласн: согласно
перенаправля: перенаправлять
реклам: реклама рекламы
произнест: произнести
прид: прид
корпоративн: корпоративный
бумажн: бумажная
помощник: помощником
инструмент: инструменты инструментам инструмент инструментов
врод: вроде
электрон: электронный электронного электронной электронная
смотрет: смотреть
удивлен: удивлению
десятк: десятки
использован: использование использования
сентябр: сентября
войт: войти
конечн: конечных
аккаунт: аккаунт
состав: составе
подпис: подписью
генерируем: генерируемого
глаз: глаза
протокол: протокол протокола
отложен: отложенного
татья: татьяна
подробн: подробно подробнее
именуем: именуемую
яндекс: яндекс
новост: новостей новости новость
перв: первую первой
чувствительн: чувствительных
подвод: подводим
проведен: проведения
перехват: перехвату
солар: солар
поиск: поиска поиск
изменен: изменений
автоматизирова: автоматизировать
возраста: возрастает
запомн: запомнился
основ: основе
инсайдер: инсайдера
образовательн: образовательные
как: какие каких каким
участник: участников
голос: голос голосов голосу
шлюз: шлюз
преодолен: преодоления
тся: тся
прошл: прошлых прошлой
реальн: реальном
точк: точка
сфер: сфере
установлен: установленных
разведк: разведки
способ: способ способах
мер: меры
браузер: браузеры
продукт: продукты
провер: проверить
информацион: информационная информационной
туннел: туннель
образ: образом образами
вызов: вызовах
конц: конце
дорог: дорогой
найд: найдены
аспект: аспекты
обзор: обзор
появ: появиться появился появились
запуска: запускаемых
практическ: практические практическую
доступ: доступа доступ доступе
наряд: наряду
вернут: вернуться
парадигм: парадигме
сетев: сетевое сетевые
гкост: гкость
киберпреступник: киберпреступников
децентрализова: децентрализованные
схем: схема
швейцарск: швейцарский
и: ии
л: л
загружен: загруженных
изменя: изменять
личност: личность
п: п
хакинг: хакинг
централизова: централизованные
небезопасн: небезопасная
показа: показана показали
сообщ: сообщить
отправ: отправить
распечата: распечатать
поэт: поэтому
мин: мин
редактирова: редактировать
вариант: варианты
памят: памяти
мир: мир мире миру
приручен: приручение
совершен: совершенно
безопасн: безопасной безопасных безопасность безопасный безопасности
феврал: феврале февраль
адресат: адресату
сообщен: сообщения сообщений сообщениям
получ: получили получив получить
блокир: блокируют
кокс: кокс
публик: публикуются
перевод: перевод
распечатк: распечатку
важн: важно
авторизова: авторизовался
списк: списками
рук: руки
час: час часа
раскр: раскрыть раскрыли
издан: издания
индустр: индустрии
могл: могли
администрирова: администрировать
больш: большие
софт: софт
мест: место
файлов: файловые
планомерн: планомерно
счет: счету счете
вход: входа
направлен: направление
шифрован: шифрованием
граф: графов
пуга: пугающей
эффективн: эффективно
извлечен: извлечения
генерац: генерации
исправ: исправить
инфосек: инфосека
формальн: формально
сформирова: сформированный
аутентификац: аутентификации аутентификация
скомпрометирова: скомпрометировали
мошенничеств: мошенничества
смог: смог
микросервис: микросервисы
основн: основной основная
гейт: гейта
константин: константин
основа: основанных
почт: почта
роскомнадзор: роскомнадзор
утечк: утечки
решен: решениям решением
офисн: офисные
передава: передаваемых
провод: проводить проводит
средн: средний
личн: личном личную
нужн: нужным
домашн: домашнего
секрет: секреты
хаб: хабы
описан: описание
добив: добиваясь
востребова: востребованы
результат: результатов результаты
банковск: банковские
вызыва: вызывающем
опыт: опыте
дад: дадим
ваканс: вакансия вакансии
настройк: настройка настройки
дал: далее
документ: документы документов
прочтен: прочтение
ссылк: ссылку
взрывн: взрывное
дан: данным данный дано данная данных данными данной
дат: дату
указа: указать
посторон: посторонний посторонних
биометр: биометрию биометрии
подменя: подменять
код: кода
технологическ: технологических
коп: копия
мтс: мтс
привязк: привязке
функц: функций функции функцией
используем: используемой
построен: построения
понадоб: понадобились
фраз: фразу фразы
звук: звук
увид: увидит
редирект: редиректов
продемонстрирова: продемонстрировать
рядов: рядовых
перебо: перебоями
подключ: подключим
финансов: финансовой
разбор: разбором разборе
позабот: позаботиться
жив: живых
обнов: обновить
объект: объекте объектов
несет: несет
разработк: разработка разработки
закладк: закладки
программн: программное
почита: почитать
изнутр: изнутри
релиз: релизов
читер: читеров
пост: пост постов
итог: итоги
вопрос: вопрос
бесполезн: бесполезная
жит: жить
внедря: внедряли
внутрен: внутренним внутренней
устройств: устройствами устройство устройств
размер: размеры
текстов: текстовые
хакер: хакер хакеры
забан: забанила
двигател: двигателем
ответ: ответили
пространств: пространство
полност: полностью
развязк: развязка
сталкива: сталкиваются
собствен: собственной собственных собственном собственный
ручн: ручным
станц: станций
британск: британском
уда: удал
расширен: расширением
материал: материалов материале материалом
мегапроект: мегапроекты
целостн: целостность
хабр: хабре хабр
обучен: обучение
тиктокер: тиктокеры
отношен: отношениям
обща: общаться
разлага: разлагаться
уявзим: уявзимости
практик: практика практики практике
последн: последний последнего последние последних
месяц: месяца месяц месяце
сам: самое самый самые
качествен: качественные
настраива: настраиваете
стартап: стартапам
туториа: туториал
подключен: подключение
подобн: подобные подобной
абсолютн: абсолютно
посмотр: посмотрим
вероятн: вероятно
выполнен: выполнения
касперск: касперского
наслед: наследием
цепочк: цепочки
распознаван: распознавания
сбо: сбоев
микр: микро
пресс: пресс
век: века
жно: жной
стандарт: стандартом
внедр: внедрить
очередн: очередного
вс: вс
популярн: популярный популярные
соцсет: соцсетях
област: областях области
учетн: учетной
сво: сво
программирован: программирование
исследуем: исследуемых
нача: начался
возникш: возникших
специалист: специалист специалистам
порог: порог
станов: становится
попробу: попробуем
атак: атак атаку атаки атакующих
явля: является являющая
редактирован: редактирования
мегафон: мегафон
свод: сводя
первичн: первичный
представ: представить
сайт: сайта
дн: дн
обеспечен: обеспечение
оборудован: оборудования оборудование
научпоп: научпоп
технолог: технологий технология технологии
продолж: продолжим
задач: задачах задач
файл: файлов
происход: происходит происходило
различн: различных
сервисн: сервисной
посвящ: посвящена
истор: истории история
ещ: ещ
призыва: призывают
гибк: гибким
сер: серии серию
сет: сеть сетью сети сетям
конфиденциальн: конфиденциальная конфиденциальность
вид: вид виде
сканер: сканер
защит: защита защиты
чуж: чужого
теор: теории
окулус: окулус
вплот: вплоть
договор: договор
хот: хотят
позволя: позволяют позволяет
платн: платный
эволюц: эволюцию
рейтинг: рейтинг рейтинга
упоминан: упоминания
способн: способных способны
постав: поставить
поток: потоки
предостав: предоставить
поддержк: поддержки поддержка
глубок: глубоких
иб: иб
классификац: классификация
пуст: пустой
звонк: звонки
защищ: защищ
зашифрова: зашифрованный
ин: иной
наш: нашему
пользовател: пользователя пользователи пользователей пользователям
транзакц: транзакций
успешн: успешно
впечатля: впечатляющее
попроб: попробую
сервис: сервиса сервисов сервисам сервисами сервисы
информац: информацию информация информации
подделок: подделок
анализ: анализа анализе
удален: удаления
трат: трата
ровн: ровно
объяв: объявил
имитац: имитация
трудност: трудностях
добавлен: добавления
понят: понятия
переста: перестал
мессенджер: мессенджеры мессенджеров
обработк: обработка обработкой
поговор: поговорим
черн: черного
собра: собрали
например: например
спам: спама
отправля: отправляют
вставк: вставки
нативн: нативные
попрос: попросил
чест: чести
выман: выманить
польз: пользуются
рассмотрел: рассмотрели
вод: воду
мо: моему
сист: систему
специфичн: специфичный
углублен: углубленно
утекш: утекшие
качеств: качестве
прошел: прошел
форвард: форварда
проблем: проблемы
обнаружен: обнаружения
сервер: сервер серверов
откровен: откровение
баланс: баланс
раздел: разделы
автоматическ: автоматически
исследовател: исследователь
угроз: угрозы угрозу
аббревиатур: аббревиатура
видеоконтент: видеоконтента
нек: некий
блокировк: блокировке
лучш: лучшие лучших
механизм: механизм
детектирован: детектировании
небольш: небольшими
дума: думаю
облегч: облегчить
пойдет: пойдет
интересн: интересную интересна интересные
возможн: возможностей
этичн: этичный
сотов: сотовый сотовая
открыт: открытых
взгляд: взгляд
коварн: коварные
круз: круз
архитектур: архитектуре
изображен: изображений
радикальн: радикально
преимуществен: преимущественно
стандартн: стандартные
откр: открыть
миллион: миллионы
источник: источников
sourc: source
dfir: dfir
xakep: xakep
intellig: intelligence
ssh: ssh
snmp: snmp
assembl: assembler
mobil: mobile
number: number
egorkotkin: egorkotkin
bank: bank
twitter: twitter
java: java
deepfacelab: deepfacelab
reddit: reddit
ptsecur: ptsecurity
lloyd: lloyds
esetnod: esetnod
jump: jump
posit: positive
qr: qr
github: github
edeshina: edeshina
jeditob: jeditobe
ai: ai
secur: security
manag: management
otu: otus
habr: habr
doc: docs
rl: rl
firstvd: firstvds
globalsign: globalsign
ubiqu: ubiquiti
server: server
valv: valve
ru: ru
postscript: postscript
solar: solar
siem: siem
searchinform: searchinform
youtub: youtube
rss: rss
cve: cve
pand: pand
web: web
tor: tor
attack: attack
southbridg: southbridge
lordbarov: lordbarov
sm: sms
adminvp: adminvps
event: event
passwordsprai: passwordspray
kali: kali
erp: erp
alizar: alizar
zhovner: zhovner
facebook: facebook
team: team
url: url
tl: tls
pentest: pentest
open: open
expressvpn: expressvpn
nord: nord
incid: incident
dacl: dacl
lab: lab labs
hola: hola
cloud: cloud
technolog: technologies
ipvanish: ipvanish
digit: digital
hunt: hunting
selectel: selectel
motherboard: motherboard
deepfak: deepfake deepfakes
real: real
keepsolid: keepsolid
rous: rouse
uprightman: uprightman
velociraptor: velociraptor
vk: vk
activ: active
maxpatrol: maxpatrol
speedifi: speedify
keycloak: keycloak
maxrokatanski: maxrokatansky
week: week
admin: admin
detect: detection
respons: response
kasperski: kaspersky
bloodhound: bloodhound
unlimit: unlimited
linux: linux
debian: debian
osint: osint
faceswap: faceswap
forens: forensics
godaddi: godaddy
live: live
openvpn: openvpn
delphi: delphi
valdikss: valdikss
lukasafonov: lukasafonov
apiset: apiset
telegram: telegram
monitor: monitoring
ddo: ddos
vitalii: vitaliy
pdf: pdf
footprint: footprinting
karkhipov: karkhipov
vpn: vpn
window: windows
threat: threat
time: time
directori: directory
mark: marks
