рс: рев
говор: говорят трудно говорить
оценк: критерии обойтись
фултайм: заниматься
понима: фронтендер смысла
оттуд: половина
оунер: разработчики
проектирова: энтерпрайз
стат: стать статья прочтите дойти
стар: новый созда смогут пометить вернуться
рабоч: использования
стал: стала
мнен: поделился субъективным субъективное
планиру: релизе
реализова: реализованный дорого
един: применения стройной единый понимания
повторя: правило
работ: работа помогают прежде фронт
завис: дешевле лайфхаки
правок: внесения
дополнительн: оповещать
сценар: брать рабочие плохих
затрагива: новой
сч: сч
будьт: шевцова
нейминг: единой
инфраструктур: существующей
пол: кнопки
сто: сценарии созданию
менеджмент: менеджмент
пункт: обязательный пункт
заполня: делал
мобильн: мобильные требуется
знакомств: знакомства
должн: какими реализуемы
структур: вершине
публикац: кнопку
партизанск: идут
неповоротлив: сложным
график: палитру
подел: статье
назван: поставь стили
котор: решение волны
денег: виде
палитр: шь ошибки
вариативн: зависят
карм: комментарии
времен: итоге
провест: тестировщики
адресн: удобнее адресные
детачьт: дизайну
шаг: лейаут первые
прав: правил базис взял
обратн: ломают
либ: сверху любой
двига: д
проект: файла использую зависит проекте вашему проектами нативные
появля: развитием подойдут
упроща: начинают
профил: профиль
дела: делать делалось максимум сделать строить предложить схожие
сут: платформенные
извн: нанимают
ребят: ребята
причастн: дополнительно
подкаст: подкастов
документац: документацию противоречива некая
узнава: развитию
верс: выводим мажорную
устраива: потребностях
маркетинг: использоваться маркетинг
избавля: решают
прост: простого используете хватает
разнос: одно
врем: времена
ауд: аудио
режет: хаотичность
занима: момент занимался продукты элементы
постро: автоматизировать
встреч: ежедневных
совместим: обратную
подруг: подруги
уровен: уровень
придума: общее
нов: выпускаем перейти названием совершенно вносим
сверх: снизу
медийн: корпоративный
атом: атомарного
част: затратите страница составные
кана: канал канала
допущен: исправлять
скелет: накидываю
постоя: тся
системн: общий
нны: удал
определен: понимаю инжинирингом
сдела: амбиций страдать
сложн: настолько сложными сложный компонентам смысл предоставлять
дают: добавлю
совет: советы
пут: путь пойти
моментальн: является
активн: старался
пример: примеров неповоротливым частый
выпада: некоторыми
тестир: компонентах
распростран: внести
противоречив: стройна
инвентаризац: унифицированные шаг
систем: системы системой системе система системах практике
выход: готовой
узна: поговорить узнал исследование
баннер: красный
запихнут: допиливать
трудн: сможете
сожален: форм
шевцов: евгения
пуш: строку
текущ: развивать поддерживаем
ресурс: необходима необходим
метод: партизанским
процесс: легкий двигает
темизац: токенами
перемен: передавать название
атомарн: правилам знаю
выпуска: фронтенда
шь: узна
требован: появляться
постепен: придется
культур: культура
хаотичн: легаси
помога: гордости помогает плагинаи помогал активно
рынк: решений
помощ: помощью контент
гугл: гугл
приложен: технических
разработчик: разработчикам фронте фронтенд пишется договариваться
отступ: переменную
текст: тексты замене
приписк: помечаешь
гордост: стыду
будущ: поговорите
желан: масштабах
выделен: ним
нуж: старта
сын: сын
нул: нуля
шил: самый
закон: паттерны
плох: неделю жизнеспособная хорошей готовое
регистрац: войти
имеет: имеет
ребрендинг: привязать
счита: мнениями
отсутств: сталкиваетесь
упрост: поставлены
заменя: токен
цел: версии модулей
кажд: совершить дизайнерами написанные
руководител: руководитель
дзех: дзех
дзен: яндекс
рожда: извне
множеств: множество
взаимодейств: взаимодействии взаимодействия
стартанут: быстро
создава: развитии создавать
мотивац: денег
спор: деле
отбер: ресурса
идут: компаниях
типографик: цвет
использова: часть узнать полно
раскладыван: описание
достаточн: этапе
примерн: обновляемся
добавля: иконки лично
коробочн: инфраструктуры
список: список
рекомендова: макетов
скриншотн: тестируются
иконок: состоит
строг: сложные
типов: необходимо
след: совместимость
строк: заменяешь
организац: организацию
дизайн: дизайна старой дизайне дизайн подписаться
помим: помимо
лты: знать
так: проекту слышу
нормальн: изменять
картин: общую
баг: решениях
переделк: понадобятся
сниз: потребность
баз: определения целых
техническ: одна языка
уменьша: разработки
поборот: настало
передела: нормально
назва: назвать
внест: изменение
собира: правильно сразу
звуков: шрифт
рутин: фигмой какую
некотор: модалками
шевц: шевцов
подума: ролей сто
количеств: количество
соглашен: документы
добав: идея быстрее
просмотр: просмотров
покрыва: работаю
нанима: команду
зна: индустрии
услов: условии
тво: получаешь
стро: хочу
аутсорс: аутсорс
друг: варианта
зон: зонов
приход: возможности собираешь
правильн: сервисах
ошибочн: многие
спорн: спорного
поня: рекомендовал атомов собрал
менеджер: менеджеры менеджерам
компан: компания компаний компании отбер
рассказыва: рассказывал коммуницировать
программ: образовательные
коммуникац: болит
получа: сценариев
ежедневн: возможно
главн: самое главный
разбира: страниц
ноут: релиз итог
составн: консистентном
страда: консистентность
кодфест: кодфесте
фич: новые пилить
созд: старого
займ: займ
элемент: элементов иной разбираю
пользуеш: мультизамены
поможет: существуют
отдел: отдела
использ: используются подход добавить расширений
визуальн: палитра
раз: первого
созда: х создал создать
фронтендер: фронтендеров удобство
имеющ: имеющие имеющий
кейс: кейсов
отдельн: мобильный организмов инструментами
предоставля: использовании
реализац: реализации
пониз: сделали
тег: видят
завяза: отдельную
тем: тема
скруглен: отступам
полн: рынке
администрирован: администрирование
пользовательск: пользовательский
знат: организма
начальн: зрелых
бел: побороть
знан: нужны
выстро: получится
детач: неудобным
раскатыва: изменения
комментар: закладки
поставл: решает
рамк: выходя релизов
прощ: влиять
сотрудник: мотивации
оповест: чате
проч: прочего прочие цветам
прош: прош
смотрител: смотрители
работа: шаблона макеты работал котором работает мнение
спринт: ускорив
песочниц: авторы песочницы смену
услуг: конфиденциальность
блог: блог
необходим: выверяется уникальных задачи насколько
числ: тестами
доработк: доработками
интерфейс: понятные интерфейс теги
чист: наработок
мамкин: мамкин
сетк: цвета
сложност: сложности
параметр: прочим
пойт: можете
исправля: листа
автор: автор сайта автором новости
снижа: мнением
локальн: глобальным
подход: опрос атомарный задействовать
пойд: пойд
лых: тяж
придет: сторонней
инпут: порядка
помеча: старый
дойт: смогли
реб: ребят
необход: поддержку
рев: занимаюсь
блогер: блогер
быстр: позволяют темизация
бизнес: представители
модалк: работаем модифицируют
удобств: признак
синхронизирова: синхронизированные
реч: реальном
реш: решили подумать
общ: общего понять нарисовать увидеть найти переменных
жизнеспособн: работают
систематизирова: систематизировал
состо: база
набор: набора набор
недел: занимает
поддержива: поддерживать обновлений
удобн: инструкций глобальные
сред: среде
учебник: определение
лайфхак: фишки
слыш: локальными
может: далее
устойчив: проектировать
мног: библиотека решением
люб: основе любого
потреб: функциональность
язык: общем настройка
обязательн: воплотить одному
нарисова: достаточно
таблиц: кнопок
стил: иконок текстовые
закинут: вариантов
критичн: откладывать
фронтенд: случае примерно дизайнеры
правк: вносить
правд: правды
перегружа: лишнего
соверш: вашем
гот: готов
разн: разными разных бывают
взял: дочерние
отвеча: отвечают
критер: ошибок нужен
интерв: проектирование
применен: продолжение
создан: создания предпосылками пользователями создание
вывод: версию обновляется
расход: расходы
волн: звуковой
одн: устаревшими маркетинга ответа подговаривают одни шилом
реклам: медийная
настольк: усложнении
прид: гибкими
корпоративн: услуги
потребн: идеей приходит
шаблон: формат пример
инструмент: инструментов инструмент сути
ток: голове меняешь
команд: выделенная команды маленькой сотрудников команде редко команд
ведущ: ведущий
массивн: избыточных
иконк: продукте
опир: опираясь
субъективн: плохая оценка
уникальн: требует
врод: общедоступные
задуш: иначе
инструкц: разработчиков длинных
войдут: базовая
смотрет: песочницу
использован: системности правила
платформ: платформы
голосован: изменяют
войт: аккаунт
усложня: момента
аккаунт: вакансии
газпромбанк: газпромбанк
сраз: обязательно
порядк: нашей
молекул: добавлял
подробн: подробную
визуа: показал
зависет: готовые
половин: библиотекой
похож: сутки
задействова: останутся
пишет: пишет минимум
яндекс: мегапроекты
новост: разделы
существ: начальник базе
перв: должны готовы
руин: предложите
яросла: ярослав
близк: близка
модалок: примеру
бол: копите какие
гайд: философия
написа: гайды
поиск: плагин поиск
изменен: ломающих сценариях моментальных отзывчивая устойчивой
автоматизирова: фигмы
повед: смотреть
равн: документации
неудобн: компонент
основ: шрифтов определиться делай
прочт: информации
держ: файлов
голов: информацию
боя: апдейту
образовательн: проекты
попутн: попутно
как: проектах ребрендингу лист узнавать покрывает
определ: шрифты токены
содерж: документация
фигм: используется баннер отдельном тяжело обучение
встреча: встречался
тся: прид
применим: желания
реальн: оповещения
тяжел: обновляться
лома: критичные фичи внося
добавл: начале
минорн: мажорные рамках
точн: вендоров
рол: каждую
мен: выпадающими
форм: таблиц
продукт: продуктов используешь продуктами распространить продукт появляется продукта необходимы
признак: полгода
быва: собственное
готов: хватить ожидать будьте фразу продукту хватит
найт: философию
оповещен: получит
образ: таким
геро: героями
маленьк: разносить небольшой
появ: сэкономить
случа: большинстве нашем
удал: планируем текущей
практическ: практически
вернут: поддержка
контур: контуре контура контур
ртву: качества
вершин: применимости
александр: карма
плагина: пользуюсь
обновлен: минорных ломающие
схем: схеме
д: разработчиками
л: л
упадут: стороны
н: н
ожида: многого
изменя: которое оповестить
ошибок: наделать
дава: давайте файлах
х: повторяется
выверя: основа
показа: находится
поэт: поэтому
мин: мин
вариант: менять начальном шаги готового
памят: оперативной
писа: писал договориться
назначен: назначения
исследован: провести
совершен: изменилось
идеальн: подходов
этап: выясниться
скор: скоро переезжать
формирова: формировать
классическ: классической
эльдар: эльдар
аналог: плагинов
получ: образом разработчик раза
синхронизац: изменениях
начальник: либо
публик: публикует
перевод: делает
фронт: твоей поломать общаться обновлять
важн: полочкам являются
останут: дизайны
тестировщик: бизнеса
наработок: отказываться
библиотекар: библиотекари назовут библиотекарями
рук: приходится
час: час
чат: поговорим
внутр: рождаются
ефрем: александр
индустр: стандартом
дешевл: становится
коммуницирова: припиской
подписа: забудьте
специфик: модалок
продуктов: продуктовых
больш: подключите говорим
мест: одном
иде: плохой создаю
модифицир: детачат
направлен: направлений
детачат: меню
инжиниринг: рс
ясн: точно
телегр: телеграм
бест: бест
смогл: надеюсь
редк: библиотекарь
представлен: базово
реализуем: код
генерац: хороший
стыд: своему
идт: картину
версионирова: вопросы
апдейт: какому
мож: можем
момент: внутри какого
шрифт: сетки графики вариативный
лишн: команда
развива: развивал базовые
основн: типографика базовой
сможет: скорее
неплох: поправят
мажорн: релизы одну следующем обновления
отзывчив: гибкая
решен: больших типовое готовых сторонние неплохим
передава: возможность
комментирова: ефремов
средн: средний
личн: личный усложнять изменениям
исчезнет: рассказывать
нужн: нужна фронтом
устаревш: заменить объявляем
кнопок: интерфейсы
меня: намного построено
хаб: интервью
описан: инвентаризации
опыт: личного опытом опыте
мультизам: текста
наполнен: масштабу
ваканс: истории вакансий
настройк: дзен
дал: поля
пониман: компонента понимании
документ: авторов
прочтен: прочтение
увер: инпутов
затащ: знания
забудьт: плохо
лейаут: придумать
подойдут: решения
фотошоп: фотошопе
откладыва: стараемся
дизайнер: экранов интерфейсов упростить дизайнер дизайнеров взаимодействовать задуманного
станет: избыточной
хват: стандартное наполненности
код: затащить коде
конвенциональн: простые
паттерн: общие
модул: отдельных
использует: стартануть
опрос: закинуть
коп: живую
используеш: составляющих
митап: митапах
обновля: глобально числе хуки опыта
привяза: основами
внесен: языке
брат: стоит
понадоб: оттуда сожалению
старт: другим
чит: понимает
версионирован: семантического
фраз: такую
предлож: боли открытые
звук: звуком
возника: аналогов
амбиц: проекта
организовыва: организовывал
глобальн: минорные глобальная источника варианты системами переписать
подключ: разработке
минимум: необходимый
вмест: выясните
тяж: памяти
накидыва: изначально
ошибк: допущенные
жив: работать
обнов: обновить
разработк: начать переделать стоимость разработка
закладк: рейтинг
увидет: страницы
стара: версионирования продуктах
продолжен: части
начал: определить
релиз: делим мажорных голосование мажорном
ориентирова: ориентирована
лист: чистого белый
итог: проще руками
полгод: раскатываться
минут: минут
дел: случаев фронтов ошибочно
вопрос: вопроса вопрос возникают вопросами
объявля: удалить
студ: студии
рассказа: визуал ноутах
макет: инвентаризацию новых
внутрен: внутренней внутреннюю
конвенц: стандартной
устройств: информация
специализир: специализируюсь
переход: модалка
текстов: вашего
ваш: параметрам считать зависеть вес
договарива: упрощать
ответ: ответ идеальный
никт: фич
пространств: пространства
сталкива: рамки
проектирован: дизайнеру
собствен: сво
ручн: помогаю
переписа: нейминга
измен: рассказать
держа: дизайнерам
мамин: маминой
уда: старые
отказыва: бояться
расширен: потребуется
оповеща: ноуты
мегапроект: стартапам
хабр: хабр
сэконом: поможет
смен: исчезнет
обучен: добавил
фрейм: фреймам
аз: азов
обща: важно
базис: описать
родительск: родительскую
наста: понял
общедоступн: общедоступной разные
практик: практиков моей
последн: последние
сам: процессы добавляй ускорить
сутк: лучшие
стартап: программы
инач: руинах
называ: называют
платформен: вроде
длин: читая
переезжа: постепенно
вед: веду
смысл: пункта процесс доходит
начина: появится начинать
стандарт: становятся
вес: использована
вс: вс
ускор: дизайнера понизили самым
начн: начн
семантическ: конвенции
цвет: стилей скруглениям войдут
плагин: посоветуешь помощи пользуются рутинные контента ручную
сво: свой своем понадобится плагинами каждого
веб: веб
взаимодействова: командах
назовут: месте
нача: началась писать начал
реша: хороша траты
фишк: плагины
станов: временем режет
тест: скриншотными
практис: практис
тесн: станет
явля: собранные споры
узн: приложений
помет: причастных
законч: закончим
легас: избавляется
развит: дальнейшем помогать подходить
представ: представил
сайт: сайте устройство
научпоп: научпоп
задач: вашей
файл: повед большой массивных фигма лых
придержива: фронтенде
пользова: рассказал
выясн: разработку проблемы
переш: переш
различн: различных
хвата: стройную
гызы: гызыев
воплот: пользователей
смогут: удалишь
сегодняшн: сегодняшними
перейт: нные
базов: токенов должна завязанную затрагивают основная
треб: файле проект
задума: коммуникации
усложнен: идти
пьес: пьесы
поправ: баги
истор: похожие
ещ: ещ
зрел: ид
довел: довелось
внос: версионировать текущие
гибк: хорошая разрабатывает выстроить
энтерпрайз: маленькую
легк: работу
вид: детачьте ресурс
представител: оунер
конфиденциальн: соглашение
доход: создавал дело
красн: лтый
нескольк: организмы несколькими
договор: встречах
влия: использовать
хот: правок
позволя: отсутствием
избыточн: получим либы
хоч: главное
полома: правки
скорост: устаревшие
рейтинг: хабы
визуализац: визуализации
дор: сложно
сторон: реализовать ясно обе
постав: публикации
обойт: равно
поток: потоки
поддержк: техническая поддержки вместе
остальн: переводит
предпосылк: доходил
принцип: единых
хорош: ртвую ускорили рутину критерия
стоимост: снижает
библиотек: библиотеку пользоваться библиотеки основной файл
ид: речь
организм: молекулы пути организм сложнее
посоветуеш: пользуешься
переделыва: детачить
ин: своя
наш: используйте скорости
пользовател: инструкция будущими
стройн: удобна простой гибкую
компонент: требования стабильности компонентов запихнуть базовыми компоненты глобальных
над: задушит
большинств: специфики
затрат: переделку
разрабатыва: разрабатывать никто
сервис: нескольких
оперативн: нехватка
евген: статью евгений
составля: важнейших
описа: визуальные
информац: держите хотите песочница
подойд: вариант
схож: находит
разрастан: адресных
трат: уменьшает
скрыт: выводить
философ: содержится законы
экран: шаблоны
замен: целый поиску
дочерн: остальные
расставля: расставляем
максимум: работе
вно: новую
поговор: фигму библиотеках созданием поговорил
собра: фултайм элемент
хук: упадут
заточ: заточена
например: например
токен: синхронизации токенах глобальными
правил: декомпозировать
понятн: представление конвенционально
нативн: реклама
масштаб: крупных каждой
декомпозирова: работ
консистентн: переделывать держать
польз: подойд плагина
полочк: раскладывание
уровн: уровня
мо: мо понятно
сист: систему систем
специфичн: специфичных
спецификац: спецификацию спецификаций спецификации
качеств: качестве оценки
пил: спринт
наскольк: узнайте
нехватк: фигме
проблем: решить
раздел: регистрация
вендор: коробочных
намн: разрастании
нек: перегружай
унифицирова: строго
об: пушишь
владимир: владимир
лучш: комментировать
небольш: смыслах
дума: думают
формат: переходит
ок: окей
экстерн: экстерне
интересн: интересна
оп: опыт
возможн: дают командой давала
дальн: тесно
открыт: уверен
допилива: постоянно
менеджерск: менеджерских
функциональн: устраивает
крупн: принципов
оптимизирова: оптимизировать
страниц: скелеты структуры собираем
надела: поняли
наверн: наверное
прежд: подумайте
стабильн: изменений
изначальн: делаете
подговарива: методом
выступа: выступаю выступал
контент: заполнял генерация
втб: втб
стандартн: делаешь придерживаемся
откр: открыть
наход: учебнику плагином
кнопк: скрыть компонентами
источник: источник единого
lamoda: lamoda
ru: ru
workstat: workstation
tone: tone
uui: uui
fiori: fiori
youtub: youtube
twitter: twitter
ui: ui
figma: figma
carbon: carbon
design: design
kit: kit
semver: semver
json: json
daw: daw
audio: audio
api: api
lang: lang
bandlab: bandlab
chatgpt: chatgpt
zeroheight: zeroheight
designop: designops
digit: digital
sap: sap
ux: ux
voic: voice
org: org
usetech: usetech
ant: ant
mvp: mvp
storybook: storybook
facebook: facebook
telegram: telegram
manag: manager
master: master
materi: material
core: core
framework: frameworks
googl: google
alexefremo: alexefremo
ibm: ibm
vk: vk
epam: epam
http: https
habr: habr
base: base
