обрат: обратить
жертв: жертвой
найт: найти
готов: готовиться готовим готовить
апр: апр
говор: говорим
понима: понимали понимаю понимают
информацион: информационная
расскаж: расскажем
занят: занятости
найм: найма
стат: стать статью статье статьи статей статья
оказа: оказалось
стар: старую
инвестор: инвесторов
улож: уложить
рабоч: рабочую рабочего рабочее
конц: концов конце
дорог: дорогие дороге
объясн: объяснить
обзор: обзор
стад: стадиях
реализова: реализовать
работ: работа работе работы работу
питч: питч
показыва: показываем показывают показывать
вернут: вернуться
мероприят: мероприятие мероприятии мероприятия
привлеч: привлечь
получен: полученными
пандем: пандемия
сто: стоят стоит
учебн: учебный
приглаша: приглашаем
тв: тв
утвержда: утверждает
янв: янв
поглощ: поглощены
вообщ: вообще
менеджмент: менеджмент
преврат: превратить
встат: встать
то: той
неприятн: неприятно
ста: ста
присутств: присутствия
ошибок: ошибок
структур: структура
публикац: публикации
скопирова: скопировать
дава: давайте
макс: макс
график: графиков графикой
запах: запахом
ч: ч
балл: баллы
приземл: приземлить
подел: поделиться
перспект: перспектив
показа: показали
поэт: поэтому
котор: которую которому которым
денег: денег
скучн: скучный скучных скучные
времен: временно
ув: увы
провест: провести
мин: мин
присоедин: присоединиться
мир: мире
моделирован: моделирование моделирования
слушател: слушателя слушателей
ум: умом ума
знают: знают
вест: вести
связа: связанных
обратн: обратной
этап: этап
уч: учит
проект: проекте проекты проекту проект проектами
связ: связи
заб: забыть
архипелаг: архипелаге архипелаг
профил: профиль
дела: делает делают делать делаем
аналог: аналог аналога
проектн: проектно проектный
получ: получилось получить
документац: документацию
верн: вернемся верном
режим: режиме
публик: публике
читальн: читальный
верс: версию
важн: важно
нна: нная
маркетинг: маркетинг
тестировщик: тестировщиков
пикап: пикап
книг: книги книга
разобра: разобраться
подушк: подушка
час: час
сосредоточ: сосредоточимся
прост: простой простое простым
внутр: внутри
высококвалифицирова: высококвалифицированных
зал: зала зал
индустр: индустрии
занима: занимающихся
каталог: каталога
глагол: глагол
конструктор: конструктор
встреч: встречи встречам
справедлив: справедливо
лиц: лице
профессионал: профессионалы
дейл: дейли
разумеет: разумеется
уровен: уровень
нов: новые новым новому новое
придума: придумать
софт: софт
больш: больших большой
медийн: медийная
мест: место места
част: часть
сценарист: сценарист
иде: идея
цифров: цифровой
устро: устроился
карьер: карьера
слов: слова слово
офис: офис
направлен: направления направлениях направлениями направлений
фестивал: фестиваль
полезн: полезным полезными
отказ: отказ
определен: определенную
сдела: сделать сделавший
эффективн: эффективной
особен: особенности особенные особенными
сложн: сложный
испытыва: испытывают
упакова: упаковать
надея: надеялись
страшн: страшное
выставк: выставке выставка выставку
представлен: представление
примен: применить
пут: пути
исправ: исправить
работодател: работодателя
виден: видении
активн: активное
денис: денис
пример: примеры
лефевер: лефевер
населен: населения
персонал: персоналом
выход: выходить выходили
техсесс: техсессий техсессиях
пыта: пытаются
узна: узнать узнали
обсужден: обсуждения
упаковк: упаковка
основн: основные основных
бренд: бренда
привлечен: привлечению
диагона: диагонали
вышл: вышло вышла
курс: курсе
текущ: текущим
читател: читателей
ресурс: ресурсы
процесс: процессом процесс
групп: группы
подготов: подготовиться
прослуша: прослушать
решен: решению решение решении решения
постепен: постепенно
хотел: хотел
подготовлен: подготовленным
репетирова: репетировать
актуальн: актуальных актуальны
провод: проводить проводиться
окрылен: окрыленные
средн: средний средняя
продолжа: продолжают
живет: живет
нужн: нужна нужны
домашн: домашнего
почв: почву
подряд: подряд
помога: помогают помогаю помогать
хаб: хабы
рынк: рынку
вечер: вечерам
продвижен: продвижение
скажет: скажет
материа: материала
помощ: помощь
современ: современные
выбира: выбирайте
слайд: слайдов
востребова: востребованы
разработчик: разработчиков
результат: результата
опыт: опытом
секунд: секунд
салют: салют
подразумева: подразумеваю
настройк: настройка
вклад: вклад
дал: далее
отступ: отступит
программиру: программируя
цветн: цветные
документ: документы
прочтен: прочтение
сравнива: сравнивает
предложен: предложение
будущ: будущее
ссылк: ссылку
стейкхолдер: стейкхолдерами
серверн: серверное
навык: навыками
нуж: нужен
заочн: заочно
интерес: интересующие
конкуренц: конкуренция
инвестиц: инвестиции инвестиций
дан: данных
займет: займет
программист: программистов
нудн: нудных
протестирова: протестировать
картинк: картинка
дизайнер: дизайнеров
акустик: акустики
помог: помог
росс: россии
осторожн: осторожно
регистрац: регистрация
ковид: ковид
технологическ: технологических
имеет: имеет
пожалова: пожаловать
цикл: цикл
митап: митапа
счита: считал
эффект: эффект
небанальн: небанальное
причин: причине
камер: камеры
деньг: деньги
конкурент: конкурентов конкуренты конкурентом
вегас: вегасе
цел: целая
предлож: предложить
очн: очным очно
звук: звук
руководител: руководитель
выходн: выходных
дзен: дзен
подключ: подключили
политик: политики
полит: политов
множеств: множеством
вмест: вместе
уход: уходят
пачк: пачку
директор: директор
жив: живой
обнов: обновить
разработк: разработке разработку разработках разработка разработки
закладк: закладки
важ: важен
увидет: увидеть
уверен: уверенные
юл: юлия
начал: начале
писател: писателя
второстепен: второстепенные
руководств: руководству
достаточн: достаточно
примерн: примерно
бюр: бюро
отечествен: отечественных
сюд: сюда
професс: профессий профессии
настоя: настоящее
питчинг: питчинг
список: список
кадр: кадром
знаком: знакомые
терминолог: терминология
прошедш: прошедший
микрофон: микрофонов
след: следующих следите следующее
стольк: столько
тах: тах
напомн: напомнить
дек: дек дека
дел: дело деле
вопрос: вопросы вопрос
дем: демо
дизайн: дизайн
студ: студию
рассказа: рассказать
бесполезн: бесполезные
жит: жить
внутрен: внутренние
севастопол: севастополе
попыта: попытаемся
устройств: устройство
отстройк: отстройка
текстов: текстовой
ваш: вашей вашим вашем
проход: проходившую
ответ: ответа
так: таких таки
видеотехник: видеотехника
картин: картину
творческ: творческих
проектирован: проектирования
течен: течение
техническ: техническую техническим технический технического техническая технические технически
расч: расч
оптимальн: оптимальной оптимального
информативн: информативным
поборот: побороть
уда: удал
раст: расти
фев: фев
бизнесм: бизнесмены
придумыван: придумывания
технологичн: технологичные
вдво: вдвоем
материал: материалы материале
рассвет: рассвете
собира: собирали
мегапроект: мегапроекты
хабр: хабр хабра
подбира: подбираем
инвестицион: инвестиционный
калышкин: калышкин
упуска: упускает
аналитик: аналитиков
видеоконференцсвяз: видеоконференцсвязи видеоконференцсвязь
откуд: откуда
отношен: отношении
рассмотр: рассмотрим
куп: купит
обуча: обучающие
количеств: количество
запитч: запитчить запитчит
служб: служба
соглашен: соглашение
добав: добавить
посмотрет: посмотреть
просмотр: просмотров
мысл: мысли
деврел: деврелов
транспорт: транспорт
последн: последние
зна: знаю
услов: условии
сам: самое самые самых
набира: набирайте
расспрос: расспросили
гибридн: гибридном гибридными
стартап: стартапов стартапам стартапы стартап стартапа
закр: закрыли
друг: друг друга другим
туториа: туториал
автомобильн: автомобильные
инач: иначе
бо: боится
воображен: воображении
поня: понять
подобн: подобного
называ: называет
компан: компаний компании
ицхак: ицхак
рассказыва: рассказывается рассказываем
электрическ: электрический
анонс: анонсами
программ: программы
коммуникац: коммуникациями коммуникацию коммуникация коммуникации
управлен: управление
разбира: разбираемся
главн: главное
действ: действиям
становл: становлюсь
венчурн: венчурного венчурные
складыва: складываются
ценностн: ценностное
иннополис: иннополис
смысл: смысл
вовлечен: вовлечение
заключа: заключается
начина: начинающего начинающий начинающих
привет: привет
стратегическ: стратегическом
вс: вс
сотрудничеств: сотрудничестве
дич: дичью
спикер: спикера
ухаживан: ухаживанием
визуальн: визуальное
утомительн: утомительные
оэз: оэз
созда: создает создаем
окажет: окажется
сво: свой своим
дотошн: дотошного
объясня: объяснять
кейс: кейсом кейс
программирован: программирования
распределен: распределенными
влюблен: влюбленных влюбленность
авг: авг
реша: решать
специалист: специалисты специалисту специалистов
пилотн: пилотного
порог: порог
гик: гиков
забыва: забывают
станов: становится
интернет: интернета интернете
необычн: необычный
московск: московского московском
хранен: хранение
учител: учителя
прода: продать
позиционирован: позиционирование
появлен: появления
регистрир: регистрируйтесь
вещ: вещи
тем: тему темам
репетиц: репетицию
выступлен: выступления выступлениям выступлению выступлении выступлениями выступлений выступлением выступление
законч: закончилась
применя: применять
пришл: пришлось
брендинг: брендинг
администрирован: администрирование
развит: развитие
консультант: консультант
трансформац: трансформации
портфел: портфеле
фотограф: фотографий
представ: представил
приглашен: приглашение
сайт: сайта сайтов
знан: знания
оборудован: оборудования
научпоп: научпоп
технолог: технологиями
эскизн: эскизную
комментар: комментарии
задач: задачи задачам
мотивир: мотивируют
рамк: рамках
трех: трех
сотрудник: сотрудников сотрудникам
хвата: хватает
неочевидн: неочевидно
потоп: потопят
работа: работают работаем работаете работает
песочниц: песочницы песочница
ценност: ценности
долг: долгие
долж: должен
услуг: услуг услуги
блейк: блейк
искусств: искусство
кандидат: кандидатов
блог: блог
необходим: необходимо
отрезвля: отрезвляет
истор: истории
зовут: зовут
модел: модели
клуб: клуба клубе
сложност: сложности
факт: факт
кризис: кризис
вниман: внимание
довел: довелось
комнат: комнате комнаты комнат
закрыва: закрывает
автор: авторы автор автором авторов
сен: сен
репутац: репутации
очеред: очередь
сер: серию
легк: легко
чита: читать
вид: видите видят виду
сет: сети
представител: представителей
конфиденциальн: конфиденциальность
полуслов: полуслова
собеседован: собеседование
заставля: заставляет
умен: умение
подход: подход
науч: научила научиться
тестирован: тестирования
сесс: сессии сессиям
оценива: оцениваются
реальност: реальностью
эксперт: экспертами
спрос: спросить
цепля: цепляемся
бизнес: бизнесы бизнеса бизнес
влия: влияем
инновац: инновации
позволя: позволяют
хоч: хочу
рейтинг: рейтинг рейтинга
распространен: распространенные
компетенц: компетенции
реш: решил решили решился
визуализац: визуализации визуализация
остав: оставим
сторон: сторон
вкс: вкс
поток: потоки
кратк: кратко
вдохновля: вдохновляют
смотр: смотрите
поддержк: поддержка
зада: задают
состо: состоит
набор: набор
профессиональн: профессионально профессиональной
хорош: хороших
ид: идей идеи идею идее
удобн: удобное удобные
сред: среди среде
затянут: затянутые
денежн: денежная
сторителлинг: сторителлинг
социальн: социальные
наш: нашим нашими нашу наших нашем
лайфхак: лайфхаки
редактор: редактора
темплейт: темплейт
чувств: чувствуют
ит: ит
мног: многие многих
пользовател: пользователи пользователей
посвящен: посвященный
люб: любой любое
над: надеюсь
язык: языка
большинств: большинство
погна: погнали
наз: назов
робот: роботы
публичн: публичных публичными
попроб: попробует
оперативн: оперативной
стил: стиле
регулярн: регулярно
захватыва: захватывающими
взят: взять
информац: информация информации
гот: готов
разн: разными разных разные
ультимативн: ультимативных
люд: людям людей
дожд: дождя
фаундер: фаундер
разв: развить
отвеча: отвечаю
интенс: интенсив
год: годы
использу: используя
целев: целевую
предостереч: предостеречь
конкретн: конкретную
снайдер: снайдер
переговорн: переговорной переговорных
беспоко: беспокоясь
переста: перестать
ко: кое
поговор: поговорим
диаграмм: диаграммы
глазков: глазкова
аудитор: аудиторией аудиторию
вывод: вывод
скандальн: скандального
запис: записи
например: например
подготовк: подготовку подготовки подготовке
одн: одном одно
мар: мар
коллег: коллега коллеги
приз: призы
знаеш: знаешь
реклам: реклама
запуст: запустили
забот: заботиться
презентац: презентация презентации презентаций
настольк: настолько
корпоративн: корпоративный
страх: страхи страх
рекомендац: рекомендаций
понятн: понятную понятным
соответств: соответствуют
нативн: нативные
одинаков: одинаково
фэйл: фэйлов фэйл
шаблон: шаблонов
инструмент: инструменты
выда: выдать
доклад: доклада докладов доклад доклады
адизес: адизес
команд: командах команда команду командой командами командам
ведущ: ведущими
обстоятельств: обстоятельства
маск: маска
сообществ: сообществом сообщества
познаком: познакомились
учат: учат
рассмотрет: рассмотреть
участ: участие
десятк: десятки десятков
разбежа: разбежалась
свет: свет свете
уровн: уровня
платформ: платформе
потрат: потратить
сист: систем
душ: душ
войт: войти
накоплен: накопленные
нечт: нечто
качеств: качество
недоступн: недоступны
участв: участвуют участвуйте
фонд: фонд фонда
организ: организую
аккаунт: аккаунт
топ: топов топ
глаз: глазами глазах
выбор: выбор выбора
деятельн: деятельности
наскольк: насколько
докладчик: докладчик докладчика докладчикам докладчиков
лас: лас
онлайн: онлайн
порядк: порядке
проблем: проблемы проблемам
холодн: холодный
но: ноя
подробн: подробно
раздел: разделы
выигрыва: выигрывайте
яндекс: яндекс
новост: новости
лучш: лучшие лучших
существ: существует
перв: первую первой первого первая
инновацион: инновационные
формат: формате формат формата форматы
дума: думать думают думайте
посет: посетила
написа: написать написал
добр: добро
поиск: поиск
интересн: интересных интересные интересным интересно интересный
возможн: возможности возможность возможно
оп: опыт
предновогодн: предновогодним
заказчик: заказчика
равн: равно
артист: артисты
американск: американский
посвяща: посвящается
привыкл: привыкли
мед: медиа
маркетингов: маркетинговая
демонстрац: демонстрации
сердц: сердца сердцем
образовательн: образовательный образовательные
семантик: семантика
участник: участники
подтвержд: подтвержден
крупн: крупные
зимн: зимнюю
голос: голосов
преодолен: преодоления
площадк: площадку
взгляд: взгляд
переговор: переговоры
вебинар: вебинар вебинаров вебинарах вебинары
прошл: прошлой
высок: высокого
прежд: прежде
реальн: реальную
гаджет: гаджеты
креативн: креативный
точн: точный
выступа: выступать
прежн: прежнему
контент: контент
коммуникацион: коммуникационном
точк: точки
сфер: сфера сфере
партнер: партнеров партнерами
откр: открыть
видеокамер: видеокамеру
способ: способ
июл: июл
форм: форму
июн: июн
наход: находится находить
илон: илона
подбор: подбора подбор
продукт: продуктом продукте продуктов продукт продуктах
конференц: конференции конференц конференциях
источник: источник
рекоменд: рекомендует
delltechteam: delltechteam
data: data
tesla: tesla
glagol: glagol
baragol: baragol
ventur: ventures
dai: day
mode: mode
technolog: technologies
ted: ted
twitter: twitter
incubat: incubat
ragequit: ragequit
slidelab: slidelab
mianoki: mianoki
mastervlado: mastervlados
powerpoint: powerpoint
digit: digital
tech: tech
marinabarayeva: marinabarayeva
edison: edison
develop: development
vitaliyaletnitskaya: vitaliyaletnitskaya
mcbernar: mcbernar
miran: miran
vk: vk
futur: future
stss: stss
lisa: lisa
habr: habr
ancotir: ancotir
maxpolitov: maxpolitov
vr: vr
anadezhdina: anadezhdina
itsumma: itsumma
lamoda: lamoda
game: game
hetcob: hetcob
glazkova: glazkova
bf: bf
powerlexi: powerlexis
busi: business
drobushevkii: drobushevkiy
global: global
demo: demo
minaeva: minaeva
youtub: youtube
ignatchuk: ignatchuker
rss: rss
julia: julia
yushkevichv: yushkevichv
lozga: lozga
recoveri: recovery
dive: diving
usikoff: usikoff
kreichik: kreichik
ce: ces
alizar: alizar
markshevchenko: markshevchenko
itismarket: itismarketing
center: center
facebook: facebook
telegram: telegram
zoom: zoom
ky: ky
dell: dell
maxilect: maxilect
lukina: lukina
stem: stem
