говор: говорить
покуп: покупая
аудиодорожк: слушать
проектирова: проектировать
стат: стать статье статьи статья
леж: лежит
стар: старую старые
оказа: модулями
стал: стали стало
мнен: бытует
апд: недавнем
беспорядочн: беспорядочным
стад: финальной
полноразмерн: полноразмерной
реализова: реализован
работ: работая работы работу
показыва: показываю показывать
ст: ст
дополнительн: либо
лидир: лидирующие
получен: источников
инфраструктур: инфраструктура
сто: уйти нм
финальн: далеки
менеджмент: менеджмент
поступ: адаптере
экра: экрана
каса: масштабируемость
то: той
пробел: пробелы
светодиодн: светодиодные светодиодных
публикац: разделы
скопирова: скопировать
макс: станции
подел: поделиться
жестк: жестких жесткой
запас: запасы
благодар: благодаря
назван: название названием
котор: котором развития которым
биотехнолог: биотехнологии
видеокарт: производительные
связа: связанное
прав: право
вовс: делается
либ: каких
проект: нативные
связ: связь зарядовой
операционник: операционниках
профил: профиль
дела: делает делалось делать потребовалось ускориться развивает
приветств: приветствую
сут: сути
голосов: звук
документац: получил электрониками
читальн: читальный
верс: вернуться
маркетинг: маркетинг
приблизительн: приблизительно
книг: книга
разобра: разобраться
центральн: центральное
прост: простой простые
врем: времена
нно: нной
позвол: позволяя позволит
зал: зал
рубл: рублей
занима: занимают изначально
совместим: совместимы
уровен: уровень
нов: новый новые новых новое
литографическ: литографического
медийн: корпоративный
динамическ: динамической динамическую динамическая
цифров: цифровое цифровые
техпроцесс: понятно
слож: сложа
слов: слов словам слову
одновремен: одновременно одновременного
сдела: сделай сделано сложно
определен: определения определенной неудивительно
сложн: сложные сложный сложнее единицы
камн: камнях
любител: любителей
примен: применить
пут: путь пути
активн: активно
пример: примера
зарядов: ионах
квантов: физика полноценного складывается снизился
упрощен: упрощенных
завоева: завоевал
узна: делают
накача: накачай
торгов: торговой
персональн: персональных
темнот: темноте
нема: немало
дистанцион: дистанционного
южнокорейск: южнокорейской
текущ: текущая
облада: обладающий обладает
сша: сша
ресурс: ресурсов
шт: шт
метод: великобритания
процесс: процесс
помогут: помогут
техник: техники
хотел: хотелось
маломощн: маломощных
масштабирован: используются
подряд: подряд
помоч: помочь
помога: помогают
рынк: рынке рынка
телевизор: вашего
современ: квантовые
индикац: индикацией индикацию индикация
лучев: лучевой засветки
разработчик: разработчики
склад: склады
эхоподавлен: решений
вклад: сюда
промышлен: промышленность китайской
слога: слоган
произнос: произносить
текст: тексте
сигнал: сигналов
робототехник: робототехники
будущ: будущее
наоборот: наоборот
лазерн: скорости
нул: деле
считыва: считывать
масштабируем: компьютера
программист: программист мнение документации
потребова: фотошаблон удалось обновление
приобрета: приобретается
росс: платой
регистрац: войти
четырех: четырех
ситуац: ситуации подобная
отсутств: отсутствия
причин: причин
поднебесн: поднебесная
цел: целях целым
цен: цены
кажд: каждого каждому
дзен: мегапроекты
взаимодейств: взаимодействие
аудиосистем: качественная
тактильн: тактильное тактильных тактильные тактильной
искусствен: искусственного искусственная искусственную
параллельн: параллельно
довод: доводилось
серьезн: аналитиков
гидропон: гидропонных
графическ: реальном графический
логик: логике логики
желез: железо
юн: юным
стратег: стратегии
десантник: десантника
контейнер: контейнер
примерн: примерно
установк: установку
оснащ: оснащ
блестя: блестящего
сюд: разработке
професс: профессии
список: список
коробочк: коробочку
исключат: исключат
ремонт: ремонт
прошедш: прошедших
организац: никакая
дизайн: дизайн
невозможн: невозможной
производительн: производительностью китая производительность производительности
электронщик: электронщиком электронщиков
помим: помимо
попробова: попробовать
коротк: короткая коротко
так: таких
общен: общения общение
публикова: блоге
недавн: голосовые
сниз: глобальном
техническ: нетривиальных языка
фев: фев
заметн: заметные
назва: названо
заметк: заметка
собира: собирается
привлекательн: привлекательных
аналитик: аналитика данным
обсуд: эхоподавление
некотор: некоторых некоторым
отступлен: отступлением
клавиатур: клавиатурой
количеств: количество масштабирования
соглашен: документы
расшифровыва: расшифровывается
собеседник: собеседника
попа: попала
добав: ним добавить прошивки
просмотр: просмотров кабелю
солнц: солнце
дополня: дополнялись
паяльник: паяльник паяльниках паяльнике
беспроводн: беспроводные беспроводную
пластин: пластин
интеллект: интеллекта
вдохновен: вдохновением
кабел: кабелей вывода
приход: приходится
правильн: правильно правильной
поня: понять
компан: компании крупных
программ: программы
ограничен: ограничениях
вчер: вчера
получа: получаем
действ: действия
привел: привело
понг: пинг
видеозвонк: видеозвонки
рад: радио
использ: связью
объясня: объяснять
ран: ранее
кейс: кейс
передач: передачу передачи передача
интернет: интернет интернета
реализац: реализациях реализации реализациями
носим: носимая
применя: применяла
официальн: официальное
великобритан: сассекса
относя: относящейся
полн: учесть
администрирован: администрирование
пользовательск: пользовательской
фотограф: фотографии
микросх: микросхем
предусмотр: предусмотрен
периодическ: периодически
питан: питания
комментар: комментарии
поставк: поставку упали
штат: штатов штаты
конкурирова: конкурировать
физик: кубитов
проч: пк
компьютер: компьютеры квантового квантовыми
сильн: сильного сильным систем
работа: работает
коснул: поставки
песочниц: хабы
исключительн: исключительно
десятилет: десятилетий
услуг: конфиденциальность
уменьш: уменьшили
телефон: телефонами телефонного
высококачествен: высококачественных
блог: своем блог
числ: проблема
интерфейс: интерфейсы
модел: модели
сложност: сложности
пенат: пенаты
исправля: исправляет
девайс: девайсы девайса
автор: авторы вклад автором
чита: читать
виде: видео
разрешен: разрешения разрешением
дальност: дальности
оценива: оценивающий
эксперт: экспертов
спрос: спроса
выруча: выручают
выраст: вырастил вырастить
бумаг: бумага
выручк: выручка
коньяк: коньяк
реч: речь
реш: решил решить решили решено
отрасл: отрасли отрасль
общ: компаний
объ: общий
набор: набор
поддержива: поддерживает
включ: включая
изобретен: изобретения
обм: обмен
социальн: социальные
слыш: слышим
оседа: пассивно
видеочип: собственные
мног: многие
люб: любит
восстанавлива: восстанавливают
снят: снять
сущност: сущностью
язык: настройка
крупномасштабн: крупномасштабные
разъ: разъ
разн: разный
письм: письма
производител: производителями производителей
звен: звено
пакет: пакет
потеря: потеряла
почуд: почудилось
вывод: поддержку
прич: причем
прикинут: ом
производств: производство производстве производства
знает: кк
одн: одном одна одно
мал: малый
семя: семян
продаж: узнать поступил
широк: широкий
мар: мар
согласн: согласны неудачным
отчаст: отчасти
межмодульн: понг
реклам: медийная
настольк: настолько
корпоративн: услуги
тов: тов
расширя: расширяет
нехитр: нехитрые
доклад: докладе
выда: устройств
команд: команда
маск: маски
сообществ: сообществах
огранич: ограничить модуле
заслужен: заслуженно
материнск: продажи
врод: вроде
электрон: электронно электронной электронную прошлый
инструкц: инструкцию
микроконтроллер: микроконтроллерах микроконтроллеров
использован: использование использования использовании
поскольк: поскольку
войн: войны
горазд: гораздо
войт: аккаунт
нечт: нечто
массов: массового
процессор: процессоры
аккаунт: лучших
эмоц: эмоции
порядк: стоимость литографа
подробн: подробности
поспрашива: поспрашивала
болезн: детские
повин: повинен
вполн: вполне
продума: продуман
выража: выражаются
яндекс: макс
университет: университета
новост: новости
существ: существа существует
достижен: проблемах
столбик: столбиков
поиск: поиск
преодолет: которую
основ: основе
планир: планирует
образовательн: проекты
участник: участника
как: мозге
недостаточн: недостаточной
голос: голосом голос голосов
почкин: почкина
содерж: содержит
кат: катом
рассматрива: рассматривать
расточительн: расточительные
пассивн: понятия
фильм: просмотре
освобод: освободить
прошл: сильно
высок: высокая рекордно
реальн: реальным видеочипы
гаджет: гаджеты
рекордн: оказалась
неслаб: вовсе
редис: редиса
форм: форме
мер: меру
компьютерн: компьютерное
продукт: продуктах продукт
улучшен: улучшение
учен: ученые ученых
ждет: ждет
конц: концов конце
найд: найдем
аспект: аспекты аспектом
обзор: обзору
электроник: электроники электроника прикинуться
случа: случай случае
успех: успехи
запуска: запускать
удар: удар
вернут: вернуть поддержка
мозг: нашем
грех: грехи
схемотехник: схемотехника
сокраща: сокращается сокращать
обновлен: аудиодорожку
санкц: санкции неслабых
схем: схему
вообщ: вообще
и: ии
прототипирован: прототипирование
гидропоник: гидропоника
стремлен: стремление
преврат: превратить
н: н
редкост: редкостью
дава: давайте
навея: навеяли
показа: показан показано
ощущен: ощущения
мин: мин
вариант: вариантов
мир: миром мире
писа: писали
выдержа: выдержать
исследован: исследования
идеальн: идеальны
выраз: выразиться
кризисн: кризисного
получ: получила лэптоп получилось получить
прототип: прототипов
приобрел: приобрел
перевод: перевод
важн: важна важным
воспроизведен: делали
рук: руки
час: час часов
выпущен: выпущенном
млн: порядка
детск: глюки
индустр: индустрии
позиц: позиции
побыстр: побыстрее
больш: большее большими большую
китайск: публиковали
мест: место
иде: идеей
направлен: направлении
аналогичн: аналогичной
полезн: полезных
заядл: заядлым
видет: видеть
гран: грани
виден: видение
жал: жал
пинг: квантовый
кит: решению
полноцен: существовании документация преодолеть
мом: мом
отклик: отклик
развива: развивать нуля
крышк: крышку
математик: математика
единиц: описать
основа: основанных
пойма: поймать
психологическ: психологические
привест: привести
решен: чипа нашему решение технических решения
легкост: легкостью
тыс: стоить
передава: передавать
средн: средний
нужн: нужна
почв: почве
меня: менялись
далек: сделать
хаб: публикации
драгоцен: драгоценные
вызыва: вызывают
опыт: опыте
продвинут: тыс
подавлен: историю
настройк: дзен
явлен: явлениях
дал: далее
документ: сайта
прочтен: прочтение
ссылк: ссылку
вдохнов: вдохновить
захвачен: касается
акрон: акроним
дан: данными данных согласно данное
весьм: весьма
быт: россии
состоя: комплект
акустик: хорошая
кож: кожу кожа
утолщ: утолщить
модул: ионов ионных
немаленьк: немаленькие
объяснен: дополнительных
кругл: круглым круглый
установок: установок
генератор: лазерного
используем: размером
понадоб: понадобилась
достиг: достигая
доступн: доступны
дерев: деревья
звук: воспроизведения дом
возника: возникает
границ: границах
сохран: сохранность
глобальн: поставок
подключ: акустика
чип: используемого чип чипов
достич: достичь
обнов: обновить
име: имеем
гонконг: гонконга
разработк: продажу разработка
закладк: закладки
паден: падение падения
разработа: разработали разработан итоге
важ: важен
начал: началом
возвращен: возвращение
заня: масок решением
совершенств: совершенство видеокарты
полупроводников: полупроводниковые
итог: санкций
лидерств: лидерство
дел: китайцев дело
вопрос: вопросы
устройств: устройствах устройство количества устройства электронных
ват: ватой вату
размер: ограничено
недоч: недоч
энергоэффективн: энергоэффективный
неудачн: выдался
ваш: фильмов
ответ: ответы
порт: порт
полност: полностью
творческ: творческий
сталкива: сталкиваются
срок: состоять
собствен: собственной собственных подавлением разработал
ион: захваченных число метод
станц: звука
сенсорн: сенсорной
суток: нескольких
существован: знает
уда: высокой
алгоритм: алгоритм алгоритмы
расширен: расширения
сассекс: занялись
уильям: уильяма
мегапроект: стартапам
хабр: хабр
смен: сменились
сэконом: сэкономить
карандаш: карандаш
радиотехник: радиотехники
австр: австрии
наста: настал
кита: китаю китаем китай
интроверт: интровертам
полива: поливать
месяц: занять
сам: самое самые
качествен: качественном подключена
диагонал: диагональю
учест: суток
стартап: образовательные
пластиков: пластиковый пластиковую
туториа: туториал
инач: иначе
подобн: объяснений
давлен: давлением
точност: точности
фотошаблон: генератора фотошаблонов фотошаблоны
неожида: неожиданные
беспощадн: беспощадная
допуска: допускаемых
укроп: укроп
складыва: ситуация
смысл: смысле
недорог: недорогом
предполага: предполагает
начина: начинающих
стандарт: стандарта стандарт стандарте
расстоян: расстоянии
вс: вс
прогноз: прогнозы
популярн: популярное популярность
ускор: стоит
научн: научных научно
минеральн: минеральную минеральной
сво: свой болезни
программирован: программирование
порог: порог
станов: млн
попробу: попробуем
масок: комплекта
парт: партий
явля: является
появлен: появлением
вещ: вещи вещей
неудивительн: получения
дорогостоя: дорогостоящее
развит: стадии развитию развитие
попиксельн: попиксельное
упита: упитанным
сайт: информация
оборудован: оборудования
научпоп: научпоп
технолог: технологий технология технологии
перейд: собственного
задач: задачу задачи
происход: происходит
точек: точек
различн: различными различных
истощ: истощились
кубит: перенос
пар: пару
посвящ: посвящена
вин: вина
истор: истории обсудим
пробл: проблем проблему
уйт: легко
налад: наладить
легк: продвинутого
представител: представители представителями
вид: вида
конфиденциальн: соглашение
дюйм: дюймов
корпорац: корпорации
ищут: ищут
долгожда: долгожданным
прошивк: апдейте
естествен: естественно
нескольк: несколькими потребоваться
памя: память
позволя: позволяет
пережива: переживает
хоч: хочу
городск: городского
рейтинг: рейтинг рейтинга
скорост: порядки программисту
дом: умный
способн: способна
постав: поставили поставить поставил
сторон: сторон
поток: потоки
сид: сидят
поддержк: техническая добавили
раздува: раздувать
дня: дня
модульн: модульным модульный
принцип: принцип
родн: родные
хорош: хороша телевизора
предназнач: предназначен
стоимост: учитывая
ид: ид идею идее
звонк: звонка
предыдущ: предыдущей
ин: ином
наш: оседают перейд
моделирова: моделировать
пользовател: пользователями пользователей
выращиван: выращивания
успешн: успешно
фоторезист: фоторезист
плат: полноценной платы материнских
большинств: большинство
сил: силы
умн: яндекс
план: плане
оперативн: оперативная
информац: информации песочница
описа: описанная полноценно
трансивер: трансиверами
анализ: анализу
замет: заметили
микрозелен: микрозелень
кк: компьютерами
понят: термины
упа: упала серьезно
ко: ко
спектроанализатор: спектроанализатор спектроанализатора
текс: тексье
поговор: поговорим
квартал: квартале
собра: собрано собрать
адаптер: графическом
идет: идет
например: например
картинок: картинок
понятн: становиться
прикосновен: прикосновение
нативн: реклама
поставок: объем
нидерланд: нидерландах
познаком: познакомить
стран: страна
мм: мм
сист: прочих
ноутбук: ноутбуки ноутбук ноутбуком ноутбуке
качеств: качестве
вычислительн: вычислительных вычислительной
комплект: срок полный
позитив: позитивом
государств: государства
нехватк: нехватки
штуковин: штуковин штуковины
нм: техпроцесса
проблем: проблемы промышленности проблемами устройстве
дешевет: дешеветь
поставщик: поставщиков
раздел: регистрация
намн: намного
параноик: параноиков
маркировк: маркировки
нетривиальн: потребовало
лучш: авторов лучшие
микросхем: микросхемы
оз: озу
небольш: небольших добавился небольшое
ом: занимались
литограф: литографии лучевого
крайн: крайне
возможн: возможности возможных
интересн: интересной интересных
американск: американское
открыт: открытый
увелич: увеличить
учитыв: месяцев
отображен: отображения
перенос: межмодульный
функциональн: функциональностью
многоапертурн: многоапертурное
крупн: коснулось
китайц: достижениях
засветк: скорость
пк: плат
санкцион: санкционным
взгляд: взгляд
растен: растений растениям
отрицательн: отрицательном
изначальн: организациях
выпуст: выпустили
глюк: совершенства
пада: падают
откр: открыть
наход: находится
опенсорсн: опенсорсных
лэптоп: небольшой
никак: никаких никак программистам
конструирова: конструировали
источник: современном
термин: определенные
слуша: аудиосистема
lm: lm
sourc: source
asu: asus
msi: msi
ruvd: ruvds
duv: duv
data: data
usb: usb
dii: diy
amartolog: amartology
seleditor: seleditor
usd: usd
asrock: asrock
ua: ua
canon: canon
enhanc: enhancement
usbchardwar: usbchardware
cloud: cloud
mode: mode
twitter: twitter
aabzel: aabzel
dram: dram
host: hosting
mastodon: mastodon
arfi: arfi
annu: annus
alekdikarev: alekdikarev
oldfashionedengin: oldfashionedengineer
multipl: multiple
im: ims
selectel: selectel
armmast: armmaster
hdmi: hdmi
dry: dry
mtt: mtt
iv: iv
translat: translate
reform: reform
horribili: horribilis
miran: miran
resolut: resolution
kopchenii: kopcheniy
vk: vk
habr: habr
firstvd: firstvds
aec: aec
evgeni: evgeny
miniwar: miniware
pine: pine
euv: euv
bright: bright
timeweb: timeweb
compani: company
mapper: mapper
firstjohn: firstjohn
smee: smee
youtub: youtube
nikon: nikon
samsung: samsung
rss: rss
arf: arf
apertur: aperture
web: web
konstantinc: konstantinc
elezarkun: elezarkun
recoveri: recovery
yuripanchul: yuripanchul
pixel: pixel
sagidullin: sagidullin
krf: krf
zhovner: zhovner
gigabyt: gigabyte
greiv: greiv
kikot: kikot
neurram: neurram
center: center
facebook: facebook
telegram: telegram
promwad: promwad
pinecil: pinecil
mnt: mnt
framework: framework
bluetooth: bluetooth
asml: asml
dmytro: dmytro
open: open
olartamonov: olartamonov
pocket: pocket
