говор: камеру
значен: опускается среднего
образ: плюсе
стат: стать статью
стар: вернуться взял
обычн: столько
конц: подходил
ждет: сюрприз
стал: аудитория изменилось писали
соглас: контента
обзор: эксперементировал получали
появ: рейтинг
работ: кжается работы договорились
показыва: плохо показывать
сценар: писать отнимала
вернут: техническая
принос: приносит монетизации интересно дальнейшем вышел
поигра: ищут
стример: длинее
просматрива: самый
человек: выпуски
реанимирова: собирать
инвестирова: данный
вообщ: платил
менеджмент: менеджмент
п: п
публикац: пользователь
дава: давать показатель
скромн: забил
показа: показал
назван: помощь
котор: которыми
карм: комментарии
времен: правда
опуска: февраля
мин: делали мин
писа: предложил писал популярыми
вест: вести
связа: переломный
ур: выходит
либ: либо
проект: хобби нативные
скоп: налажены
конец: топе
весн: проблема
феврал: счет январь
заб: роликов
профил: профиль
дела: делал делалось делать набирается нужны
получ: ютуба
вложен: мое
узнава: узнавал
верс: старую
важн: периодически
маркетинг: маркетинг
увеличива: тайминг
экономическ: спроса
час: часов
прост: простой
фидбек: фидбек
свободн: свободное
занима: занимало озвучивал продолжать
заработа: заработали
крипт: бизнесом недвижимостью
уровен: уровень
нов: формате новое возобновить
медийн: блог
монетизац: тематики цель
част: часть
ждат: рад
счет: свой
вход: порог
направлен: направлении некоторе
недвижим: автомобилями
кана: историю канал
игр: разработчиков игре игры игр игру играм
полезн: полезного
системн: системном
сдела: сделать
определен: смотрел топа
субботник: субботники
телегр: ссылка
выкладыва: выкладывали выкладывать
сложн: сложно
скле: старые
совет: советы
пут: путь
виден: пайплан
активн: моем
заикан: переснимать
заказа: обложку
идт: увеличиваться
выход: помощника новом наступает стабильно выходят
мог: инвестиции
вкладыва: позволяет
провал: провалился
наступа: среднем
узна: узнать достиг
итерац: кнаалов
момент: сфере момента
пошл: выход
монтирова: монтировать играх
развива: развивать развиваться концу отнимает
смог: уровня
популяр: становятся
монтажор: требуется требовался
сша: сша
подписчк: примерно
процесс: наладили
шел: ролик
хотел: сегменте смотрят
расскзата: могу
актуальн: актуальную
провод: проводить
средн: отличии тему
продолжа: развить
нужн: никому
бесплатн: делаю продвигать
помога: расходы
хаб: доход
описан: название
нрав: нравились
материа: скопилось
помощ: вел
выш: входа
гугл: появилась
разработчик: разработчикам переговоры собирал разработчик разработчики
настройк: дзен
показател: количеству дни
документ: компаний
прочтен: прочтение
будущ: будущую
карма: какие
ссылк: каналах
отнима: муторная протяну
вдохнов: вдохновившись
конкуренц: темы
инвестиц: крипту
сравнен: пошел
дан: вкладывать
тэг: описание
состоя: стала
плох: мини
детальн: детальной
регистрац: войти
монтаж: сценарий
приммерн: ежемесячно
автомобил: криптой
счита: бесплатный
причин: причинам
камер: момент
деньг: деньги
пошел: быстро
новостн: игроки
цел: новый заключение
переломн: человека
цен: откуда
предлож: подписчик
достиг: смотря
кажд: виде выходили
дзен: яндекс
кнаал: ведение
канал: канале связался ждать
разбор: разбор
зарабатыва: зарабатывает
создава: создавать
жив: бесплатно добавляю
обнов: обновить
веден: людям
сегмент: русскоговорящем
разработк: разработка разработки
обложк: обложками идти занимался обложки
закладк: добавить
стара: каши
стратег: экономические
примерн: стало
добавля: пишет
метрик: метриками
релиз: релизу релиз релиза
список: список
намерева: сообщества
скриншотн: скриншотные
тематик: интересна знал
итог: итоге
минут: шел
стольк: показывали
возобнов: попробую
нашел: нашел
дел: значения
вопрос: написали
дизайн: дизайн
студ: крупной
игра: роли
устройств: песочница
коротк: короткие
ответ: ответ
так: таким
никт: реанимировал
инд: инди
озолот: озолотиться
техническ: языка
измен: сильно
раст: пошло
август: августе
собира: одно сработало собирало отдельные
мегапроект: стартапам
хабр: хабр
откуд: инвестировал
некотор: задали
иска: искал
куп: купить
количеств: количество каналы
соглашен: документы
оформлен: оформление
обложек: обложек
добав: голосов
просмотр: стали просмотров
месяц: продержал месяц
сам: какую скажу набирает
набира: прибавил рассказываю
скаж: стратегии
паблик: паблике
друг: другим сравнении
сутк: лучшие
стартап: программы
поня: разработчиками
рассказыва: рассказывал очередь убыток
компан: авторов новости
длин: подписчков
программ: образовательные
выглядел: выглядели
получа: получаешь лучших
эксперементирова: популярную
предполага: предполагать
вк: вк
вел: активно
игрок: игроков очереди состоять
вс: работа
популярн: самую
пропиар: пропиарить
рад: тематика
раз: увеличились
сво: содержать своем
ран: материала
ролик: сценарии ролики ролика увеличить выпуске производству
помн: цена
нача: начало начал
отдельн: обзорами
отобража: обложке
проссмотр: канала
порог: заикания
станов: рассказывать
убыток: производство
тег: внимание
игров: игровой игровые
хобб: моих
сработа: роликах
тем: определенную определенные
администрирован: администрирование
развит: видение
заливк: заливки
периодическ: проссмотров
сайт: устройство
знал: любопытоство
научпоп: научпоп
продолж: поиграть
ежемесячн: приносил
комментар: закладки
муторн: равно
цент: хочу
работа: работал
сильн: временем
песочниц: авторы
услуг: конфиденциальность
подписчик: подписчиков помощник
треб: вопросом
блог: корпоративный
истор: просматриваемый похожие
напиш: напишу
цифр: цифрами
прова: провала
сложност: сложности
вниман: телеграм
автор: компании сайта автором
выйт: выйти
очеред: живую живой
лонгрид: лонгрид
чита: читать
налад: итераций
вид: ним
конфиденциальн: соглашение
виде: видео
налаж: развивался
проолжа: принципом
подход: топ
гуглпл: гуглплей
доход: заработок источник
ищут: топы
быстр: быстрее склеил
заключен: помним
договор: роликам
спрос: конкуренции
бизнес: приносят
вышел: самые
выраст: перестал
позволя: дохода
хоч: пишу
прибав: заниматься
набра: набрать
дни: приносить
рейтинг: высокий
реш: решил
поддержа: поддержать
поток: потоки
смотр: принципе получил
поддержк: вложение
зада: студии
недел: неделю
поддержива: проолжать
пройдет: пройдет
дня: дня
принцип: развивается вообще моим
серг: карма
продвига: помогать
творен: творения
ютуб: цента ютуб
пользовател: сергей пользователей
люб: форма любит
плат: проектах работу
принес: февраль
сюрприз: близка
язык: настройка
затрат: окупали
план: план
разрабатыва: разрабатываю разрабатывать
попроб: вырастит
содержа: давало
стим: стиме
эпизод: эпизоды
информац: информацию информация информацией
правд: шаблону
гот: готов
взял: выбрал
люд: платить
дневник: дневник
разв: смогу
протян: понял
отвеча: отвечаю
целев: целевую
требова: думал
переста: месяца
аудитор: аудиторию важно
потеря: потерял
собра: другими
тайминг: выходить
отбива: целей
расход: карманные
русскоговоря: реально
производств: выше затраты
одн: отображать каждую
реклам: медийная
корпоративн: услуги
нативн: реклама
попрос: попросить
помощник: согласился хотел
шаблон: направление
сообществ: поддержка
плюс: думаю
любопытн: скромный
петличк: говорить
заработок: теги
смотрет: смотреть
январ: приммерно
уровн: уровне какого
отлич: собрал
любопытоств: монетизацию
продержа: новостные
мо: принцип некое намереваюсь показатели
четк: расти
консол: консоли
переснима: вешать
смотрел: никто
войт: аккаунт
аккаунт: истории
топ: поддерживать дело раза конец
веша: петлички
счаст: ура
сраз: сразу
пиш: играло
проблем: стримеров
трейлер: трейлеры
раздел: регистрация
кжает: минут
похож: сутки
пишет: желающий
пайпла: четкий
жела: любой
нек: считаю
яндекс: мегапроекты
новост: разделы
лучш: ждет публикации
перв: первые
формат: продолжил
дума: монтажор интересных
близк: развитие
написа: написать весной
поиск: поиск
интересн: игрокам образом счастье
возможн: принес
каш: одну
дальн: отбивало
равн: вс
планир: планируют
выбра: ранее
увелич: тэги просмотры
учитыв: учитывая
образовательн: проекты
хочет: хочет
как: старался узнал приносило
крупн: заказал
голос: хабы
страниц: страниц
окупа: хотелось
переговор: монтаж
коварн: коварный
выпуск: обычные каждом
высок: обзоров
реальн: любопытно
стабильн: процессы
выпуст: возможно
рол: значение
контент: контенте монтажора
ник: собирает
сфер: расскзатаь
откр: открыть
форм: гугл
ретроспектив: ретроспектива
озвучива: монтировал
источник: выпустил
magic: magic
aaa: aaa
twitter: twitter
vk: vk
facebook: facebook
telegram: telegram
habr: habr
hero: heroes
steam: steam
greenolor: greenolor
seo: seo
youtub: youtube
