быва: бывают
готов: готовиться
найт: найти
оценк: оценка
говор: говоря говорят
проработк: проработки
информацион: информационная
расскаж: расскажем
туннел: туннель
рассказ: рассказ
заверша: завершается
стат: стать статье статей статьи статья
автоочистк: автоочистки
обычн: обычное
стар: старую
повторн: повторных
вызов: вызове
рабоч: рабочие рабочих рабочей рабочего
учет: учетом
ждет: ждет
служ: служит
гибкост: гибкость
обзор: обзор
сл: сл
случа: случаев
един: единая
органическ: органических
реализова: реализовать
работ: работа работу работы
запуска: запускали
показыва: показывать
практическ: практический
доступ: доступ доступен
сценар: сценариев
вернут: вернуться
под: поды поде
сетев: сетевую сетевые сетевых
принос: приносит
инфраструктур: инфраструктура
учебн: учебный
основан: основания
тд: тд
специализирова: специализированных
менеджмент: менеджмент
интеграц: интеграции
л: л
местоположен: местоположение
н: н
мобильн: мобильного
знакомств: знакомство
должн: должны
ошибок: ошибок
публикац: публикации
скопирова: скопировать
дава: давайте
подел: поделиться
разбива: разбивают
призм: призму
сезон: сезон
ы: ы
котор: которыми
ув: увы
девопс: девопсу девопс
мин: мин
вариант: вариант
мир: мире
реализовыва: реализовывать
конспект: конспект
обсужда: обсуждаем обсуждали
мультитенантн: мультитенантном
безопасн: безопасность безопасности
интервьюер: интервьюера
двига: двигаться
либ: либо
проект: проектов проектам проекты проекта
феврал: февраля
удаст: удастся
появля: появляются
профил: профиль
сообщен: сообщений сообщение
получ: получить
документац: документацию документация
верн: верно
перевод: перевод
верс: версии версию
важн: важно
дистрибутив: дистрибутива
провел: провели
защ: защите
маркетинг: маркетинг
книг: книга книгах
сосредоточ: сосредоточена
чат: чат чате
прост: простое простая простого простой
внутр: внутри
трафик: трафика
нно: нное
выстав: выставить
задачк: задачки
позвол: позволят
индустр: индустрии
занима: занимаемся
могл: могли
администрирова: администрировать
ярк: яркой
встрет: встретить
повышен: повышения
уровен: уровень
нов: новые новым нового
больш: большой большими
медийн: медийная
част: часть части
начин: начиная
наде: надеемся
алекс: алексей
карьер: карьере карьера
слов: слова
инженер: инженера инженером инженеры инженеров
вход: входа
офис: офиса
полезн: полезно
попаст: попасть
системн: системное
нны: нный
сдела: сделать
эффективн: эффективный
особен: особенностях
устанавлива: устанавливает
сложн: сложным сложными сложные
судьб: судьбу
дают: дают
капот: капотом
совет: советы
примен: применить
активн: активно активность
жизн: жизни
пример: примера примере
ноч: ночью
мож: можем
узна: узнать узнаете узнаем
неизмен: неизменные
выкатк: выкатки
пропуска: пропускать
частн: частная частной
трудн: трудно
микросервис: микросервисы микросервисов микросервисами
курс: курса курсы
сможет: сможете
метод: методы
процесс: процессы процесса процесс
групп: групп
подготов: подготовил
приведен: приведенного
решен: решению решений решением
масштабирован: масштабирование
продолжа: продолжаем
средн: средний
личн: личного
нужн: нужным
домашн: домашние
домашк: домашки
помога: помогает
хаб: хабы
рынк: рынке
современ: современные современных современными
помощ: помощью помощи
приложен: приложениями приложение приложения приложений
разработчик: разработчик разработчиков разработчики
результат: результатов
опыт: опыта
полож: положиться
ваканс: вакансиях
настройк: настройку настройка настройки
дал: далее
пониман: понимании понимания
документ: документы
прочтен: прочтение
мечта: мечтает
ссылк: ссылку
серверн: серверное
реал: реалиям
навык: навыков навыки
заманчив: заманчивые
нуж: нужен
преддвер: преддверии
расследован: расследований
дан: данных данная
программист: программистом
охват: охватить
хлебниц: хлебница
дат: дата
квест: квестов
состоя: состоящим
сквоз: сквозь
код: код кодом
напоследок: напоследок
паттерн: паттернах
росс: россия
задумыва: задумывались
регистрац: регистрация регистрации
мелк: мелкие
объяснен: объяснение
кругл: круглый
барабан: барабанов
служебн: служебный
числен: численность
медлен: медленных
митап: митапы
виноват: виновата
счита: считается
причин: причин
упрост: упростить
архитектурн: архитектурных
озарен: озарения
цел: цель целей
углуб: углубимся
старт: стартует старте
мирн: мирно
старш: старшим
кажд: каждом
возника: возникает возникают
настро: настроить
быстродейств: быстродействие
нагрузок: нагрузок
дзен: дзен
сохран: сохранить
подключ: подключиться
политик: политики политику
множеств: множество
взаимодейств: взаимодействием
рассчита: рассчитать
уход: уходят
разбор: разбор
создава: создавали
директор: директор
позабот: позаботиться
параллельн: параллельного
достич: достичь
тупик: тупики
обнов: обновить
оффер: оффере
разработк: разработкой разработка разработки
закладк: закладки
предложат: предложат
использова: использовать
спутник: спутники
пройт: пройти
достаточн: достаточно
контейнер: контейнеры контейнер
установк: установка
метрик: метриками
сюд: сюда
список: список
терминолог: терминология
обеспеч: обеспечить
след: следующее
пыт: пытаясь
типов: типовое типовых
дел: дело деле
организац: организациям
вопрос: вопросов вопросы вопросами
дизайн: дизайн
производительн: производительности производительность
бюджет: бюджет
стремительн: стремительные
внутрен: внутренней
устройств: устройствами устройство устройства
переход: переходишь
ваш: вашей ваших вашими
лекц: лекции
ответ: ответом
пространств: пространства пространстве
сталкива: сталкиваются
событ: событий
проектирован: проектирования
собствен: собственный
баз: баз базе
идеал: идеале
техническ: техническая
уда: удал
алгоритм: алгоритмы
фев: фев
расширен: расширений
поднима: поднимаем
минус: минусы
мегапроект: мегапроекты
хабр: хабр
угл: углами
обучен: обучения
откуд: откуда
некотор: некоторое
рассмотр: рассмотрим
обуча: обучающие
подума: подумать
количеств: количество
ртыван: ртывание ртывания
соглашен: соглашение
добав: добавить
просмотр: просмотров
практик: практикующих
ряд: ряд ряду
последн: последние
зна: знаем
монолитн: монолитными
конфигурац: конфигурации
сам: самая самых самые
исчерпыва: исчерпывающие
настраива: настраиваете
виртуальн: виртуальная
стартап: стартапам
туториа: туториал
приход: приходить
подключен: подключение подключения
захотет: захотеть
аппаратн: аппаратного
поня: понять
кластер: кластере кластер кластера кластером
компан: компанией компаниях компаний компании
выполнен: выполнении
рассказыва: рассказываем
программ: программы
управлен: управление
ежедневн: ежедневные
лезт: лезть
разбира: разбираем разбираться разбираемся
действ: действует
фундаментальн: фундаментальные
непремен: непременно
обеспечива: обеспечивают обеспечиваем
созд: созда
умолчан: умолчанию
предполага: предполагает
начина: начинающий начинающих
внедр: внедрить
скобин: скобин
поможет: поможет
состоян: состояние
популярн: популярных
высокоуровнев: высокоуровневому
начн: начн
использ: используют
спикер: спикер спикеров
созда: создайте создаем создал создать
кирилл: кириллом
ролик: ролики
помн: помним
кейс: кейс
программирован: программированию программирование
распределен: распределение
стол: стол
реша: решать
специалист: специалистов
передач: передачи
станов: становится
реализац: реализаций
оптимизац: оптимизация
тем: темы
администрирован: администрирование
различа: различаться
сайт: сайта сайт
знан: знания
обеспечен: обеспечения
научпоп: научпоп
технолог: технологий технологии
задач: задачи задача задач
комментар: комментарии
тренинг: тренинги
клиентск: клиентского
сотрудник: сотрудники сотрудникам
инженерн: инженерных
приступ: приступить
задан: задания
увольня: увольняются
работа: работать работал работалось работает работала
сильн: сильно
долг: долгих долгой
методичн: методичный
песочниц: песочница
долж: должен
сегодняшн: сегодняшней сегодняшний
кропотлив: кропотливой кропотливых кропотливый
посвящ: посвящена
услуг: услуги
подписчик: подписчики
гки: гкие
безболезнен: безболезненно
кандидат: кандидатам кандидатов
базов: базовое
логирован: логирования
блог: блог
числ: число числе
увлекательн: увлекательный
период: периоды
пробл: проблем
сложност: сложности
ещ: ещ
параметр: параметров
гибк: гибким
автор: авторы авторов автором
нагружен: нагруженных
функционал: функционалу
сер: серия
борисов: борисовым
очеред: очереди
чита: читать
легк: легко
сет: сетью сеть сети
представител: представитель
конфиденциальн: конфиденциальность
собеседован: собеседование собеседованию собеседования
подход: подход
защит: защитить
придет: придется
науч: научиться
теор: теории
ноябр: ноября
долгожда: долгожданном
быстр: быстро
реальност: реальность
эксперт: экспертов
спрос: спросить
договор: договориться
бизнес: бизнесом
позволя: позволяющая
платн: платный
инцидент: инцидентами инцидентов инцидентах
аутентифицир: аутентифицирует
рейтинг: рейтинг
скорост: скорость
дом: дома
компетенц: компетенций
реш: решили решить
известн: известная
остав: оставив
горяч: горячие
сторон: сторона сторонних сторону
поток: поток потоков потоки
поддержк: поддержкой поддержка
предостав: предоставить
зада: задали
состо: состоят
набор: набора
берут: берутся
брокер: брокера
дофамин: дофамина
любим: любимого
зашифрова: зашифрованный
сред: среди
комплексн: комплексный
предыдущ: предыдущей
наш: нашей
может: можете
мног: многое многие
пользовател: пользователей
попыток: попыток
люб: любом любого любой
избежа: избежать
язык: языка
большинств: большинстве
сервис: сервисами сервисам сервис
соответствова: соответствовала
мониторинг: мониторинг
информац: информация
правд: правда
разн: разными разному
ключев: ключевое
анализ: анализа
люд: людей
разв: разв
отправк: отправке
пакет: пакетов пакет
ожидан: ожиданий ожиданиям
интерв: интервью
сборк: сборки
поговор: поговорим
обработк: обработки
админ: админов
кульминац: кульминацией
создан: создания создание
собра: собрали
храня: хранящихся
прич: прич
конвейер: конвейер
антон: антон
например: например
одн: одном одну одними
самостоятельн: самостоятельно
мар: мар
коллег: коллеги
классн: классной
реклам: реклама
запуст: запустил
корпоративн: корпоративный
рекомендац: рекомендации
нагрузк: нагрузки
функциона: функционала
нативн: нативные
инструмент: инструменты
команд: командах команды команде командой команд командам
плюс: плюсы
польз: пользы польза
познаком: познакомиться
ответствен: ответственен
стек: стеку стек стеком
стран: стране
смотрет: смотреть
использован: использование использования
платформ: платформа
запрос: запросы запросов
поскольк: поскольку
сентябр: сентябре
войт: войти
исходн: исходным
выстраиван: выстраивании
аккаунт: аккаунт
протокол: протоколов
репозитор: репозитория
подробн: подробный подробности
сервер: сервер серверов
поближ: поближе
раздел: разделить разделы
автоматическ: автоматически
яндекс: яндекс
об: обо
новост: новости
ов: ов
лучш: лучшая лучшие лучшего
механизм: механизм
управля: управлять
впрыск: впрыском
поиск: поиск
интересн: интересные интересных
возможн: возможность возможно
дальн: дальнейшем
основ: основе основам основы
открыт: открытия открытым
выбра: выбрать
позвольт: позвольте
кафк: кафке кафка
образовательн: образовательные
как: какие каких какими
определ: определ определить
недостаточн: недостаточно
препятств: препятствий
голос: голосов
пайплайн: пайплайны
высок: высокая
бывш: бывшие
реальн: реальном реальной
стабильн: стабильную
мечт: мечты
архитектур: архитектуры
точк: точка
потоков: потоковой
откр: открыт открыть
способ: способам способах
рм: рм
конференц: конференции
studio: studio
instal: install
polina: polina
devop: devops
ssh: ssh
anna: anna
listen: listen
highload: highload
twitter: twitter
looker: looker
epa: epas
mysql: mysql
dnf: dnf
apk: apk
jump: jump
budget: budget
lika: lika
edb: edb
sokol: sokol
apt: apt
edeshina: edeshina
averina: averina
io: io
ip: ip
accept: accept
servic: service
vk: vk
consum: consumer
kafka: kafka
slo: slo
letter: letter
mdo: mdos
habr: habr
gitlab: gitlab
produc: producer
exchang: exchange
server: server
pod: pod
dead: dead
error: error
istio: istio
kubernet: kubernetes
docker: docker
network: networking
youtub: youtube
sql: sql
yum: yum
rss: rss
desktop: desktop
postgresql: postgresql
southbridg: southbridge
debian: debian
linux: linux
chernigo: chernigo
mesh: mesh
openvpn: openvpn
tcp: tcp
eucariot: eucariot
cd: cd
ci: ci
sre: sre
facebook: facebook
upgrad: upgrade
telegram: telegram
rsocket: rsocket
bigqueri: bigquery
zubarek: zubarek
broker: broker
rabbitmq: rabbitmq
googl: google
vpn: vpn
jenkin: jenkins
postgr: postgres
paus: pause
apach: apache
ebpf: ebpf
advanc: advanced
