обрат: обратить обратиться
найт: найти
говор: говорить
понима: понимают понимаю понимать
оттуд: оттуда
занят: занятости
стат: стать статью статьи
туп: тупо
стар: старую
рабоч: рабочее
конц: конце конца
успех: успех
став: ставишь
ниш: нишу
повторя: повторять
завис: зависит
работ: работы работ работе
практическ: практические
удар: ударит
показыва: показываю показывать
вернут: вернуться
получен: полученные
принос: приносить
инфраструктур: инфраструктура
сто: стоишь стоит
основан: основание
человек: человека
приятн: приятно
лен: ленитесь
д: д
свалк: свалку
самообучен: самообучение
словар: словарь
менеджмент: менеджмент
пункт: пункт
й: й
публикац: публикации
студент: студент студента студенту
показа: показать показал
сообщ: сообща
благодар: благодарю
котор: котором
денег: денег
карм: карма
времен: временем
двер: дверь
мин: мин
кандидатур: кандидатуру
присоедин: присоединиться
мир: мире мир миру
писа: писать писал
конспект: конспектов
вест: вести
обсужда: обсуждать
уч: учился учить учусь
двига: двигать
скор: скоро
проект: проекте проектом проекты проект
профил: профиль профиля
дела: делать
ооп: ооп
получ: получите получилось
верс: версию
важн: важно
маркетинг: маркетинг
выбер: выберу
разобра: разобраться разобрался
комфорт: комфорта
владисла: владислав
рук: руку
час: час
прост: простой
внутр: внутри
врем: времен
прям: прямо
индустр: индустрии индустрия
занима: заниматься
позиц: позицию
профессионал: профессионалом профессионалы
уровен: уровень
придума: придумал
нов: новые новому новое
семинар: семинары
клавиш: клавиши
прокрастинац: прокрастинация
медийн: медийная
мест: место месте
демонстрирова: демонстрировать
карьер: карьера
вход: входят входить
слов: слова слов
направлен: направления направление
выписа: выписать
убытк: убытки
полезн: полезный полезную
сдела: сделать сделай сделал
внимательн: внимательно
отзыв: отзывы
эффективн: эффективным
особен: особенность особенности
устанавлива: устанавливать
видет: видеть
выкладыва: выкладывай выкладывать
пробова: пробовать
прорабатыва: прорабатывать
поработа: поработать
печат: печати
совет: советую советы совет
пут: путь пути
примен: применить
работодател: работодателю работодателей работодатель
жал: жалей
вперед: вперед
идт: идти
деятел: деятелей
примеш: примешь
населен: населения
индивидуальн: индивидуальным
вкладыва: вкладывать
пыта: пытаются
мож: можем
переводчик: переводчики
смог: смог
основн: основного основной
курс: курса курс курсов курсы курсах
сможет: сможете
ресурс: ресурс
метод: методом методами метод методов
процесс: процесса процесс
подготов: подготовил
решен: решений решение
доказательств: доказательство
зауч: заучить
написан: написания
провод: проводить
средн: средняя
продолжа: продолжаю продолжай
личн: лично
нужн: нужным нужны
домашн: домашние
помоч: помочь
помога: помогать
хаб: хабы
рынк: рынку рынке
материа: материал
современ: современному современных современным современную современной современный
помощ: помощью
наставник: наставнику
слайд: слайд
востребова: востребованным востребованный
результат: результаты
вызыва: вызывать
командн: командный
опыт: опытом
настройк: настройка
опасн: опасное
дал: далее
документ: документы документ
прочтен: прочтение
увер: уверен
самообма: самообман
ссылк: ссылке ссылка
навык: навыки
нуж: нужен
прочита: прочитать
зачисл: зачислены
всецел: всецело
конкуренц: конкуренция
дан: данных
потребова: потребовалось
займет: займет
минимальн: минимальный
картинк: картинку
найдеш: найдешь
плох: плохого
код: код кода
регистрац: регистрация
вредн: вредные
имеет: имеет
ситуац: ситуации
счита: считаю
причин: причина
цел: целом цель целей цели
новичк: новичкам новичку
предлог: предлоги
старт: старта
изуча: изучать
звуч: звучит
кажд: каждого
границ: границы
оболочк: оболочки
дзен: дзен
канал: канале
конвертер: конвертеры
начат: начатое
вмест: вместо
финансов: финансовый
окончательн: окончательно
преподавател: преподавателю
мотивац: мотивация мотивацию мотивации
спор: спорил
идут: идут
обнов: обновить
иностра: иностранных
веден: ведения
разработк: разработка
довод: доводить
закладк: закладки
использова: использовать
увидет: увидеть
уверен: уверенным
начал: начале
примерн: примерно
установк: установка
професс: профессию профессии
карьерн: карьерный
слеп: слепой
список: список
кадр: кадров
пост: посты
выписыва: выписывать
овладет: овладеть
ориентирова: ориентированное
терминолог: терминология
итог: итоге
минут: минуты
след: следует
институт: институт
дел: деле дело делиться дела
вопрос: вопроса вопрос вопросы вопросов
дизайн: дизайн
рассказа: рассказать
попыта: попытаться
устройств: устройство
пришел: пришел
рискуеш: рискуешь
ваш: вашей вашу
ответ: ответа ответил ответить ответы
никт: никто
срок: сроки
сталкива: сталкивался
техническ: техническая
ручк: ручка
красот: красота
алгоритм: алгоритмы
добива: добиваться
внушительн: внушительными
расширен: расширения расширение
людьм: людьми
уродств: уродство
рефлекс: рефлексия
мегапроект: мегапроекты
хабр: хабр
пишут: пишут
синдр: синдром
обучен: обучения
иска: искать
выработа: выработал
куп: купить
обща: общаюсь
количеств: количество
чистот: чистоту
соглашен: соглашение
ам: ами
добав: добавить
просмотр: просмотров
практик: практика
содержан: содержание
сад: садился
последн: последний
замечан: замечания
друз: друзья друзей
месяц: месяцев
услов: условии
сам: самое
тво: твое твоими твоей твоего
скаж: скажу
друг: другими другом другим другого
сутк: сутки
стартап: стартапам
зон: зоне
правильн: правильно правильный правильных
бо: бойся
поня: понял понять
посмотр: посмотри
называ: называется
компан: компаний компании
выполнен: выполнения
давлен: давление
программ: программа программ программы
получа: получать
принят: принято
главн: главная
наслажда: наслаждаться
действ: действия
стресс: стресс
обузда: обуздать
записа: записать
наруша: нарушайте
неправильн: неправильный
начина: начинающим
привет: привет
поможет: поможет
вс: вс
отдел: отдела
запомина: запоминаете
начн: начни
рад: ради
использ: использую
шариков: шариковая
сво: своим свой своими своему своем
помн: помните
взаимодействова: взаимодействовать
программирован: программирование программирования
жалк: жалко
реша: решать решаешь
специалист: специалисты специалистом специалист специалистов
даст: даст
станов: становятся становится
интернет: интернете
го: го
исключа: исключать
тег: теги
явля: является
комьюнит: комьюнити
сигнатур: сигнатуры
всеравн: всеравно
законч: закончил
администрирован: администрирование
сайт: сайта
знан: знания
научпоп: научпоп
привлека: привлекает
технолог: технологий технологию технологии
задач: задачу задача задачи
комментар: комментарии
поставлен: поставленных
ускорен: ускорения
пользова: пользоваться
поеха: поехали
хвата: хватает
задан: задания
работа: работаем работают работать
сильн: сильно
самозванц: самозванца
песочниц: песочницы песочница
долг: долгом
ценност: ценность
подсказк: подсказка
пар: паре пару
услуг: услуги
оставля: оставлять
телефон: телефону
блог: блог
истор: истории
автоматизац: автоматизация
ход: ходу
пробл: проблему
сложност: сложности
факт: факт
вниман: внимание
пойт: пойти
автор: авторы авторов автором
очеред: очередь
легк: легко
чита: читать
вид: виде
конфиденциальн: конфиденциальность
собеседован: собеседовании
некуд: некуда
отдач: отдачей
умен: умение
попада: попадать попадаешь
защит: защиту
подпрограмм: подпрограмм
рев: ревью
заключен: заключение
быстр: быстро
бизнес: бизнесу бизнес
пережива: переживай
хоч: хочу
неоднократн: неоднократно
рейтинг: рейтинг
многолетн: многолетняя
реш: решить
визуализац: визуализация
горяч: горячие
недостатк: недостатки
постав: поставить
поток: поток потоки потока
поддержк: поддержка поддержку
предостав: предоставить
страдан: страданиями
зада: задаю
состо: состоит
угодн: угодно
берут: берутся
библиотек: библиотекой
повод: поводу
переведен: переведенные
денежн: денежная
наш: нашем
объектн: объектно
можеш: можешь
люб: любом любой
авторск: авторский
над: надеюсь
язык: языками язык языка
большинств: большинства
сил: сил
робот: роботы
обязательн: обязательно
сервис: сервисы сервис
фактор: факторы
информац: информацию информацией информация информации
выгоран: выгорание
негативн: негативные
люд: людям людей
спуст: спустя
отвеча: отвечаю
дедлайн: дедлайны
английск: английский
отталкива: отталкиваешь
понят: понятие
физическ: физической
потеря: потерять
вывод: вывод
самозанят: самозанятый
идет: идет
пишеш: пишешь
привод: приводит
идеш: идешь
например: например
знает: знаете
одн: одном одну одно
инглиш: инглиш
самостоятельн: самостоятельно
знаеш: знаешь
реклам: реклама
презентац: презентация презентации
закончен: законченные законченным законченный законченное
корпоративн: корпоративный
функциона: функционал
соответств: соответствующую
нативн: нативные
расширя: расширять
подарк: подарки
познаком: познакомят познакомиться
стек: стеком
участ: участие
соблюда: соблюдать соблюдал
оклад: окладами
отлич: отличии
платформ: платформы платформах
мо: мою
осваива: осваиваю
навстреч: навстречу
душ: душе
войт: войти
конечн: конечная
аккаунт: аккаунт
выбор: выбор
елизар: елизаров
наскольк: насколько
онлайн: онлайн
пиш: пишите
репозитор: репозиторий
вечн: вечного
печата: печатать
раздел: разделы
зависет: зависеть
похож: похожей похожие
транслир: транслируется
пишет: пишете пишется
яндекс: яндекс
обработа: обработать
новост: новости
существ: существует
заголовк: заголовки
лучш: лучшие
перв: первого первую первые
управля: управляем
оцифрова: оцифровать
дума: думал
тороп: торопись
приня: принять
написа: написал
поиск: поиск
возможн: возможность возможное
интересн: интересно
оп: опыт
основ: основа
выбра: выбрал выбрать
отечеств: отечеству
привыкл: привыкли
образовательн: образовательной образовательных образовательные
боя: боялся
семантик: семантика
хочет: хочет
проактивн: проактивным
как: какое
подтвержд: подтвержден
голос: голосов
рассматрива: рассматривать
фигн: фигня
встреча: встречать встречаться
портфол: портфолио
стабильн: стабильность
тянут: тянуть
изначальн: изначальном
становлен: становление
бойт: бойтесь
сфер: сфера
откр: открыть
влад: влад
форм: форме
наход: находится
компьютерн: компьютерная
озвучива: озвучивать
потер: потере
рекоменд: рекомендую
engin: engineer
ru: ru
continu: continuous
js: js
react: react
youtub: youtube
bwuftfrbaacmf: bwuftfrbaacmf
twitter: twitter
modern: modern
softwar: software
web: web
simpl: simple
vladislav: vladislav
geekbrain: geekbrains
fraemwork: fraemwork
id: ide
mastervlado: mastervlados
digit: digital
github: github
facebook: facebook
en: en
telegram: telegram
vkov: vkov
list: list
javascript: javascript
todo: todo
googl: google
specialist: specialist
vk: vk
slide: slides
elizarov: elizarov
http: https
doc: docs
habr: habr
present: presentation
frontend: frontend
mixccpw: mixccpw
