найт: найти
максимальн: максимально
готов: готовое
финал: финале
оценк: оценки
криптограф: криптография
информацион: информационная
расскаж: расскажу
успел: успели
стат: стать статью статье статьи статья
стар: старую
нин: нина
стал: стала
мнен: мнение
обзор: обзор
таргетирова: таргетированной
появ: появятся появиться
проработа: проработал
пропускн: пропускной
реализова: реализовать
работ: работа работой
показыва: показывать
дополнительн: дополнительный
доступ: доступа
вернут: вернуться
парадигм: парадигме
жаргон: жаргонный
сетев: сетевых
получен: полученном
четверт: четвертая
связк: связке
связн: связных
резолв: резолвятся
гкост: гкость
послед: последующего
децентрализова: децентрализованные
схем: схема схемы
наравн: наравне
менеджмент: менеджмент
интеграц: интеграции
прототипирован: прототипированию
л: л
преврат: превратился
стекля: стеклянная
тр: тр
о: ой
мобильн: мобильных
п: п
парсинг: парсинг
должн: должны должна
централизова: централизованные
публикац: публикации
скопирова: скопировать
дава: давали
х: х
ч: ч
подел: поделиться
показа: показать
сезон: сезон
благодар: благодаря
котор: которую которое котором которыми
выгрузк: выгрузка
мин: мин
мир: мир
реализовыва: реализовывать
свят: святым
совершен: совершенно
безопасн: безопасность
этап: этапе этапов
либ: либо
проект: проекты проектов проекта
связ: связи
конец: конец
перестава: переставал
феврал: февраля
вперв: впервые
вмеща: вмещается
относительн: относительно
профил: профиль
ооп: ооп
дела: делал
сут: сути
сообщен: сообщений
столкнут: столкнуться
кэширован: кэширование
получ: получим
перевод: перевод
почерпнут: почерпнуть
верс: версии версию
подводн: подводным
важн: важной
нна: нная
маркетинг: маркетинг
компилируем: компилируемый
разобра: разобранном разобраться
списк: списков
маршрутизац: маршрутизации
час: час часа часов
прост: простой
трафик: трафика
внутр: внутри
задачк: задачки
занима: занимал
постро: построит
удержа: удержать
уровен: уровень
нов: новые новый новое
внешн: внешнюю
больш: большие больших
преамбул: преамбула
медийн: медийная
мест: место
файлов: файловые
планомерн: планомерно
част: часть части
отбор: отбор
кодов: кодовая
резолвинг: резолвинга
счет: счет
традицион: традиционных
несоблюден: несоблюдение
инженер: инженерами
постоя: постоянно
системн: системное
сдела: сделать сделаю сделал
доставк: доставки
телегр: телеграм
бесспорн: бесспорно
сложн: сложный
опенсорснут: опенсорснуть
дают: дают
представлен: представление
капот: капотом
камн: камнем камням
примен: применить
пут: путь пути
активн: активно
жизн: жизни
штук: штуки
пример: примере
привл: привл
операцион: операционной
идт: идти
хранилищ: хранилищ хранилища
сформирова: сформировать
систем: системы
пыта: пытаюсь
переписыва: переписывал
узна: узнал узнаем
итерац: итерация
момент: момента
лишн: лишним
основн: основном
микросервис: микросервисы
раунд: раундов раунда
сожален: сожалению
читател: читателей
машин: машине
процесс: процессу
свойств: свойство
бонус: бонусом
выпуска: выпускайте
почт: почта
решен: решений решение решения
хотел: хотелось хотел
нных: нных
фина: финал
средн: средний
личн: личного
комфортн: комфортнее
продолжа: продолжаем
слайс: слайса
вакуум: вакууме
влюбл: влюбл
случайн: случайно
подряд: подряд
помоч: помочь
хаб: хабы
вечер: вечер
описан: описание
ребр: ребром
современ: современный современного
помощ: помощью
бенчмарк: бенчмарк
приложен: приложение приложений приложения
разработчик: разработчик разработчикам
результат: результатов
опыт: опытом
жизнен: жизненный
секунд: секунд секунды
ваканс: вакансии вакансий
настройк: настройка настройке
вклад: вклад
дал: далее
текст: текста
пониман: понимание понимания
сортировк: сортировку
принесл: принесло
документ: документы
прочтен: прочтение
интерва: интервал
корректн: корректного
увер: уверен
ссылк: ссылка ссылку
мигрирова: мигрировать
перцентил: перцентиль
лоб: лоб
неподготовлен: неподготовленному
ключ: ключи
инкапсуляц: инкапсуляцией
интерес: интересов
агрессивн: агрессивный
дан: данными данные данных данной данный
сравнен: сравнение сравнении
сходств: сходство
полиморфизм: полиморфизм полиморфизма
охват: охвата
картинк: картинки картинкой
конфигурирован: конфигурирования конфигурированию
состоя: состояло
конкурентн: конкурентной
хват: хватили
код: кода код коде
рост: рост роста
помог: помог
детальн: детального
задумыва: задумываются
регистрац: регистрация
кон: коней
мтс: мтс
издательск: издательский
имеет: имеет
ситуац: ситуации
шка: шка
цикл: цикл цикла
каза: казался
некорректн: некорректно
эффект: эффекте
причин: причинам
функц: функций
брифинг: брифинг
используем: используемых
цел: целом
тополог: топология
построен: построение
шку: шку
отлича: отличается
брал: брался
лент: лента
чих: чих
граал: граалем
пройд: пройдусь
миграц: миграции
столп: столпов
продемонстрирова: продемонстрировать
российск: российских
дзен: дзен
сохран: сохранить
канал: каналов каналы
взаимодейств: взаимодействия
разбор: разбор
любовн: любовное
многопоточн: многопоточный
ошибк: ошибка
параллельн: параллельно
синтаксис: синтаксису
обнов: обновить
разработк: разработкой разработке разработка
закладк: закладки
обложк: обложки
желез: железе
занимательн: занимательные
достаточн: достаточно
почита: почитать
примерн: примерно
изнутр: изнутри
предположен: предположений
метрик: метрик
сюд: сюда
релиз: релиза
настоя: настоящая
коробочн: коробочное
преимуществ: преимущества преимуществах
список: список
пост: пост
паразитическ: паразитическим
знаком: знакомому
укладыва: укладывается
итог: итоге
след: следующих
минут: минут
пакшин: пакшина
дел: дело
нашел: нашел
вопрос: вопросом вопрос
дизайн: дизайн
рассказа: рассказать
производительн: производительного производительность
внедря: внедряли
устройств: устройство устройстве
попыта: попытаемся
заверш: завершился
квалификац: квалификация
размер: размер размеры размером
переход: переходе переход
обезопас: обезопасить
клиент: клиентов
бэкенд: бэкенд
ваш: вашему
проход: проходило
так: таких таки
сним: снимая
полност: полностью
дженерик: дженерикам дженериков дженерики
поменя: поменялась
отсылк: отсылки
собствен: собственных
копирован: копирование
баз: база
техническ: техническая
уда: удалось
алгоритм: алгоритмы
фев: фев
оговор: оговоримся
слыша: слышал
внест: внести
поднима: поднималась
конкурс: конкурсе
собира: собирать
подошл: подошли
мегапроект: мегапроекты
описыва: описывал
хабр: хабре хабр
некотор: некоторое некоторые
отношен: отношениям
застав: заставили
оберега: оберегаем
рассмотр: рассмотрим
подума: подумал
заопенсорнут: заопенсорнуть
переполнен: переполнение
количеств: количество
соглашен: соглашение
куч: кучи
разлага: разлагаться
добав: добавить
посмотрет: посмотреть
просмотр: просмотров
район: районе
содержан: содержание
сферическ: сферических
последн: последние
дополня: дополняем
сам: самое самых
сказ: сказ
представля: представляет
синтез: синтез
бд: бд
друг: друг друга другую
питер: питер
стартап: стартапам
туториа: туториал
нацелен: нацеленный
инач: иначе
выглядет: выглядеть
задава: задаваться
крак: кракена
тайн: тайные
подобн: подобными подобному подобной
развертыван: развертывание развертыванию развертывания
кластер: кластера
компан: компаний компании компаниях
рассказыва: рассказывать
программ: программах программы
коммуникац: коммуникаций
вчер: вчера
главн: главное
разбира: разбираемся
компьютерщик: компьютерщика
ненормальн: ненормальное
представл: представлен
руковож: руковожу
элемент: элементам
привет: привет
очередн: очередной
вс: вс
ускор: ускорить
использ: используется использует
раз: раза
ран: ранее
кейс: кейс
программирован: программирование программирования
исход: исходя
распределен: распределенных
влюблен: влюбленных
отдельн: отдельную
реша: решает
порог: порог
соревнован: соревнование
сохранен: сохранение
станов: становится
мбайт: мбайт
попробу: попробуем
тест: тесты теста тестов
значительн: значительное
краеугольн: краеугольным
реализац: реализаций реализацией реализации реализация
явля: является
бегл: бегло
оптимизац: оптимизация
тем: тема
пришл: пришлось
претерпел: претерпел
администрирован: администрирование
хеширован: хеширование
представ: представить
сайт: сайта
научпоп: научпоп
технолог: технологий
задач: задачу задачах задачи задача
комментар: комментарии
происход: происходит
праздн: празднует
ускорен: ускорение
рамк: рамках
различн: различным
трет: третья
прош: прошу
компьютер: компьютеры
сильн: сильно
работа: работать
достигнут: достигнуто
прос: просило
песочниц: песочницы песочница
пересобира: пересобирать
посвящ: посвящ посвящена
услуг: услуги
базов: базовом
логирован: логированию
блог: блог
фреймворк: фреймворка фреймворкам
истор: истории история
зовут: зовут
цифр: цифр
наследован: наследованием
праздник: праздник
сложност: сложности
ещ: ещ
вниман: вниманию
коллаж: коллажа коллаж
автор: авторы авторов автором
чита: читать
подава: подавать
сет: сети
конфиденциальн: конфиденциальная конфиденциальность
вид: вид виде
подход: подхода подходит
попада: попадались
сбермаркет: сбермаркет
доход: доход
тестирован: тестирование
нескольк: нескольких
быстр: быстрее
пользу: пользуемся
дне: дней
хоч: хочу
неоднократн: неоднократно
внедрен: внедрения
рейтинг: рейтинг рейтинга
скорост: скорость
дом: дом
реш: решил
способн: способностью способны
недостатк: недостатках
сторон: сторону стороны
поток: потоки
поддержк: поддержка
недел: недель
поддержива: поддерживающими
рек: рек
принцип: принцип
иб: ибо
хорош: хороший
профессиональн: профессиональный
анонимн: анонимного анонимной
повод: повода
библиотек: библиотеки библиотекам
обо: обоих
удобн: удобный
социальн: социальные
предыдущ: предыдущей
улучш: улучшить
мног: многие многими
посвящен: посвященного
люб: любим любит любой
тки: ткий
язык: языков языкам язык языка языками
большинств: большинство
сервис: сервисов сервис сервисами сервисы сервисе
регулярн: регулярностью
встава: вставала
информац: информация информации
совмест: совместить
гот: готов
письм: письмо
маг: магии
математическ: математическую
замер: замеры
ровн: ровно
использу: используем
целев: целевого
добавлен: добавление
критер: критерий
сборк: сборки сборка
мессенджер: мессенджеры
равнодушн: равнодушны
аудитор: аудитории
встроен: встроенным
создан: создания создании
матр: матр
дожда: дождались
запис: записи
подготовк: подготовка
одн: одном одним
картинок: картинок
мап: мапы
реиспользован: реиспользования
реклам: реклама рекламы
корпоративн: корпоративный
калугин: калугин
запуск: запуск
нативн: нативные
шаблон: шаблона шаблон
инструмент: инструментов
буфер: буфера
огромн: огромное
итак: итак
опиш: опишем
команд: команды команда
сообществ: сообщество
осужда: осуждаю
польз: пользуются
сло: слоем слой
нерефлексивн: нерефлексивные
электрон: электронная
смотрет: смотреть
использован: использования
уровн: уровне
побед: победившего победы победу победил
мо: мо
запрос: запросы запросов
ассемблер: ассемблера
сист: систем
горазд: гораздо
специфичн: специфичный
углублен: углубленно
сшивател: сшиватель
войт: войти
исходн: исходной
качеств: качестве
завидн: завидной
пригод: пригодиться
аккаунт: аккаунт
распараллеливан: распараллеливание
исходник: исходников
отложен: отложенной
компиляц: компиляции
онлайн: онлайн
пиш: пишу
секц: секция
проблем: проблемы проблема
холодн: холодным
репозитор: репозиторий репозитории
рекурс: рекурсией
сервер: серверов сервера серверу
раздел: разделы
порица: порицали
пишет: пишет
нек: некий
яндекс: яндекс
новост: новости
лучш: лучшая лучшее лучшие лучших
владимир: владимир
перв: первая первых первые
механизм: механизма механизмам
небольш: небольшое небольшой
дума: думаю
формат: формата
облегч: облегчить
написа: написать написал
добр: добрый
поиск: поисках поиск поиске
изменен: изменение изменения
возможн: возможности возможно возможностям
интересн: интересно
оп: опыт
открыт: открытые
выбра: выбрал
микросервисн: микросервисные микросервисных микросервисной
увелич: увеличить
образовательн: образовательные
как: какие какого
крупн: крупных
луковиц: луковица
голос: голосов
крут: крутятся
содерж: содержит
многозадачн: многозадачности
кат: кат
шлюз: шлюза
взгляд: взгляд
принадлеж: принадлежу
пассивн: пассивно пассивный
прошл: прошли
высок: высокая высокой
реальн: реальная
взглян: взглянем
копа: копаться
втор: вторая
архитектур: архитектурой
дешев: дешевый
рно: рной
откр: открыть
способ: способ способа
продукт: продуктов продукт
никак: никак
непонятн: непонятным
sourc: source
hl: hls
devop: devops
px: px
miiao: miiao
react: react
wikendp: wikendp
compos: compose
ht: ht
helm: helm
liquibas: liquibase
number: number
twitter: twitter
darwin: darwin
faq: faq
sqshq: sqshq
api: api
hashmap: hashmap
pet: pet
ram: ram
ninako: ninako
github: github
mkevac: mkevac
gener: generics generic
clickbeetl: clickbeetle
krakend: krakend
alonecod: alonecoder
zap: zap
otu: otus
openai: openai
nativ: native
kafka: kafka
habr: habr
unsaf: unsafe
rp: rps
cup: cup
schema: schema
ru: ru
tioff: tioffs
youtub: youtube
rss: rss
onokonem: onokonem
kustom: kustomize kustomization
dmitriizolotov: dmitriizolotov
map: map
sbermarket: sbermarket
lenta: lenta
autoscal: autoscaler
ci: ci
facebook: facebook
pyxru: pyxru
prometheu: prometheus
imag: image
fitter: fitter
travel: travel
chart: chart
quasilyt: quasilyte
open: open
protobuf: protobuf
redux: redux
ryzen: ryzen
romapr: romapres
project: project
dn: dns
reactj: reactjs
mode: mode
bazel: bazel
html: html
hyper: hyper
yaml: yaml
tech: tech
nginx: nginx
rail: rails
fizzbuzz: fizzbuzz
vd: vds
core: cores
vk: vk
http: http
amd: amd
maxrokatanski: maxrokatansky
websit: website
arkashaerema: arkashaerema
golang: golang
svistunov: svistunov
divan: divan
kubernet: kubernetes
docker: docker
rust: rust
joom: joom
piter: piter
postgresql: postgresql
keigisdead: keigisdead
backend: backend
recoveri: recovery
tokio: tokio
bozaro: bozaro
gomicro: gomicro
rest: rest
goapp: goapp
yourock: yourock
telegram: telegram
env: env
tarmalonchik: tarmalonchik
horizont: horizontal
registri: registry
hlt: hlt
build: build
vpn: vpn
ph: ph
rubi: ruby
