слух: слуху
понима: понимаю понимать
криптограф: криптография
фактическ: фактическим
стат: стать статье статьях сша статьи статья
оказа: оказалось
стар: вернуться старое платформ
порабощен: порабощения
рабоч: рабочее
стал: стали
составлен: составлением
мнен: мнение мнений мнениями
таргетирова: таргетированной
став: приложения
работ: работая работе работы работу
правок: правок
показыва: показывают показывает показывать
дополнительн: дополнительные дополнительный дополнительных
проблематик: проблематики проблематику
сценар: сценарий
арт: артем
получен: полученный
пол: поле
инфраструктур: инфраструктуры инфраструктуру инфраструктура инфраструктуре
сто: стоит
менеджмент: менеджмент
интеграц: интеграции
вкратц: вкратце
мобильн: мобильных мобильного
публикац: разделы
скопирова: скопировать
побрат: побратим
график: графики
подел: поделиться
жестк: жестко
котор: котором устройстве которыми
денег: денег
подкреплен: подкрепленные
свят: святым
связа: связанные связанное
обратн: обратную
манифест: манифестам манифестов манифесты манифестами манифеста
вовс: вовсе
либ: либо
проект: проектов проекты проект проектами
связ: связи
появля: появляются
строков: строковых
зад: зада
относительн: относительно
профил: профиль
дела: делаем
приветств: приветствую
сут: загублено
верс: версии старую
маркетинг: маркетинг
некогд: поговорим
прост: простой
предобучен: предобученной
рубл: рублем
занима: занимающегося занимают занимаюсь
типографск: типографской
дым: дыма
профессионал: профессионалы
эксплуатац: эксплуатации
уровен: уровень
очевидн: очевидно
нов: новые новых
айфон: старые
медийн: корпоративный
част: часть частого
цифров: цифровых цифровом
предсказан: предсказаний
слож: сложилось сложилась
кана: ютуб
постоя: постоянно
сдела: сделать сделай сделано
особен: некоторых
сложн: сложный
капот: капот
совет: советы советов
примен: применить
пут: пути пут путем
подключа: подключаются подключать
персонал: персоналом
хранилищ: хранилищ хранилища
систем: система
узна: узнать особенностей
нема: немало
курс: курс курсов
текущ: текущая
ресурс: ресурса ресурсами ресурсы ресурсов
сша: создавать
машин: машинное
лидер: лидерами
процесс: процессы процессов
групп: групп
помогут: помогут
свойств: свойства
требован: требования
достойн: достойным
хотел: хотел
размест: разместить
актуальн: актуальных искал
продолжа: поныне
номер: номера
подряд: подряд
помога: помогают
бесплатн: бесплатными бесплатные
рынк: рынку рынке
помощ: помощью
современ: современный современном современных
гугл: гугл
приложен: приложение сохранились приложениях приложений
напряжен: напряжения
разработчик: разработчик разработчики
командн: командной
вычислен: вычисления
промышлен: промышленных
мышк: мышки
профильн: профильного
нул: нулю
интерес: интересов
конкуренц: конкуренция
потребова: потребовалось
охват: охват
наслуша: наслушавшись
плох: плохого
тулз: тулзов
помогл: помогло
регистрац: аккаунт регистрации
толк: толком
газ: газа
ситуац: ситуациях
счита: считает
причин: причин причине
цел: целом целая
граал: граалем
кажд: скачивания каждого
человечеств: человечества
руководител: руководителя
настро: настроить
дзен: мегапроекты
канал: каналы
множеств: множество
взаимодейств: взаимодействия
золот: золотые
коммерческ: коммерческие
создава: полезного
искусствен: искусственный
кажущ: кажущейся
иностра: иностранного
донастройк: донастройка
серьезн: серьезность
налич: наличием
использова: использовать использоваться
графическ: графический
логик: логику
желез: железо
стратег: стратегии стратегий
пройт: пройти
примерн: примерно
взаимопомощ: взаимопомощи
сюд: информацией
професс: профессии
настоя: настоящее
список: список
сказа: сказано
паразитическ: паразитическим
знаком: знакомы
энерг: энергия
терминолог: терминология
строк: строки
нашел: метриками
дизайн: дизайна дизайн
резюм: резюме
производительн: производительность
концепц: концепции
помим: помимо
клиент: клиентов
так: такую такого таких
общен: общения
перевест: перевести
поменя: поменять
видеонаблюден: видеонаблюдения
семейств: семейства
техническ: настройка технических технического
баз: база базе базами
заметк: заметка заметке
здравоохранен: здравоохранение
аналитик: аналитики
некотор: некоторые силами
предпочита: предпочитают
рассмотр: рассмотрим
оберега: оберегаем
потенциальн: потенциальный
утечек: утечек
удивительн: удивительно
количеств: количество
введен: введением введение
соглашен: документы
добав: добавить
широчайш: широчайший
просмотр: просмотров
специальн: специальное
транспорт: транспорт
дополня: дополняем
конфигурац: конфигурация конфигураций
услов: условии
сканирован: сканирования
представля: представляет
синтез: синтез
интеллект: интеллект
друг: друг друга
нынч: нынче
семенюк: семенюк
сингулярн: сингулярности
правильн: правильно
активизирова: активизировались
тайн: тайные
сбор: сбора
поня: понять
менеджер: менеджеры менеджеров менеджерам
кластер: кластере
компан: компании авторов
программ: образовательные
коммуникац: коммуникаций
получа: получается
предъяв: предъявить
пят: пятая
элемент: элементы
привет: привет
стратегическ: стратегическим
состоян: состоянием состояние
дайджест: дайджест
мишен: мишенью
использ: использующие используются
имеют: имеют имеются
магазин: магазин
созда: создана создать
колдовск: колдовской
кейс: кейс
нын: ныне
сохранен: сохранением
интернет: интернет интернете
реализац: реализацию реализации
игров: зарабатывает игры
оптимизац: оптимизации
тем: тему
применя: применяются
пришл: пришлось
брендинг: брендинг
полн: полного
администрирован: администрирование
пользовательск: пользовательская
легковесн: легковесного
определя: определяет
питан: питания
комментар: комментарии комментариях
рамк: рамках
сотрудник: сотрудники
смотрител: смотрители
компьютер: ставить
работа: работают работать работаю работающее узнаем
песочниц: публикации песочницы
долг: долгих
эконом: экономии
услуг: услугам конфиденциальность
кандидат: кандидатов
блог: сюда блог
необходим: необходимо
высказа: высказать
фреймворк: фреймворками
автоматизац: автоматизации
логотип: логотипов логотип
интерфейс: интерфейсы интерфейс
модел: модели модель
сложност: сложности сложность
вниман: внимание
девайс: айфоны
автор: авторы сайта автором автора
очеред: очередь
чита: читать
собеседован: собеседование собеседования
локальн: локальную
подход: подходах
положен: положения
попада: попадают
тестирован: тестирование тестирования
реб: ребят
расписа: расписаться
быстр: быстрого быстро
вчерашн: вчерашних
пользу: пользуемся
перевал: перевалила
типичн: типичный
бизнес: бизнеса
тип: типов
предмет: предметы
спектр: спектр
бумаг: бумаги
внедрен: внедрению
портативн: портативный
печа: печать
реш: решил решила решить
общ: общем
окончан: металлолома
набор: набор
недел: неделю
поддержива: поддерживают поддерживаются поддерживать
расскажут: расскажут
включ: включая
бенефициар: бенефициаром
социальн: социальные
редактор: редакторе
мног: многое многие многих
люб: ним лонгрид
язык: языку языка
согласова: согласованных
тко: тко
заглянут: заглянуть
содержа: содержащие
целесообразн: целесообразным
критикова: любят
гор: горы
правд: правда
продакш: продакшен
разн: разного
документооборот: документообороте документооборота
отсканирова: отсканировать
люд: людей
разв: разв
отвеча: отвечают ответ
производител: производителями производителя производителей
год: годы
открыва: открывает
интерв: интервью
физическ: физические
площадок: площадок
применен: применения
парочк: парочку
создан: создания создание
вывод: вывод
храня: хранящихся
прич: причем прич
фолд: фолды фолдами
привод: приводятся
подп: подпись
производств: производство производстве
знает: знаете знает
одн: одно
широк: широкий широко
наблюден: наблюдения
знаеш: знаешь
реклам: рекламы медийная
попадет: попадете
прид: прид
корпоративн: услуги
бумажн: бумажная
тов: тов
выпускник: выпускников
одинаков: одинаковыми
шаблон: шаблонов
подборк: подборка
инструмент: инструментов инструментами
сравнительн: сравнительный
доклад: докладов доклады
команд: команда команды командами команд
сообществ: сообществом сообществ сообществах
врод: вроде
электрон: электронные электронного электронная
смотрет: смотреть
использован: использования использованием использовании
платформ: закрытость
войт: войти
безграничн: безграничные
аккаунт: ланит
подпис: подписью
прохожден: прохождению
протокол: протоколы
сраз: хочет
репозитор: репозитории
излага: излагается
поспрашива: поспрашивала
датчик: датчики датчиков
яндекс: блоги
новост: новостей новости
существ: существует
перв: первую первого
достоинств: достоинства
написа: написать написал
поиск: поиск поисков
автоматизирова: автоматизировать
основ: основе основы
образовательн: нативные
как: каком каких какие каким какого
эдак: эдаким
голос: голосов
смарт: смарт
рассматрива: рассматриваемые
тся: тся
высок: высокое высокой
скептическ: скептическую
гаджет: гаджеты
рол: роли
точн: точно
сфер: сфера
установлен: установленного
однозначн: однозначно
научат: научат
способ: способ
браузер: браузеры
компьютерн: компьютерное
улучшен: улучшение
ретроспектив: ретроспектива
обрат: обратить
нейрон: нейронная нейронной
готов: готовых
информацион: информационная
занят: занятости
вызов: вызовы
окн: окнами окно
аспект: аспектах
предлага: предлагаю
обзор: обзору
электроник: электроники
появ: появилось появился появилась появиться
случа: случалось
доступ: доступ компьютера
вернут: поддержка
парадигм: парадигме
грех: грехи
принос: месяц
гкост: гкость
децентрализова: децентрализованные
вообщ: вообще
л: л
преврат: углу
н: н
п: п
централизова: централизованные
х: х
отправ: отправить
распечата: распечатать
поэт: поэтому
ничт: ничто
модификатор: модификаторах
мин: мин
вариант: вариант варианты
редактирова: редактировать
мир: мире мир
исследован: исследования
знают: знают
совершен: совершенно
безопасн: безопасность безопасности
повезл: повезло
скор: скорого
адресат: адресату
столкнут: столкнуться
получ: получила получил
синхронизац: синхронизации
перевод: перевод
распечатк: распечатку
тестировщик: тестировщикам тестировщика
город: города городить
библиотекар: библиотекари
рук: руки
час: час часа часов
чат: чатов
внутр: внутри
млн: млн
заодн: заодно
индустр: индустрию индустрии
позиц: позицию
больш: большие большая большое большими
софт: софт
заморож: заморожены
мест: место
файлов: файловые
планомерн: планомерно
иде: идея
ждат: ждать
карьер: карьера
вход: вход
направлен: направления направлениями направлений
игр: игр канал
пристальн: пристально
полезн: полезными полезна нашел полезный
паническ: панических
существен: существенные
телегр: телеграм
ввид: ввиду
исправлен: исправлений
циркулирет: циркулирет
загубл: которое
генерац: генерации генерация
населен: населения
лиценз: лицензий
пыта: пытаются
сотн: сотни
момент: момент
смож: сможем
отклик: отклик
основа: основанные
скрыва: скрывается
подготов: подготовят
почт: почта
решен: решений
офисн: офисные
загугл: загуглить
создател: создателем
средн: средний средняя
личн: личные лично
нужн: нужна нужны
поздн: поздно
хаб: хабы
описан: описания
вызыва: вызывают
опыт: опытом опыте
чрезмерн: критиковать
настройк: дзен
дал: далее
явлен: явлениях
матричн: матричными матричные
документ: компаний документов
прочтен: прочтение
предложен: предложенные
ссылк: ссылку
затащ: затащить
монет: монеты
фрейморк: фрейморка
дан: данных данными данной данный данная
имел: имела
дат: дать
установ: установить
весьм: некогда
векторн: векторный векторных
указа: указанного
быт: быта
код: кода
детальн: любит
технологическ: технологической
коп: копия
вредн: вредные вредных
генератор: генераторах генераторы
формирован: формирования
камер: камер
внесен: внесения
кпк: кпк
заран: заранее
сохран: радовать
вмест: вместе
обознач: обозначить
зарабатыва: работало
позабот: позаботиться
интеллектуальн: интеллектуальных
обнов: обновить
разработк: разработкой разработка разработки
закладк: закладки
имуществ: имущества
начал: начале
программн: программных программного
руководств: руководство
худш: худшее
изнутр: изнутри
метрик: цифрами
преимуществ: преимуществах преимуществами
корпус: корпуса
итог: итоге
минут: минуту минут
дел: дело
вопрос: вопрос
рассказа: рассказано рассказать
бесполезн: бесполезная
пошагов: пошаговое
жит: жить
устройств: навороченном устройства песочница
размер: размеры
недоч: недоч
ваш: вашим
попрактикова: попрактиковаться
ответ: сразу
генерир: генерирую
покупк: покупкой
сталкива: сталкиваются
собствен: собственно собственных
переписа: переписал
мегапроект: стартапам
хабр: хабр
передов: передового
угл: каждом
обучен: обучения обучение обученную
отношен: отношениям
иска: консоли
фрейм: фреймам
ртыван: ртывание ртыванием ртывания
куч: превратились
эпизодическ: эпизодической
разлага: разлагаться
посмотрет: посмотреть
практик: практиков практика
последн: последнее последней последние
заявлен: заявленными
месяц: отвечаю месяцев
сам: самый самых
примкнувш: примкнувший
манипулирова: манипулировать
стартап: программы
туториа: туториал
переда: переданы
школ: школ
образован: образования
подобн: подобной
посмотр: посмотрим
называ: называют
вероятн: вероятностью вероятно
управлен: управление управлением управления
наслед: наследием
предназначен: предназначенного
допуска: допускаемых
руковод: руководил
век: века
начина: начинал начинающим
стандарт: стандартом стандарта стандартов
вс: вс
прогноз: прогнозы
начн: начнем
област: областях области
простот: простотой
плагин: плагины
веб: веб
программирован: программирование программирования
реша: решать
специалист: специалисты специалистов специалистам
порог: порог
станов: становится
гк: яндекс
значительн: значительно
полигон: полигонов
явля: является являюсь являются
редактирован: редактирования
огород: огород
вещ: вещей
свод: сводя
легас: легаси
де: де
тимлид: тимлидов тимлида тимлидам
представ: представить
сайт: устройство сайтов
обеспечен: обеспечения обеспечение
научпоп: научпоп
технолог: технологий технологию технологии
задач: задачи задач задачах
различн: различные различных различными
хвата: хватает
сегодняшн: окончания
пар: пару
посвящ: посвящена
треб: требует требуют
металлолом: кучу
инструментар: инструментарий
зовут: зовут
истор: историей истории история
зрен: зрения
напиш: приносит
цифр: информацию
пробл: проблем
ещ: ещ
факт: факт факто
легк: легко
лонгрид: напишу
сет: сети сеть сетей
конфиденциальн: конфиденциальная соглашение
вид: вид виде
обменива: обмениваться
внов: вновь
науч: научимся
кошк: кошки
разумн: разумно
розетк: розеткой
нескольк: нескольких
вышеперечислен: вышеперечисленных
обеща: обещающих
контролирова: контролировать
альтернат: альтернатив
позволя: позволяют
платн: платный платную
хоч: хочу
рейтинг: рейтинга рейтинг
дом: дом
стандартизац: стандартизации
способн: способны
визуализац: визуализация
известн: известно
сторон: стороны сторону
постав: поставить
поток: потоки
поддержк: техническая поддержки
тысяч: тысячи
принцип: принципе
хорош: хорош
пуст: пусть
прогнозирован: прогнозирование
наш: нашего нашем
ин: иной
ютуб: игровой
ит: ит
пользовател: пользователей
успешн: успешно
компонент: компонентов компоненты
над: надеюсь
большинств: большинство
погна: погнали
заказ: заказу
умн: умный
сил: сути
робот: роботы роботами
затрат: затрат
разрабатыва: разрабатывает
сервис: сервисами сервисы сервисов
прибор: приборы
информац: актуальную детальной информация информации
восторг: восторга
анализ: анализа анализу анализ
удален: удаленно
трат: трата
скилл: скиллами
ровн: ровно
жадн: жадные
неолуддит: неолуддиты
сборк: сборки сборку
расставля: расставляем
ко: кое
мессенджер: мессенджеры
поговор: сегодняшней поговорил
собра: собрано собрать
закрыт: чрезмерную
например: например
запута: запутано
агрегатор: агрегатор
коллег: коллегам
наворочен: весьма
презентац: презентация презентации
понятн: понятно
соответств: соответствующее соответствующей
запуск: запуска
нативн: реклама
огромн: огромное
месячн: месячный
польз: пользуются пользуюсь
рассмотрен: рассмотрения
воз: воз
отлич: отличия
уровн: уровня
консол: игровые
сист: систему систем
специфичн: специфичный
углублен: углубленно
упорств: упорством
качеств: качестве качество
смс: смс
выбор: выбор
лан: гк
проблем: проблемы проблемами
раздел: регистрация
автоматическ: автоматически
радова: продолжают
нек: некий
унифицирова: унифицированно
лучш: лучшие лучшего
владимир: владимир
управля: управлять управляться
ок: окей
операц: операциями
возможн: возможности возможность возможностей возможно возможных
понын: девайсы
ленив: ленивый
семантик: семантика
хочет: статью
функциональн: функционального функциональное
подтвержд: подтвержден
крупн: крупных
сконфигурирова: сконфигурированных
меша: мешает
взгляд: взгляд
тематическ: тематических
надвига: надвигающейся
отрицательн: отрицательном
портфол: портфолио
архитектур: архитектуру
контент: контент
откр: открыть
скачиван: доступен
насмотревш: насмотревшись
наход: находится
опенсорсн: опенсорсного
термин: терминах
studio: studio
vladimir: vladimir
copilot: copilot
ruvd: ruvds
govern: governance
devop: devops
argocd: argocd
helm: helm
adalan: adalan
iot: iot
qa: qa
number: number
rembo: rembo
twitter: twitter
vova: vova
faq: faq
statefulset: statefulset
zend: zend
mastodon: mastodon
vim: vim
api: api
mastervlado: mastervlados
augur: augur
cto: cto
designop: designops
boumrz: boumrz
python: python
ai: ai
mafranc: mafrance
modul: module
manag: manager
javascript: javascript
otu: otus
habr: habr
firstvd: firstvds
kera: keras
greenolor: greenolor
feder: federation
globalsign: globalsign
pod: pod
postscript: postscript
appl: apple
bright: bright
sdy: sdy
secret: secret
youtub: youtube
tensorflow: tensorflow
rss: rss
jsonnet: jsonnet
kustom: kustomize
southbridg: southbridge
packag: package
man: man
alexrussianpyth: alexrussianpyth
chatgpt: chatgpt
jetbrain: jetbrains
facebook: facebook
xxi: xxi
bing: bing
googl: google
alexefremo: alexefremo
php: php
inteleph: intelephence
zelenykh: zelenykh
dii: diy
usb: usb
reactj: reactjs
evgeniir: evgeniir
deploy: deployment
usbchardwar: usbchardware
cloud: cloud
mf: mf
html: html
yaml: yaml
group: group
selectel: selectel
develop: development
translat: translate
servic: service
na: nas
semenyuk: semenyuk
vk: vk
scrum: scrum
rusau: rusau
numpi: numpy
internet: internet
primetalk: primetalk
game: game
phpstorm: phpstorm
android: android
cio: cio
lsp: lsp
timeweb: timeweb
admin: admin
artsiom: artsiom
kubernet: kubernetes
deni: denis
git: git
andgenn: andgenn
linux: linux
midjournei: midjourney
json: json
wp: wp
sam: sam
nvim: nvim
stabl: stable
agil: agile
custom: customization
telegram: telegram
gitop: gitops
pdf: pdf
neovim: neovim
diffus: diffusion
