максимальн: максимальной
готов: готовы
говор: говоря говорят
покуп: покупая
впоследств: впоследствии
информацион: информационная информационной
отчекан: отчеканил
расскаж: расскажу
страхов: страховой
стат: стать статье статьи статей
обычн: обычное
стар: старую
вызов: вызове вызовах
рабоч: рабочие
юзер: юзеров
мнен: мнение
предлага: предлагает
обзор: обзор
появ: появилась
един: единую единая
пропускн: пропускной
реализова: реализовали
работ: работа работе работы работой работу
запуска: запускаемых
частичн: частично
показыва: показывать
практическ: практических
сценар: сценариев
доступ: доступа
наряд: наряду
вернут: вернуться
сетев: сетевое сетевые
экономик: экономики
принос: приносит
инфраструктур: инфраструктуру инфраструктуры инфраструктура инфраструктурой
александр: александр
вершин: вершине
сто: стоит
качкин: качкин
двухчасов: двухчасового
специализирова: специализированных
туч: тучи
менеджмент: менеджментом менеджмент
интеграц: интеграции
михайлец: михайлец
разговор: разговора
мобильн: мобильных мобильном мобильного
снижен: снижения
сув: сув
публикац: публикаций публикации
скопирова: скопировать
студент: студенты
макс: максим
балл: баллы
подел: поделиться поделились
поэт: поэтому
ничт: ничто
котор: котором которым которыми
шах: шахов
выгрузк: выгрузкой
времен: временем
мин: мин
вариант: вариант
памят: памяти
эксперимент: эксперименте
реализовыва: реализовывать
конспект: конспект
репортаж: репортаж
связа: связался связанно связав
участвова: участвовал
безопасн: безопасная безопасно безопасность
орга: органы
проверя: проверял
вовс: вовсе
либ: либо
проект: проектом проекты проектами проекта
связ: связи
лиг: лига лиги
ива: ивана
ушл: ушло
феврал: феврале
лид: лиды
заб: забыть
относительн: относительно
профил: профиль
заварива: заваривайте
дела: делаем
столкнут: столкнуться
сообщен: сообщениям
власт: власти
получ: получилось получить
блокир: блокируют
документац: документации документацией документация
дискусс: дискуссию
верн: верно
перевод: перевод
фронт: фронтам
верс: версию
дистрибутив: дистрибутива
провел: провели
член: членов
отреза: отрезал
схд: схд
маркетинг: маркетинг
аргумент: аргументы
книг: книга
газет: газеты
час: часа часов
чат: чате
прост: простой простое простую
внутр: внутри
раскр: раскрыли
нно: нное
чаш: чаше
задачк: задачки
позвол: позволят
покрас: покрасить
индустр: индустрии
занима: занимаются занимаюсь
свободн: свободно
зап: запись
могл: могли
лиц: лицо
встрет: встретились
повышен: повышением
уровен: уровень
нов: нового новой новые новых новым новое
ног: ногу
больш: большой
медийн: медийная
част: часть части
начин: начиная
файлов: файловые
иде: идеями
цифров: цифровой
счет: счет
тишин: тишину
устро: устроено
опубликова: опубликована
карьер: карьера
саппорт: саппортом
слов: слову
офис: офиса
вход: входит
направлен: направления
выжимк: выжимка
геймифицирова: геймифицировать
накоп: накопилось
системн: системное системный
сдела: сделать сделай сделал
внимательн: внимательных внимательно
определен: определенный
доставк: доставки
мерч: мерч
особен: особенный особенности
развернут: развернутую
устанавлива: устанавливает
сложн: сложный сложные
инфоцентр: инфоцентры
капот: капотом
совет: советов
генерац: генерации
примен: применить
активн: активно
моментальн: моментально
штук: штуку
пример: примере
подключа: подключаются
идт: идти
эфир: эфира
хранилищ: хранилища
формальн: формально
локомотив: локомотива
систем: системы системам системе система системами
пыта: пытаться
государствен: государственной государственная
решим: решимости
момент: момент
дополн: дополнил
круглов: круглова
пообща: пообщаться
основн: основном основной
синапс: синапсов
вышл: вышло
провайдер: провайдеров
хамад: хамада
лидер: лидерами
метод: методы
миха: михаил
машин: машинное
процесс: процессы процессов
основа: основан
групп: группы
бонус: бонусы
роскомнадзор: роскомнадзор
решен: решениям решений
сторадж: стораджей
размест: разместить
культур: культуры
самура: самурай
нным: нным
средн: средний
нужн: нужны
домашн: домашнего
случайн: случайного случайным
подряд: подряд
секрет: секреты
помоч: помочь
помога: помогает
бесплатн: бесплатной
хаб: хабы
рынк: рынком рынка
продвижен: продвижения
современ: современные
послуша: послушать
гугл: гуглит
приложен: приложениями приложение приложения приложений
напряжен: напряжения
результат: результатах результаты
разработчик: разработчик
здоров: здорового
опыт: опыта опыте
рынок: рынок
выигра: выиграть
бонусн: бонусные
ваканс: вакансии вакансий
настройк: настройка
вклад: вклад
дал: далее
интегрирова: интегрированная
пониман: понимании
последовательн: последовательного
документ: документы
прочтен: прочтение
ссылк: ссылку
серверн: серверное
навык: навыков навыки
прасков: прасковью прасковья
средств: средств
жен: жена
масштабируем: масштабируемости
дам: дам
прокс: прокси
дан: данных данной
указа: указать
состоя: состоящим
сквоз: сквозь
негодован: негодования
любопытств: любопытство
код: кодом
рост: ростом
беспрецедентн: беспрецедентных
росс: россии
ладн: ладно
регистрац: регистрация
четырех: четырех
выявля: выявлять
мтс: мтс
привязк: привязке
ситуац: ситуации ситуаций ситуацию ситуация
имеет: имеет
медлен: медленной
цикл: цикла
гигант: гиганте
митап: митап митапа
каза: казалось
цел: цели
цен: цены
кова: ковал
построен: построения
бунин: бунина
порассужда: порассуждал
котар: котаро
сообща: сообщает
сдвинул: сдвинул
доступн: доступны
заран: заранее
кажд: каждым каждом
руководител: руководитель
нагрузок: нагрузок
просветл: просветл
дзен: дзен
сохран: сохранить
перебо: перебоями
подключ: подключиться
тезис: тезисах
вмест: вместе
создава: создавать
позабот: позаботиться
отличн: отличные
ошибк: ошибки
спор: спор
обнов: обновить
разработк: разработка разработки
закладк: закладки
пятер: пятеро
частност: частности
желез: железо
программн: программных
поколен: поколение поколения
установк: установка
сюд: сюда
релиз: релизе релизов
список: список
пост: посте пост
энерг: энергия
корпус: корпуса
полгод: полгода
след: следили следующем
дел: дело
организац: организации
дизайн: дизайна дизайн
рассказа: рассказали
резюм: резюме
производительн: производительности
добротн: добротным
тяжк: тяжкое
внутрен: внутренний внутренней
устройств: устройство устройства
виджет: виджете
вымышлен: вымышленной
переход: переходу
клиент: клиентов
бэкенд: бэкенда
информатизац: информатизация
ваш: вашей ваших вашими
так: такого такую таких
ответ: ответ ответили
никт: никто
поменя: поменять поменялась
проектирован: проектирование
сталкива: сталкиваются сталкиваемся
событ: событий
флант: флант фланте
разогна: разогнавшихся
баз: база базе базы
техническ: технической техническая
кенг: кенго
суток: суток
фев: фев
расширен: расширения расширений
назва: назвали
материал: материалах материалов материале
слыша: слышали
конкурс: конкурс
товар: товаров
мегапроект: мегапроекты
хабр: хабре хабр
здравоохранен: здравоохранения
смен: смены
аналитик: аналитиков аналитики аналитика
рутин: рутинных
савел: савелием савелия савелий
обсуд: обсудим
обучен: обучение
некотор: некоторое
рассмотр: рассмотрим
потенциальн: потенциального
иска: искать
обща: общаются
количеств: количество количеству
ртыван: ртывание ртывания
введен: введение
соглашен: соглашение
полез: полезен
добав: добавить
просмотр: просмотров
практик: практики практике
ряд: ряд
цепочек: цепочек
последн: последнего последние
воцар: воцарилось
замечан: замечаниям
друз: друзья друзей
сам: самых
качествен: качественные
аутсорс: аутсорсе
закр: закрыть
стартап: стартапам
туториа: туториал
бз: бз
блочн: блочных
захотет: захотеть
образован: образования
посмотр: посмотрите
кластер: кластера кластером кластер
менеджер: менеджер менеджера
компан: компаний компании
рассказыва: рассказываем
выполнен: выполнении
степен: степень
касперск: касперского
гост: гост
программ: программы
управлен: управлению управление управления
вчер: вчера
ежедневн: ежедневные
разбира: разбираем
фундаментальн: фундаментальные
соответствен: соответственно
сбо: сбоев
пресс: пресс
руковод: руководят
обеспечива: обеспечивают обеспечивать
изобрета: изобретал
перечен: перечень
пят: пятью
наруша: нарушает
элемент: элементы
привет: привет
состоян: состояние
вс: вс
голландск: голландского
высокоуровнев: высокоуровневому
соцсет: соцсетях
начн: начнем
рад: рад
област: области
использ: используют
отозва: отозвалась
раз: раза
созда: создали создать
плагин: плагин
сво: свой
веб: веб
помн: помните
кейс: кейс
нача: начал
отдельн: отдельных
реша: решаете решаются
специалист: специалистов
порог: порог
муниципальн: муниципальные
предоставля: предоставляется
интернет: интернет интернета интернетах интернете
атак: атакующих атак
тест: тестов теста
хранен: хранения хранение
плеч: плечами
вступ: вступить
танахас: танахаси
мегафон: мегафон
оптимизац: оптимизация оптимизацию
тел: теле
тем: теме
выступлен: выступления
сбертех: сбертехе
администрирован: администрирования администрирование
трансформац: трансформации
развит: развитием
спаст: спасти
тимлид: тимлид
представ: представить
парирова: парировал
анонсирова: анонсировали
питан: питания
сайт: сайта сайте сайт сайтов
знан: знаний
дн: дн
оборудован: оборудование
научпоп: научпоп
технолог: технологий технологиями технологии
привлека: привлекать
продолж: продолжил
перейд: перейд
комментар: комментарии
задач: задачи задач
праздн: праздное
происход: происходит
поставк: поставки
сотрудник: сотрудники
различн: различных
приступ: приступим приступить
работа: работающего работать работал работает работала
спринт: спринты
техпис: техписов техписа
песочниц: песочница
сегодняшн: сегодняшнем
долж: должен
пар: пару
услуг: услуги
безболезнен: безболезненно
треб: требует требуют
блог: блог
необходим: необходимостью
поправ: поправят
истор: истории
прод: прод
зовут: зовут
числ: число
проб: пробившиеся
ход: ходе
интерфейс: интерфейс
шум: шум
модел: модели
сложност: сложности
ещ: ещ
параметр: параметрам
сем: семи
грузов: грузового
автор: авторы автором авторов автора
функционал: функционалу
сер: серии серию серия
чита: читать читайте
сет: сети сеть
вид: видим
конфиденциальн: конфиденциальность
собеседован: собеседований
отдач: отдачей
инсайдерск: инсайдерская
чтен: чтения
защит: защиты
науч: научиться
теор: теории
тестирован: тестированию тестирование тестированием
розетк: розеткой
быстр: быстрые быстро
нескольк: нескольких несколькими
договор: договорились
спрос: спросил
вышел: вышел
бизнес: бизнесе бизнес
инцидент: инцидентов
внедрен: внедрению
рейтинг: рейтинг рейтинга
переезд: переезд
дом: дом дома
реч: речь
реш: решена
лаборатор: лаборатория лаборатории
способн: способности
известн: известно известных
покупател: покупателя
олег: олега
горяч: горячего
сторон: сторонних
постав: поставить
остан: останемся
поток: поток потоки потока
кратк: краткая
интеграцион: интеграционной
виртуализац: виртуализация виртуализации
поддержк: поддержка поддержку
хайп: хайпа
набор: набора
шуток: шуток
брокер: брокера
серг: сергей
иб: иб
повод: поводу
пуст: пустая
оператор: операторов
любим: любимого
наш: наших
лайфхак: лайфхаками
может: можете
слыш: слышите
республик: республики
ис: ис
пользовател: пользователям пользователи пользователей
посвящен: посвященной посвященная посвященных
хостинг: хостинг
язык: языка
большинств: большинство
планирован: планирования
заказ: заказов
сил: сил
татарста: татарстана
робот: роботы роботах
сервис: сервисами сервиса сервисы
стил: стилей
измерен: измерению
мониторинг: мониторинга
информац: информация информации
облачн: облачный облачные облачных
разн: разных
ключев: ключевых
анализ: анализ
завтр: завтра
трат: трата
математическ: математическую математическая
лаврент: лаврентий лаврентия
разв: разв
выявлен: выявления
производител: производителей
сродн: сродни
объяв: объявил
пакет: пакетов пакет
дополнен: дополнениям
экспертиз: экспертиза
трудност: трудностях
нюанс: нюансы
объедин: объединить
парол: пароль пароля
сборк: сборки
переговорк: переговорке
законодательств: законодательство
переста: перестал
ко: кое
сбер: сбер
упа: упали
поговор: поговорим
создан: создание
администратор: администратор
собра: собрали собрать
дожда: дождаться
битрикс: битрикс
перспективн: перспективных
подготовк: подготовка подготовки
продаж: продажи
мар: мар
коллег: коллег коллегами
увеличен: увеличения
реклам: реклама
запуст: запустили
онтик: онтико
корпоративн: корпоративный
понятн: понятно
нагрузк: нагрузки
потребн: потребности
нативн: нативные
шаблон: шаблоны
инструмент: инструменты инструмента
чест: честь чести
смоделирова: смоделировал
надежн: надежную
команд: команда команды команде командой
молчан: молчание
польз: пользы польза
стек: стек стеком
аренд: аренду
стран: странах
десятк: десятки
использован: использования
отлич: отличиях
уровн: уровня
платформ: платформе платформы
сист: систему систем
сентябр: сентября
войт: войти
исходн: исходным
аккаунт: аккаунт
эмоц: эмоций
глаз: глазах
аукцион: аукциона аукционом
протокол: протоколов
выбор: выборе выбором
прохожден: прохождения
чудновск: чудновский
молл: молл
проблем: проблемой проблема
подробн: подробнее
репозитор: репозитория
сервер: сервер серверов сервера серверах
раздел: разделы
половин: половины
жела: желанный
категорийн: категорийный
выража: выражало
замедлен: замедленной
яндекс: яндекс
блокировк: блокировке
импортозамеща: импортозамещать
новост: новостей новости
воврем: вовремя
лучш: лучшие лучший лучших
механизм: механизм
перв: первой первая
детектирован: детектировании
лошадин: лошадиных
сгуст: сгустились
небольш: небольшими
формат: формату
облегч: облегчить
добр: доброго
поиск: поиск
интересн: интересное интересными интересно интересный интересного
автоматизирова: автоматизировать
возможн: возможность возможно возможных
оп: опыт
дальн: дальнейшем
возраста: возрастает
упуст: упустить
заказчик: заказчик заказчиков
основ: основам
открыт: открытия открытым
позвольт: позвольте
трехчасов: трехчасовые
голов: головах
кафк: кафке
образовательн: образовательные
хочет: хочется
участник: участниками участников
определ: определ
как: каких
комментатор: комментатором
голос: голосов
страниц: страниц
вск: вск
бров: брови
меша: мешает
площадк: площадке площадки площадку
тематическ: тематический
растет: растет
прошл: прошла прошлый
кивнул: кивнул
реальн: реальных
втор: вторая
скидк: скидке скидкой скидки
изначальн: изначальной
рол: роли
контент: контентом
скорм: скормим
прежн: прежнем
радикальн: радикально
апгрейд: апгрейдом
стандартн: стандартных
откр: открыть
форк: форк
способ: способ
синтетик: синтетики
продукц: продукцию
справля: справляться
учрежден: учреждения учреждений
телекоммуникац: телекоммуникаций
улучшен: улучшение
компьютерн: компьютерное
продукт: продукты
кнопк: кнопки
никак: никаких
напоминан: напоминаниями
бюджетн: бюджетных
конференц: конференции конференция
источник: источник
панел: панелью
ruvd: ruvds
devop: devops
egorkotkin: egorkotkin
twitter: twitter
chudnovskii: chudnovskiy
faq: faq
ptsecur: ptsecurity
api: api
dnf: dnf
apk: apk
posit: positive
sokol: sokol
apt: apt
edeshina: edeshina
ip: ip
secur: security
manag: management
grpc: grpc
accept: accept
sli: sli
nativ: native
slide: slides
kafka: kafka
slo: slos slo
driven: driven
singl: single
architectur: architecture
dasafyev: dasafyev
habr: habr
ru: ru
synaps: synapse
document: document
sdy: sdy
siem: siem
yadro: yadro
youtub: youtube
thisprogam: thisprogame
rss: rss
attack: attack
southbridg: southbridge
man: man
adminvp: adminvps
event: event
chatgpt: chatgpt
cni: cni
art: art
set: setting
facebook: facebook
ntsaplin: ntsaplin
zubarek: zubarek
shapelez: shapelez
googl: google
cx: cx
apach: apache
fullstack: fullstack
expressvpn: expressvpn
nord: nord
instal: install
dii: diy
lyova: lyova
sign: sign
hostingmanag: hostingmanager
lab: lab
hola: hola
ua: ua
anna: anna
listen: listen
cloud: cloud
mode: mode
technolog: technologies
linkerd: linkerd
host: hosting
ipvanish: ipvanish
axelu: axelus
mysql: mysql
implement: implementing
digit: digital
skovalev: skovalev
selectel: selectel
keepsolid: keepsolid
kachini: kachini
vd: vds
poweredg: poweredge
servic: service
na: nas
vk: vk
recruit: recruit
mdo: mdos
haioshia: haioshia
barseadar: barseadar
maxpatrol: maxpatrol
speedifi: speedify
deckhous: deckhouse
cillium: cillium
fortun: fortune
book: book
detect: detection
kasperski: kaspersky
bitrix: bitrix
istio: istio
kubernet: kubernetes
docker: docker
network: networking
yum: yum
barsmonst: barsmonster
desktop: desktop
unlimit: unlimited
linux: linux
leagu: league
hostkei: hostkey
recoveri: recovery
mesh: mesh
nixi: nixys
tcp: tcp
san: san
rpc: rpc
sre: sre
kvap: kvaps
telegram: telegram
dell: dell
digitaltatarstan: digitaltatarstan
shakhovalex: shakhovalex
vpn: vpn
step: step
postgr: postgres
