недоумев: обрюзгших
слух: слуху
говор: говорят
банк: модуль докладываю
понима: понимаю события
расскаж: актуальность
фактическ: моложе
стат: стать статью вопроса статье статьи статья
обычн: заполняться
стар: вернуться
порабощен: порабощения
инвестор: венчурных
рабоч: рабочее
юзер: обычными
стал: система стали
составлен: составлением
мнен: мнение мнений мнениями
се: айтишников
указан: ввода
местонахожден: определить
чанг: чанга
работ: работа инструмент работы помочь
показыва: заметка показывать
ст: накачай
прошлогодн: прошлогодний
получен: рассказывал
сто: стоит
тб: тб
менеджмент: менеджмент
пункт: пунктов
заполня: начинают
благодарен: прошлый
интеграц: интеграции
каса: подумать
поисковик: годом
мобильн: мобильного
знакомств: знакомства
снижен: снижение
публикац: публикации
скопирова: скопировать
побрат: побратим
график: графики
макс: макс продажами
всемирн: всемирной
подел: поделиться
человеческ: аспектами
жестк: жестко жестких жесткие
благодар: кстати
котор: котором друг
подкреплен: подкрепленные
благ: пользуйтесь
эксперимент: эксперименты
прав: конце
кухн: странность
связа: решений
обратн: обратную
статистик: оптимизация
компромиссн: принять
уч: ним
проект: проект проектами нативные
уш: меньшими
появля: появляются
относительн: относительно
вьющ: носом
профил: профиль
дела: никто
приветств: десантника
читальн: читальный
верс: старую
маркетинг: маркетинг
увеличива: увеличивают
разобра: попробуем
прост: простой предпочитают начиная
врем: переживает
позвол: воображение
рубл: рублей
зал: зал
занима: занимают компания занимаюсь
свободн: свободное
лиц: лиц
встреч: вызвать
профессионал: профессионалы
заработа: обойти
разумеет: решать
уровен: уровень
нов: новые
медийн: корпоративный
част: часть ответить частого
предсказан: предсказаний
цифров: рассказываю
слож: мама
субъект: осознания
слов: точные упала
журна: изобретениях
нну: нную
одновремен: одновременным
постоя: постоянно
нны: нный
картошк: картошки
сложн: помогают памяти выдачи проектирование сложный
совет: советы гранта советов
примен: применить
пут: пути почкина
нос: длинным
ноч: ночи
персонал: персоналом
морщин: покрытых
систем: баз системы системе
выход: ресурсе
узна: узнать
накача: приложений
частн: частных
недособра: недособранной
трудн: отношения
южнокорейск: идет
курс: курс курсов
текущ: текущие текущим
ресурс: ранее ограниченных
метод: некоторые
помогут: помогут
свойств: обязательных работе
постепен: постепенно
хотел: хотел
предпочит: предпочитая
культур: культуре
актуальн: работали
номер: номера
неужел: неужели
подряд: подряд
помоч: вдохновить
бесплатн: бесплатная
помога: свой
рынк: рынку рынке рынка
продвижен: тренды продвижением
материа: прочтением
помощ: помощью
современ: современного
отвернул: клиентов
выш: считают
приложен: односложных
разработчик: разработчик
здоров: здоровье
комикс: тематические
склад: освободить
довольн: довольного
текст: текст текста
произнос: утолщить
показател: показателям показатели
схватыва: интуитивно
мышк: мышки
наоборот: скорее
профильн: профильного
интерес: советую
конкуренц: конкуренция пониженной
программист: программист программистах программистом программистов
странност: учитывая
тулз: тулзов
росс: видел
регистрац: аккаунт регистрации
толк: сбивающий
убед: убедить
ситуац: веков
выдач: поисковой
поисков: трендов топ
счита: например какими
эффект: толку
причин: причин причине
съед: съеден
архитектурн: журнал
цел: целая
цен: времена
троп: культурные
сериал: тропы
лент: ленту
усопш: захоронения
человечеств: человечества
кажд: разный каждой сложнее
руководител: руководителя
пройд: итак
выходн: выходного
захоронен: области
дзен: мегапроекты
эр: эры
канал: своем
множеств: множество
золот: золотые
искусствен: искусственный
спор: радиоактивные
иностра: иностранного
всяк: которому
завершен: завершение
налич: наличием
желез: железо
стратег: стратегии стратегий
десантник: голосом
пройт: пройти
примерн: примерно
закономерн: известная
сюд: методологии
професс: профессии
настоя: россии
список: список
сказа: сказано
знаком: знакомы
терминолог: терминология
меньш: людях
типов: правило
дизайн: дизайн
резюм: резюме
концепц: концепции
попробова: попробовал
светов: измерить
клиент: управляют
коротк: вещи
телеграмм: канале
так: таких
поменя: поменять
семейств: семейства
событ: фотографии
техническ: настройка технических технического
баз: база свойствами свойств
дешевеют: дешевеют
заметк: короткая
собира: участника
обсуд: положения
некотор: умнеют некоторым
предпочита: большинство
рассмотр: компаниях
подума: странно
введен: введение
количеств: количество количеством большом
соглашен: документы
попа: попали
оформлен: усопших
добав: добавить
широчайш: широчайший
просмотр: просмотров
содержан: содержание
друз: друзей
услов: условиях условии
объем: объемы
интеллект: интеллект
стереотип: стереотипов
вдохновен: показываю
друг: местонахождение
семенюк: семенюк
сингулярн: сингулярности
активизирова: активизировались
тайн: тайное
поня: понять
воображен: щекочет
менеджер: менеджеров менеджерам
компан: кульгин компаний компании крупных
рассказыва: конкуренции подробно отторжение
степен: высшей
программ: сложные
ограничен: учетом
вчер: вчера
получа: вопросы
наслажда: наслаждаться
действ: требуется
главн: каким
салфетк: одну
венчурн: настоящих
обеспечива: проприоцепция
привел: склады
взросл: земных
ных: уч
привет: привет
стратегическ: стратегическим
рубеж: сотрудников
мишен: мишенью
дайджест: дайджестами дайджестом дайджест
пропаст: понимаете
ран: благо
кейс: кейс
стол: накрывали
взаимоотношен: образа
гик: гиков
нелегк: нелегко
сохранен: документов
интернет: меняться интернет интернете
волос: вьющимися
осознан: людьми
радиоактивн: задал
оптимизац: поисковая
тел: знает схему
тем: материале
сбалансирова: создания
физиолог: пространстве
фрик: фриком
пришл: банке
полн: полного
администрирован: администрирование
пользовательск: пользовательские пользовательская
фотограф: видите
зерка: смотрит
бен: бена
комментар: комментарии комментариях
сотрудник: вроде
проч: комиксы декомпозиции
работа: работают методы работал работаю работает
сильн: сильно настолько
песочниц: разделы песочницы
исключительн: исключительно
вызва: эффект
услуг: конфиденциальность
подписчик: получаю
кандидат: кандидатов
дадут: команды
высказа: высказать
блог: блог
фреймворк: фреймворками
числ: гранту
автоматизац: автоматизации
проприоцепц: называют кратко
несколбьк: несколбько
модел: модели
сложност: сложности
вниман: внимание
исправля: заявку
оглядыва: встречи
автор: авторы устройство автором
снижа: снижаются
очеред: очередь
чита: читать
собеседован: собеседование собеседования
остр: острое
подход: является
положен: основные
намет: продвижении
тестирован: тестирование тестирования
вчерашн: вчерашних
перевал: перевалила
совр: статей
эксперт: словам
спрос: спроса благодарения
бизнес: бизнеса бизнесов бизнесе
выруча: моделировать
недовол: столько
декомпозиц: инструменты
спектр: спектр
выручк: квартале выручки
бумаг: выручают
внедрен: внедрению
реч: увеличить
реш: решил решила
общ: наоборот
объ: объем
зада: вопросов
недел: неделю
расскажут: расскажут
включ: включая
изобретен: направлениях
емкост: емкости
культурн: гэги
социальн: социальные
вдохновл: вдохновл
лайфхак: лайфхаки
редактор: редакторы
чувств: чувство
мног: вызывают многое многие
нулев: концу
люб: программы
директ: яндекс
язык: языка
обязательн: вместе
воспа: воспал
фактор: фактор
транш: двумя
гор: горы
правд: правда
разн: творческий
люд: сорок думаем
разб: разбил
отправк: сбой
производител: производители производителей
год: каждым световых нулевых
зачаст: зачастую
куратор: кураторы
аудитор: аудиторией
создан: полезно
фси: грант
вывод: вывод
избега: избегают
самозанят: самозанятых
отторжен: многих
производств: схемотехника
знает: волосами
одн: проблемы одному одно ресурсов сложила
продаж: продаж поднявшая заявки
мам: спросила стол
мар: ощущаете
согласн: согласны
наблюден: наблюдения
знаеш: знаешь
реклам: контекстной медийная
настольк: экспертов
грант: благодаря получить получения
корпоративн: корпоративные корпоративных услуги
выпускник: выпускников
одинаков: одинаковыми
инструмент: крутые инструментами прочее
инфоповод: инфоповоды инфоповодов
команд: наметились команде командами команд
итак: типовые
сообществ: сообщество сообщества
ознаком: интересующимся
подня: смутилась мелочь
таков: ошибка
стел: стелю
субъективн: понятие
врод: технарей
электрон: электронных
завещан: оформления
смотрет: смотреть
использован: использования
выхлоп: выхлоп
горазд: материала
войт: войти
фонд: получили нашей западные
аккаунт: сюда
топ: попасть
сомнен: сомнения пройдемся
прохожден: прохождению
совокупн: обзор
сраз: людей
сколков: резидентом
подробн: подробности выходили
похож: похоже
выпит: выпито
яндекс: рекламы
новост: новостей новости
существ: сей существует
перв: первую первого
перешагнул: перешагнул
приня: крайне
достоинств: достоинства
написа: написать написал
поиск: поиск
неудобн: большой
посвяща: айтишникам
основ: детей
мед: медиа
голов: подняла
образовательн: проекты
обрюзгш: морщинами
определ: определ трудно
как: пропасть умолчу прошлой
участник: чипов
недостаточн: недостаточного
голос: голосов произносить
почкин: ст
покрыт: одноклассников
кат: катом
встреча: встречаются
освобод: побыстрее
прошл: неудобной перевод
скептическ: скептическую
гаджет: гаджеты
рол: роли
точн: точно таковы
сфер: сфера ритуализированную
мем: бесчисленные
научат: научат
способ: возможных
бесчислен: посвящаются
мер: крайней
доказа: доказать
продукт: продуктом
компьютерн: компьютерное
обрат: обратить
найт: найти
заявк: разбором нашу
информацион: проектировании
занят: занятости
образ: основа образ
ввод: действий
туп: разобраться
щекочет: государства
конц: соцсетей ссылка
учет: компромиссные
аспект: связанных
предлага: предлагаю
обзор: патентование
электроник: производство электроники электронику
появ: появилось
удар: мар
доступ: доступ
мозг: нашим популярное
вернут: поддержка
миг: миг
схемотехник: задачи
сокраща: одном падают
буб: бубен
схем: обеспечивает схема
вообщ: корпорации
легкомысл: легкомыслия
стремлен: дешеветь
н: н
п: п
резидент: числе
дава: вообще
х: х
умнеют: поисковики
смут: представлении
показа: просьбой
поэт: поэтому
сочн: сочный
мин: мин
одинок: одиноко
сбыва: сбывается
памят: сохранением
мир: мире
писа: сокращается писал
исследован: исследования
знают: знают
внешност: недоволен
повезл: повезло
скор: никак скорого скором
диск: дисков диски
сообщен: личных
тренд: расскажем главных
кризисн: падения
получ: августе получил позитивом
вложен: вложения
несут: несут
перевод: мозг
одиночеств: одиночества
майнер: майнеров
списк: простых
забира: понемногу
час: час часов
чат: чат
скидок: отправки
млн: млн
погост: цифровой
индустр: индустрии
позиц: позицию
могл: недоумевая
яростн: могли
повышен: повышением
побыстр: поставщиков
жарен: жареной
кстат: отвернулся
больш: умной мере
контекстн: скликивания
мест: место
начин: простые
счет: деньги
токсичн: сомнениям
карьер: карьера
вход: вход
направлен: направления рассказываем направлениями
пристальн: пристально
полезн: полезными полезна обсудим
паническ: панических
попаст: статистика
пуга: внешностью
ввид: ввиду
представлен: маму
циркулирет: циркулирет
генерац: генерации
плавн: плавно
видел: разумеется
жизн: жизнью
методолог: гибкой
населен: населения
пыта: пытаются
сотн: сотни совру
гэг: мемы
момент: момента
основн: рассмотрим основной
вышл: вышло
отб: отбились
подготов: подготовят
сознан: сознания
решен: путь технологических
скликиван: защитой
одмин: одминах
средн: средний средняя старше
личн: личные сотню
нужн: нужны
поздн: поздно
смерт: человеческой сферу
носител: носителей
ощуща: фактического
хаб: хабы
меня: начинает
вызыва: мораль
опыт: опытом
полож: положил
настройк: дзен
дал: далее
накопител: накопителей накопители
пониман: гораздо
документ: завещаний авторов
прочтен: ознакомиться прочтение
предложен: предложенные
карма: карман
ссылк: ссылку телеграмм
монет: монеты
вдохнов: карандаш
фрейморк: фрейморка
дан: данных данной
дат: дать
привязан: привязанности
детальн: опыт
живш: жившим
утолщ: начинающих
модул: счет
дефицит: дефицита
технологическ: совокупность технологической
вредн: вредные вредных
кот: кот
деньг: токсичные
брат: моего
новостн: новостную
авит: продажи
старш: взрослые
возраст: субъективный касается капитулировать
патент: онлайн
вмест: прочие
разбор: детальным
ошибк: произошла
покупа: покупают
чип: сокращать
понемног: годов
обнов: обновить
объект: объект
разработк: разработкой разработка разработки
закладк: закладки
паден: сильного падение
начал: начале
руководств: руководство
накрыва: брата
высш: схватывают
преимуществ: преимуществах
произошл: пугается
минут: минуту минут
стольк: зеркало
дел: дело выше
завест: завести
вопрос: частые понимания банк повторить
рассказа: рассказать
пошагов: пошаговое
жит: жить
устройств: информация устройства
пришел: пришел
ваш: запуск
проход: проходит
докладыва: траншами
ответ: позволю
никт: фонд
пространств: тело
творческ: приветствую
проектирован: архитектурных анализ
измер: считаем
алгоритм: алгоритмов
август: директ
дет: тела
людьм: взаимоотношений
материал: исправляюсь
вентиляц: вентиляции
мегапроект: стартапам
хабр: хабр хабра
карандаш: бумага
абстрактн: степени
смел: смерть
отношен: субъекта
интроверт: интроверту
посмотрет: посмотреть
односложн: списков
мысл: мысли
последн: последние
искрен: искренне
технар: ных
заявлен: заявленными
месяц: месяцев месяц
сам: самая работу
примкнувш: примкнувший примкнувших
морал: общественную
стартап: стартап стартапа образовательные
возвраща: возвращается
жанр: жанрах
школ: школ
будоражат: смелые
образован: образования
называ: физиологи
длин: ушами
управлен: управление управлением
неожида: самые
сбо: авито произошел
руковод: руководил
тарелк: тарелка
век: века рубежа
начина: начинал интернеты электроника ситуация
внедр: подход
вер: верю
постел: постель
западн: инвесторов
прогноз: прогнозы прогноз
вс: вс
популярн: научно
дич: дичи
соцсет: появлением
област: инновации
научн: думаете
одноклассник: оглядываетесь
сво: подписчиков своими каждого
веб: веб
программирован: программирования
нача: начал
жалк: делал
реша: общем
специалист: специалисты специалистов
порог: порог
станов: становится
попробу: давайте
стрим: стрим
явля: способов
появлен: появлении появления юзерами
вещ: неожиданные
неудивительн: неудивительно
теря: теряют
развит: развитие
тимлид: тимлидов тимлида тимлидам
представ: сложно
сайт: сайта сайтов
научпоп: научпоп
технолог: технологий
продолж: продолжить
задач: интересной
происход: возраст
мелоч: тупая
обществен: будоражат
хвата: хватает
сегодняшн: сегодняшнего
пар: пару
треб: базе
вин: вина вино
нног: нного
зовут: зовут
истор: историей истории история
двум: дается
ещ: ещ
факт: факт
гибк: архитектуры
произошел: сбоя
легк: легко
сет: сети
вид: возрастом
представител: кризисного
конфиденциальн: соглашение
защит: занимается
внов: вновь
корпорац: южнокорейской
кошк: кошки
ищут: представители
естествен: вопрос
аномал: аномалия
повтор: попросила
обеща: обещающих
альтернат: альтернатив
инновац: смерти
зябк: зябко
памя: оперативная
пережива: озу
хоч: хочу
эволюц: эволюция
рейтинг: рейтинга рейтинг
визуализац: визуализация
известн: указания
покупател: скидок
структурирова: структурировать
сторон: сторону
обойт: покупателям
поток: потоки потока
кратк: проприоцепцией
смотр: всякий
поддержк: техническая
платя: платящих
тысяч: тысячи
дня: дня
принцип: принципе
хорош: хорош
стоимост: стоимости
пуст: пусть
ид: иду
любим: любимый
наш: кордицепса нашем фонда показать
моделирова: любит
ит: ит
суммарн: суммарной
пользовател: пользователей
просьб: сообщений
над: надеюсь
компонент: компонентов
большинств: закономерность
погна: погнали
умн: стала
робот: роботы роботами
разрабатыва: разрабатывать
попроб: попробую
сервис: сервисов
оперативн: писали
понижен: заработать
информац: информацию информации песочница
восторг: восторга
земн: количестве
ключев: ключевых
впуст: впустую
выгляд: выглядят выглядит
анализ: информационных
скилл: скиллами
умолч: фонды
неолуддит: неолуддиты
пет: пет
понят: абстрактное
ко: кое
упа: выручка
сериа: сериала сериал
квартал: привело
сорок: салфетку
идет: речь
например: возраста
кордицепс: гриба
самостоятельн: самостоятельно
увеличен: увеличением
презентац: презентация презентации
запуск: запуска фси
соответств: соответствия
нативн: реклама
попрос: головы
надежн: надежности
месячн: месячный
интуитивн: сразу
польз: пользуюсь жалко
рассмотрен: рассмотрения
стран: происходит странных
мо: кухне
сист: систем
сбива: слова
качеств: качестве
патентован: патент
смс: смс
выбор: выбор
позитив: вдохновением
государств: тема
онлайн: погост
проблем: ищут
айтишник: айтишника айтишники айтишниках существу забираются
дешевет: память
стейк: стейк
поставщик: стремление
раздел: регистрация
бород: борода
сол: соло
выигрыва: выигрывают
лучш: лучшая лучшие
владимир: владимир
управля: мозгом
оз: удар
формат: формату
дума: дадут деле
крайн: годах сложных
возможн: возможно одним
побежда: побеждают
интересн: решения
оп: вашего
твердотельн: твердотельных
увелич: собирается
учитыв: естественно
дает: пришли
кульгин: максим
семантик: семантика
подтвержд: подтвержден
крупн: внедрен
капитулирова: яростно
неполн: неполной
молож: среднем
крут: какие
бока: бокал
меша: мешает
гриб: споров
взгляд: взгляд
тематическ: сериалы
надвига: надвигающейся
портфол: портфолио
изначальн: изначально
архитектур: сбалансированной
контент: контент
пада: цены
откр: открыть
наход: находится
никак: сколково
ритуализирова: представить
magic: magic
vladimir: vladimir
copilot: copilot
ruvd: ruvds
govern: governance
ssd: ssd
devop: devops
rostislavdugin: rostislavdugin
microsoft: microsoft
theori: theory
adalan: adalan
evgeniir: evgeniir
qa: qa
cloud: cloud
twitter: twitter
dram: dram
vikdovnar: vikdovnar
gtd: gtd
faq: faq
block: blocks
mastervlado: mastervlados
augur: augur
cto: cto
tech: tech
ik: ik
selectel: selectel
ai: ai
adl: adl
develop: development
markati: markaty
iv: iv
makasin: makasin
cern: cern
otu: otus
ingirov: ingirov
semenyuk: semenyuk
kopchenii: kopcheniy
vk: vk
scrum: scrum
architectur: architecture
habr: habr
deathtech: deathtech
bodi: body
descript: description
game: game
offlinecrm: offlinecrm
death: death
log: log
cio: cio
timeweb: timeweb
webtron: webtronics
clickfraud: clickfraud
youtub: youtube
notion: notion
samsung: samsung
rss: rss
dmitriizolotov: dmitriizolotov
midjournei: midjourney
adminvp: adminvps
seo: seo
gregyku: gregyku
chatgpt: chatgpt
crm: crm
stabl: stable
mind: mind
erp: erp
twitch: twitch
agil: agile
greiv: greiv
facebook: facebook
xxi: xxi
hdd: hdd
telegram: telegram
erwinm: erwinmal
bing: bing
commerc: commerce
googl: google
spotifi: spotify
sashageo: sashageo
diffus: diffusion
