термина: терминал
обрат: обратить
максимальн: максимально
готов: реализации переписать
говор: тружусь
провер: мере
консольн: консольного консольным
понима: понимал понимать
фактическ: фактически
экспериментальн: экспериментально
образ: образом
значен: значений
стат: стать контексте статье
смеша: смешанный
ввод: ввода
оказа: оказаться
стар: вернуться
вызов: вызова вызовом
вводн: вводной
учет: учетом
составлен: составлением составления
мнен: моему
предлага: предлагаемого следующей
соглас: согласен
захож: захожу
категорическ: категорически
появ: появился
случа: результат случаях
став: ставим
атавизм: обозначенный
работ: работа работы работе
завис: зависит
заход: заходит
запуска: запускался
дополнительн: дополнительная дополнительных
практическ: практически
сценар: сценарии сценария сценарий
доступ: доступ доступен
вернут: поддержка
ухитря: ухитряемся
терминал: терминале
впечатлен: первое
пол: поля полей
обновлен: обновления
словар: словарю словаря словарей попадают словаре
менеджмент: менеджмент
лет: лету
единствен: единственному
субд: субд
преврат: превратить
то: той
вымерл: вымерла
структур: структуру структуры
исчисля: исчисляется
регулир: регулируется
публикац: сайт
ветк: ветке
скопирова: ссылке
многофункциональн: многофункциональной
одиночн: рейтинг
поэт: поэтому
котор: которым впечатление
карм: комментарии
мин: мин
вариант: варианта вариант варианту варианте
прописа: прописать прописан
пор: порой
отойд: отойду
назначен: назначения назначение
стоков: стоковый
совершен: совершенно
прав: правило
связа: связанной
безопасн: безопасно
проверя: проверять
отмет: отметить
либ: либо
скор: скорее
проект: проекта нативные
вперв: впервые
относительн: относительно
автоформатирован: автодополнением
профил: профиль профиля
дела: делающая делают делать
оправда: оправдан
получ: удалось статья
крича: перестать
режим: режима
перевод: объекта переводятся
верс: заменить модифицированная стабильной
исключен: исключения исключение
маркетинг: маркетинг
компилируем: компилируемых
списк: списка
рук: дошли руками
внутр: внутри
прям: прямого
позвол: позволит
языков: языковое
зам: замены
проверк: проверку
зап: запись
следова: вещей
справедлив: справедливые
олдсульн: олдсульных
разумеет: разумеется
очевидн: очевидным
специфик: специфике
нов: новую
обошл: заметок
внешн: внешнюю внешний
кстат: кстати
нод: ноду
клавиш: клавиши клавиш
надп: надпись
больш: больших большой
контекстн: контекстного
медийн: блог
мест: местами большинство
част: частый части
счет: счет
карьер: места
слов: слова слов ключевым
аналогичн: аналогичных
опц: последнюю опция
модифицирова: репозитория
излож: изложено
приемчик: запрещенных
принудительн: использован
сдела: сделать
особен: особенность
торт: торте
устанавлива: устанавливается устанавливаем устанавливать устанавливаться
сложн: которое сложных
расшир: попытался
представлен: представлений
печат: печати
пут: путем
примен: применим
окружен: окружения окружением окружение
пример: пример
выпада: выпадающего
подключа: подключался
инициализац: инициализацию
процедур: процедур процедуры
систем: системы системой
пыта: пытаются пытается
подстраива: подстраивающийся
момент: данный
мыслим: мыслимые
труж: ним
развива: развивающих
основн: основных
популяр: популярен
провайдер: провайдеров
курс: курсе
текущ: текущей
нивелирова: нивелировать
сторонник: сторонники
переопределен: переопределения
облада: обладает
читател: читателей читатель читателя
процесс: процесс
перезапуст: перезапустим
перемен: переменных переменную переменной
привест: форматировщики
дошл: проверить
решен: решению решение решений
достойн: достойным
истерическ: истерический
личн: личных личная
нужн: нужному нужна
помест: поместив
поздн: поздно
хаб: теги
описан: словарь
современ: современные современных современное
помощ: помощи
драгоцен: драгоценное
выш: выше
неко: некоем
приложен: приложением приложений приложение
лож: ложится
выполня: выполнять
разработчик: разработчиком разработчика
результат: желаемый
тонк: повозиться тонкие
обозначен: принудительно
подразумева: подразумеваю
благообразн: благообразно
настройк: настройки настройка тонкими
форматировщик: известные
дал: далее
текст: тексту
выключа: выключает
контекст: следовало контексту
показател: показатель
крик: крик
документ: компаний
прочтен: прочтение
универсальн: универсального
запрещен: обошлось
желан: желание желании
вспомогательн: вспомогательная
кавычек: применении
ссылк: ссылку версию
единожд: единожды
выделен: выделения
отнима: отнимать
задержк: задержка
интерес: интересуют
подойдут: подойдут
средств: средства готовыми
дан: данных данными данные параметрами данном
имел: имел
установ: установить установим установил
весьм: весьма
минимальн: минимальные
поделк: поделка
плох: плохо
код: кодами коде кодом
детальн: промежуточный
регистрац: войти
вряд: вряд
универсал: универсален
служебн: служебных
имеет: имеет
соединен: соединения соединение
цикл: цикле цикла циклу
обновля: обновляться
отладк: отладки
отсутств: отсутствие
завися: зависящий
функц: функций словам функции
привяза: привязанной
заменя: заменяет
брат: брать
цел: целом целях
инициализирова: инициализировать
понадоб: понадобится
отлича: отличать
брал: брал
заран: заранее
кажд: каждом каждого
возника: возникает
регистр: исходном регистр регистром
дзен: яндекс
энтузиаст: энтузиасты
глобальн: глобальную глобально
взаимодейств: взаимодействие взаимодействия
вмест: вместе
обознач: обозначен
разбор: разборе
директор: директорию
создава: создавать
решат: карьер
синтаксис: синтаксиса
прилож: приложил
кажущ: кажущуюся
идут: идут
обнов: обновить
объект: объектов объектам атавизм объекты
разработк: разработка
налич: наличия
серьезн: серьезная
закладк: голосов
графическ: графического графический графических графические
настроек: настроек
использова: использовать понять
загружа: загружать
начал: началу
желез: железа
достаточн: достаточно достаточным
подсветк: подсветки
повседневн: повседневной
форматирован: отношения форматирования форматировании
примерн: примерно
установк: установка установке
вышеупомянут: вышеупомянутого
добавля: добавляются
закономерн: закономерное
изнутр: изнутри
список: список
итог: итоге
удоб: удобен
реляцион: реляционных
след: следующий настройками регистре следует следующим
строк: строка строке
нашел: нашел
дел: взгляд делая дело
дизайн: дизайн
производительн: производительности
перечислен: перечисленными
помим: помимо
устройств: устройстве информация
попыта: приемчиков
текстов: текстовые
клиент: клиента клиент клиентов
ваш: вашей
так: таки такого таких таким
общен: общения общении
полност: полностью
несмотр: несмотря
выясня: выясняется
собствен: собственную собственных собственно собственного
переписа: решат
баз: баз базами кричать базы базе базах
привык: привык
техническ: дзен
мощн: мощный
отсыла: отсылаю
драйвер: драйвер
цельн: цельное
уда: средствами
фев: фев
оговор: оговориться
расширен: расширения расширение расширений
заметк: заметке
вкусовщин: вкусовщина
мегапроект: стартапам
целостн: целостность
описыва: описывал
хабр: хабр
откуд: откуда
предпочита: предпочитаю
некотор: недолго
отношен: привести переводит
количеств: количество
соглашен: документы
добав: добавим добавить
просмотр: просмотров
специальн: специально специальным специальную
практик: практика
замечан: замечания
последн: последняя последний руки
орфограф: орфографии
конфигурац: конфигурации конфигурацию
сам: самых самым
представля: представляет
бд: бд
виртуальн: виртуальных
настраива: настраивать
нынч: нынче
закр: закрыть
сутк: лучшие
стартап: программы
туториа: туториал
подключен: подключение подключения
выглядет: выглядеть
восстанов: сложно
спорн: спорному
озвучен: озвученных
поня: версия
абсолютн: абсолютно
болячк: псевдонимов
промежутк: промежутков
развертыван: развертывания
менеджер: менеджер
сбок: сбоку
степен: степенью степени
выполнен: выполнения
компан: авторов новости
программ: программ образовательные
ограничен: ограниченные
длин: длинный длина
зажима: зажимают
разбира: разбирается разбирался
главн: главная
принят: принятое
цепочк: цепочка
соответствен: соответственно
предпочтен: предпочтение предпочтений
страда: болячкой
перечен: расширить
смысл: делим
заключа: заключается
умолчан: умолчанию
недолг: остановиться
испорт: детальный
начина: начинает
интерактивн: интерактивные
вс: вс
использ: использует
визуальн: визуальное
элементарн: элементарно
вручн: вручную
простот: простоту
кусок: подробной
плагин: плагин плагинов плагина
ран: ранее
объясня: объяснять
веб: веб
нижн: нижний
отдельн: отдельной отдельными отдельный
отобража: отображать
реализ: реализуется
станов: становиться
выполн: выполнить
предоставля: предоставляющий
значительн: значительно
реализац: деталях
энтузиазм: известной
тег: мнению
явля: является
редактирован: редактирования
кавычк: кавычках
нужда: нуждаются
вещ: пара
неудивительн: неудивительно
минималистск: минималистской
сбалансирова: сбалансированы
подшаман: подшаманить
ощутим: ощутимо
легас: легаси
администрирован: администрирование
первичн: первичной
различа: различает
определя: определять
сайт: пользователь устройство
непонят: непонято
знал: знал
подгружа: подгружать
научпоп: научпоп
задач: задач
файл: файлов файла файлами файле файлы файл
комментар: закладки
клиентск: клиентским
рамк: рамки
пользова: пользоваться
проч: прочего прочим
трет: третьих
автодополнен: случае автодополнения автодополнение
сочетан: сочетанию
работа: работало работает работать
сильн: сильно
детал: некоторых
проф: профили
долг: долгих
песочниц: авторы
сегодняшн: сегодняшнего
пар: осталась
услуг: конфиденциальность
оставля: остальное
треб: требует требуется
необходим: необходимость необходимо необходимым
блог: корпоративный
числ: числе
подходя: подходящий
истор: похожие
зрен: зрения
верхн: верхним верхний
интерфейс: интерфейс
скрипт: скриптов скриптами скрипты
чист: чистая
вниман: внимание
параметр: параметры обязательными
автор: компании сайта автором
автокоманд: автокоманды
лежат: лежат
вишенк: вишенкой
очеред: очередь
легк: легко
конфиденциальн: соглашение
локальн: локальные локально
попада: перечень попадать
придет: придет
естествен: естественным
оста: исходный
изыска: изысканном
быстр: быстро
контролирова: контролировать
тип: типа тип
позволя: позволяет
избыточн: избыточный
эволюц: эволюция
внедрен: внедрением
распространен: распространенный распространенных
статическ: статическую
рейтинг: карма
реч: речь
реш: решил
способн: способно
известн: форматированию восстановить
общ: общем общая общей
горяч: горячих
недостатк: недостатках
сторон: сторону стороны сторонних сторонней
поток: потоки
пута: момент
поддержк: техническая поддержки
специфическ: специфических специфические
остальн: функциям
состо: состоит
набор: наборе
тысяч: тысячами
модульн: модульную
родн: родной
принцип: принципов
предназнач: предназначены
хорош: хорошим
библиотек: библиотеку библиотеки
обо: обоих
ид: идею
догада: догадаться
удобн: удобно удобный
повоз: готовый
сред: средах среды
комплексн: комплексной
предыдущ: предыдущей предыдущего предыдущий предыдущем
им: имена
ин: иных
редактор: редактор редактора редакторах редакторе
темп: темпа
разнообразн: разнообразные
пользовател: палата
перегрузк: перегрузка
сущност: сущностей
язык: языках языком языка
большинств: энтузиазма большинстве
останов: предлагаю
несложн: несложно несложной
обязательн: обязательно описанием
таблиц: таблиц
оперативн: оперативном
предвид: предвидя
гол: голый
информац: песочница
совмест: совместить
ключев: ключевых ключевые отношению
выгляд: вожусь
привязок: привязок
малопригодн: малопригодный
отвеча: отвечает
замен: базу
целев: целевом
дополнен: дополнения
пакет: пакеты
конкретн: конкретного конкретно конкретной
добавлен: добавленный добавления
парол: пароль
переста: опцию
отража: отражается
широт: широте
применен: применения путается
встроен: встроенный
размещен: размещения
допотопн: допотопных
распина: распинаться
вывод: вывода
заточ: заточены
прич: причем
конвейер: конвейеров
привод: приводит
например: например
отвлек: отвлекаясь
знает: знает
одн: одно одним
самостоятельн: самостоятельно
наворочен: навороченные
увеличен: увеличения
реклам: медийная
запуст: запустить
псевдоним: кавычек
корпоративн: услуги
функциона: функционал функционала
потребн: потребности
соответств: соответствующую
запуск: запуске
синтаксическ: синтаксическом
нативн: реклама
глубж: глубже
попрос: попросить
расширя: расширяет расширяется
команд: команду команды команд
итак: итак
огранич: ограничен
экземпляр: экземпляром
польз: пользуется
субъективн: субъективно
заметок: следующих
вож: автоформатированием
соблюда: соблюдать
инструкц: инструкцию инструкция
удивлен: удивление
использован: использование использования использовании
отлич: отличии отличие отличиях
платформ: платформ
мо: сыровато
запрос: запросы запросов запросами
сист: систем
специфичн: специфичную специфичных
упорств: упорством
войт: аккаунт
исходн: исходными оставляют исходным страдает
качеств: качестве
аккаунт: истории
исходник: исходник
выбор: выборе
сраз: сразу
кост: костыли
проблем: проблема
подробн: наверное подробнее
репозитор: измененные
раздел: регистрация разделе
автоматическ: автоматического автоматически
похож: сутки похожими
вынесен: вынесенными
жела: получить
яндекс: мегапроекты
новост: разделы
существ: существует
лучш: публикации лучшего
перв: первую первых первая испортить
механизм: механизм
бог: бог
небольш: небольшого
дума: думаю
относ: относились
корн: корне
сыроват: выглядит
разворачива: разворачиваться
промежуточн: промежуточных смысле
крайн: версии
поиск: поиск
возможн: возможности возможностей возможностями
автоматизирова: автоматизированных
интересн: интересные
изменен: скопировать
дальн: дальнейшая
равн: равно
основ: основу
планир: планируется
выбра: выбрать
открыт: открытия
отображен: отображения
исполнен: исполнения
палат: одиночная
образовательн: проекты
как: какую каком каких какие
функциональн: функциональности
эдак: эдакой
непосредствен: непосредственно непосредственного
все: всей
недостаточн: недостаточно
голос: хабы
меша: мешает
упомянут: упомянутой упомянутый упомянуто
взгляд: кусок
рассужден: рассуждений
трога: трогать
дублир: дублируется
род: рода
высок: высокого
наверн: получилось
поведен: поведения поведение
реальн: реальных реальными
стабильн: говорить
втор: вторая второго
добавл: добавлю
точн: точно
складн: складный
наверняк: наверняка
высот: высота
диалект: диалекте диалекта диалект
точк: точки
улучша: улучшающая
стандартн: стандартной стандартным
откр: открыть
мен: меню
способ: способа способ
мер: крайней
напрям: напрямую
sbp: sbp
leader: leader
sourc: source
nospel: nospell
sensit: sensitivity
pluginstal: pluginstall
extens: extensions
shift: shift
endfunct: endfunction
complet: completion
omnifunc: omnifunc
ignor: ignore
type: type
conqueror: conqueror
branch: branch
plsql: plsql
rembo: rembo
twitter: twitter
cocconfig: cocconfig
vim: vim
id: ide
write: write
case: case
ext: ext
github: github
var: var
modul: modules
tiger: tiger
omni: omni
substr: substring
script: scripts
databas: database
exist: exists
node: node
exit: exit
mission: mission
passwd: passwd
pumheight: pumheight
exact: exact
habr: habr
tpope: tpope
cmp: cmp
js: js
global: global
dbext: dbext
neoclid: neoclide
kei: key
youtub: youtube
pictur: pictures
default: default
coclocalconfig: coclocalconfig
releas: release
scott: scott
set: settings set
facebook: facebook
suggest: suggestion
menu: menu
cp: cp
url: url
weird: weird
plugin: plugins
coc: coc
vimrc: vimrc
config: config
return: return
db: db
dbpromptforbufferparamet: dbpromptforbufferparameters
dialect: dialect
coninstal: coninstall
prefer: prefer
wrapper: wrapper
lowercas: lowercase
tab: tab
oracl: oracle
function: function
johnrembo: johnrembo
limit: limit
dotenvget: dotenvget
clipper: clipper
localhost: localhost
imposs: impossible
srvname: srvname
profil: profiles profile
list: list
eval: eval
abort: abort
vk: vk
orcl: orcl
http: https
paramount: paramount
plug: plug
lsp: lsp
sql: sql
ftplugin: ftplugin
cap: caps
git: git
json: json
autoload: autoload
ora: ora
nvim: nvim
readm: readme
match: match matching
telegram: telegram
label: label
env: env
strategi: strategy
dotenv: dotenv
clone: clone
dadbod: dadbod
neovim: neovim
user: user
mark: mark
