нейрон: нейронная нейронной
максимальн: максимально
найт: найти
говор: говорится
банк: банк
расскаж: расскажу
экспериментальн: экспериментально
значен: значение
образ: образом образ
стат: стать статью статье статьи статей статья
оказа: оказалось оказалась
имитир: имитирующих
стар: старую
конц: конца
стал: стало
мнен: мнение
объясн: объяснен
линейн: линейной линейному
обзор: обзор
появ: появились появилась
случа: случае
успех: успеха
реализова: реализовать реализованы реализовано
работ: работа работе работу работы работой
запуска: запускать
показыва: показывает показывать
дополнительн: дополнительные
арс: арсен
практическ: практически
сценар: сценарии сценариям
доступ: доступа
вернут: вернуться
выяв: выявить
абстракц: абстракций
удач: удача
получен: получения
инфраструктур: инфраструктуре
лен: лень
штрасс: штрассена
вообщ: вообще
менеджмент: менеджмент
интеграц: интеграции
л: л
преврат: превратитесь
неудобств: неудобства
разговор: разговор
основательн: основательно
снижен: снижения
должн: должны
ошибок: ошибок
перейдет: перейдете
коэффициент: коэффициента
публикац: публикации
скопирова: скопировать
студент: студент
карт: карту
подел: поделиться поделюсь
показа: показан показать
бэкграунд: бэкграундом
поэт: поэтому
благодар: благодаря
котор: которую которое которым
денег: денег
провест: провести
ув: увы
мин: мин мини
отнест: отнести
мир: мире
примечан: примечание
эксперимент: экспериментов
писа: писал
шаг: шагом
скор: скорее
диск: диск диска
уч: уч учился учились
проект: проекты проектов
начнет: начнете
проскоч: проскочить
упроща: упрощает
профил: профиль
дела: делает делал делающими
ооп: ооп
сообщен: сообщениями
получ: получился получил получилось
тестер: тестера тестеров тестер
приобрел: приобрела
документац: документации документация
перевод: перевод
верс: версию
важн: важны
маркетинг: маркетинг
книг: книг книга
аргумент: аргумента аргументы
разобра: разобраться
центральн: центральный
декабр: декабре
рук: руками
час: час часов
ежегодн: ежегодная
хаброжител: хаброжители
прост: простой
внутр: внутри
предобучен: предобученной
прям: прямо
стэк: стэка
заодн: заодно
рубл: рублей
справ: справится
индустр: индустрии
занима: занимает
могл: могли
подписк: подписка
повышен: повышение
уровен: уровень
нов: новые новое
умеет: умеет
клавиш: клавиш
больш: большого
медийн: медийная
мест: место
част: частью
иде: идея
динамическ: динамической
счет: счет
предполож: предположить предположим
карьер: карьера
литератур: литература
осво: освоите
направлен: направленная
самоучк: самоучки
полезн: полезные полезных полезно
граф: графам
отказ: отказов
нны: нные
сдела: сделать
телегр: телеграм
особен: особенности
сложн: сложный сложных
редк: редко
отказоустойчив: отказоустойчивость отказоустойчивости
капот: капот
поработа: поработаете
представлен: представлений
примен: применить
пут: путем
жизн: жизни
пример: пример примере примеры примерах
операцион: операционной
систем: системы системами
мож: можем
класс: класс
рефакторинг: рефакторинг
узна: узнайте узнаем
сотн: сотни
затрон: затронем
момент: момент
отклик: откликов
основн: основным основных основной
микросервис: микросервисы
вышл: вышло
курс: курса курсов
сможет: сможет
текущ: текущую
облада: обладать
математик: математика математике
машин: машинное машинного
процесс: процесс
основа: основанную
подготов: подготовил
привест: привести
требован: требование
решен: решений решению решение решении решения
написан: написание написании написания
хотел: хотел
продуктивн: продуктивной
провод: проводил
средн: средний
личн: лично
комфортн: комфортнее
нужн: нужны
подряд: подряд
ощуща: ощущал
помога: помогает помогал
хаб: хабы
рынк: рынке
повыс: повысить
современ: современном
наставник: наставника
аналитическ: аналитическими
результат: результате результаты
разработчик: разработчиков разработчик разработчиком разработчика
вызыва: вызывает
опыт: опытом опыта
вычислен: вычисления вычислений
ваканс: вакансии вакансий
настройк: настройка настройке
обнаруж: обнаружил
вклад: вклад
дал: далее
фанат: фанатом
матричн: матричными матричные
текст: тексте
альф: альфа
пониман: понимание
функционирован: функционирования
сортировк: сортировки
документ: документы
прочтен: прочтение
будущ: будущее
предложен: предложение
божествен: божественных
увер: уверены
ссылк: ссылку
навык: навыки
линкольн: линкольна
нул: нуля
имел: имела имелось
дисциплин: дисциплина
дан: данный данными данные данных данную данной данного
потребова: потребовалось
программист: программист программиста
займет: займетесь
охват: охватить
коррекц: коррекции
сподвигл: сподвигло
установ: установить
дат: дать
приобрест: приобрести
состоя: состоялся
код: кода код
зарегистрирова: зарегистрировать
помогл: помогло
задумыва: задумываемся
регистрац: регистрация
сократ: сократить
технологическ: технологического
григоря: григорян
извест: известен
издательск: издательский
пайчарм: пайчарма
отладк: отладки
эффект: эффект эффекте
функц: функциями функциям функции
упрост: упростить
внесен: внесением
пустот: пустоту
цел: цель целей целью целых
новичк: новичкам новичков
трудолюб: трудолюбие
изуча: изучал
звуч: звучит
доступн: доступны доступность
ошиба: ошибался
возника: возникали возникают
увид: увидите
оцен: оценить
холивар: холивара
дзен: дзен
подписок: подписок
вмест: вместе
минимум: минимум
искусствен: искусственный
отличн: отличный
шенхаг: шенхаге
параллельн: параллельную
понемног: понемногу
обнов: обновить
име: имея
разработк: разработка
закладк: закладки
довод: доводил
использова: использовать использован
танц: танцев
логик: логике
продакшн: продакшна
юн: юнит
заня: заняться
достаточн: достаточно
повседневн: повседневной
контейнер: контейнеры контейнера
установк: установки установка
сюд: сюда
преимуществ: преимущества
список: список
освещен: освещения
сказа: сказано
знаком: знакомится
след: следующий следующую
занижен: занижения
дел: дело деле делюсь
нашел: нашел
вопрос: вопрос
дизайн: дизайн
умножен: умножение умножения
устройств: устройство устройств устройства устройствами
квалификац: квалификации квалификация
пришел: пришел
прикладн: прикладных
ваш: вашу вашего
телеграмм: телеграмма
ответ: ответов ответы
так: таки
публикова: публиковать
перевест: перевести
проектирован: проектирование
собствен: собственных
переписа: переписал
баз: базе
техническ: техническая
измен: изменился
понрав: понравился
замк: замки
уда: удалось
алгоритм: алгоритмы алгоритмов алгоритмами
фев: фев
людьм: людьми
копипаст: копипастой
заметк: заметки
контролируем: контролируемых
мегапроект: мегапроекты
описыва: описывается
хабр: хабр
формул: формулам формулами
евангелист: евангелистом
аналитик: аналитик аналитиков
обучен: обучения обучение обученную
некотор: некоторые
рассмотр: рассмотрим
потенциальн: потенциальные
обща: общаться
претенд: претендует
количеств: количество
введен: введения
соглашен: соглашение
диалог: диалог
добав: добавить
просмотр: просмотров
практик: практики практикой практике
умест: уместить
месяц: месяцев
конфигурац: конфигурации
сам: самое
объем: объема
интеллект: интеллект
стро: строится
скаж: скажем
захотел: захотел
настраива: настраивать
друг: другом другими другому другим друг другу
питер: питер
стартап: стартапам
туториа: туториал
бубн: бубном
возвраща: возвращающий возвращать
правильн: правильно
поня: понять
абсолютн: абсолютно
компан: компаний компании
рассказыва: рассказывал рассказывают
степен: степень
программ: программе программы
управлен: управления
вчер: вчера
фундаментальн: фундаментальной
записа: записав
обузда: обуздать
сбо: сбоям
привел: привел
созд: созда
недорог: недорогой
начина: начинающий
привет: привет
поможет: поможет
во: вое
прогноз: прогнозами
вс: вс
популярн: популярности
высокоуровнев: высокоуровневого высокоуровневый
покаж: покажите
ускор: ускорить
рад: ради
использ: используется использующий использую
област: области
созда: создана создать
достига: достигать
плагин: плагинов
ран: ранее
сво: своим сво своими своем
предшествова: предшествовали
помн: помню
взаимодействова: взаимодействовать
программирован: программированию программирование программирования программированием
распределен: распределенных
первостепен: первостепенное
нача: начать началось
реша: решать
даст: даст
порог: порог
просто: простоя
интернет: интернет
тест: тесты
значительн: значительным
реализац: реализацию реализации
находчив: находчивой
легион: легион
явля: является
юност: юности
вещ: вещи
чисел: чисел
хобб: хобби
тем: тему темы
применя: применять
официальн: официального
пришл: пришла пришлось
полн: полную
администрирован: администрирование
знат: знать
дверн: дверные
сайт: сайта
сгенерирова: сгенерировать
знан: знаний знание знанию
научпоп: научпоп
технолог: технологию
комментар: комментарии
задач: задачу задача задач задачи
файл: файлы
ежемесячн: ежемесячная
рамк: рамках
пользова: пользоваться
различн: различными
приступ: приступим
задан: задание
типизац: типизацией
компьютер: компьютером компьютер
термостат: термостаты
работа: работать
сильн: сильно
достигнут: достигнута
прос: просим
долг: долгих
песочниц: песочницы песочница
долж: должен
поучительн: поучительном
услуг: услуги
треб: требует требующие
необходим: необходимых
блог: блог
истор: истории история
индекс: индекс
зовут: зовут
числ: числе
двум: двумя
период: периода
модел: моделью модели модель
шум: шумами
пробл: проблему
сложност: сложности сложностью
ещ: ещ
факт: факт факте факта
привед: приведем
автор: авторы автором авторов автора
гка: гкая
чита: читать
пробн: пробного
сет: сеть сети
конфиденциальн: конфиденциальность
собеседован: собеседованиях
распоряжен: распоряжении
чтен: чтение
умен: умение
триад: триаду
неузнаваем: неузнаваемости
подход: подхода подходить подход
твит: твитов
теор: теории
науч: научил
тестирован: тестирование
историческ: исторически
ранжирован: ранжированию
розетк: розетки
быстр: быстрого
нескольк: нескольких
эксперт: эксперта
повтор: повторил
спрос: спросить
принима: принимают принимать
хот: хотят хотите
тип: тип типов
позволя: позволяет
дойд: дойдя
спектр: спектра
сумм: сумму
хоч: хочу
рейтинг: рейтинг рейтинга
реч: речь
дом: дом дома домах
реш: решил решили решить
известн: известные
общ: общую общее
горяч: горячих
окончан: окончание
поток: потоки
поддержк: поддержка
остальн: остальные
поддержива: поддерживающие
тысяч: тысячи
прилага: прилагается
брокер: брокере
принцип: принципах
предназнач: предназначена
хорош: хороший
профессиональн: профессиональная
стоимост: стоимости стоимость
обм: обмена
библиотек: библиотеку
удобн: удобные
предыдущ: предыдущей
наш: нашей нашем
ин: иные
может: можете
моделирова: моделировать
ит: ит
разнообразн: разнообразных
пользовател: пользователей
люб: любого любому любой
язык: языков язык языки языками языка языке языку языком
большинств: большинства
заказ: заказу
умн: умный умного умных
сил: силу
заглянут: заглянуть
разрабатыва: разрабатывать
стил: стиль
регулярн: регулярных регулярным
описа: описать
информац: информация
разн: разных
анализ: анализ
видим: видимому
математическ: математическими
разв: развить
цикломатическ: цикломатической
погод: погоды
использу: используем
конкретн: конкретно
сборк: сборки сборке
применен: применение применением
поговор: поговорим
обработк: обработку
кластеризац: кластеризацией
создан: создание созданию
особ: особое
каскад: каскад
расход: расходов
прикинут: прикинуть
практикум: практикуме практикум
производствен: производственных
знает: знаете
например: например
одн: одном
мам: мами
отправля: отправлять
продаж: продаж
картинок: картинок
самостоятельн: самостоятельно
агрегатор: агрегатор
мар: мар
целик: целиком
широк: широкого
реклам: реклама
разбер: разберу
запуст: запустить
корпоративн: корпоративный
рекомендац: рекомендаций
функциона: функционал
потребн: потребности
соответств: соответствующей
запуск: запуска
нативн: нативные
выпускник: выпускники
подборк: подборкой
инструмент: инструменты инструментах
надежн: надежность
огромн: огромное
опиш: опишу
сообществ: сообществах сообщества
плюс: плюс
предшеств: предшествующую
интуитивн: интуитивных
сконцентрирова: сконцентрироваться
польз: пользуюсь польза
любопытн: любопытно
апрел: апреле
архитектор: архитекторов
вод: воды
предупрежда: предупреждать
инструкц: инструкцию
устран: устранить
уровн: уровне
использован: использованию использования использованием
мо: моем
запрос: запросы
потрат: потратил
осваива: осваивал
сист: систем
войт: войти
качеств: качестве качество
распредел: распредел
аккаунт: аккаунт
сомнен: сомнения
вычислительн: вычислительных
выбор: выбор
протокол: протокол
наследник: наследников
наскольк: насколько
проблем: проблемы
опытн: опытных
сервер: сервер
откровен: откровений
бот: бот бота
раздел: разделы
жела: желаемая
вполн: вполне
нетривиальн: нетривиальная
мытарств: мытарствами
яндекс: яндекс
новост: новостей новости
лучш: лучшие лучших
существ: существуют существует
перв: первые первым первого первое
механизм: механизмами механизмах
управля: управляешься
небольш: небольшого небольшой небольшом
операц: операциями
проведен: проведения
близк: близки
столбик: столбика
написа: написать написал написан
пойдет: пойдет
добр: добрый
поиск: поиска поиск поисков
изменен: изменения
возможн: возможности возможность возможными возможно
интересн: интересным
автоматизирова: автоматизировать
оп: опыт
основ: основы
регресс: регрессии регрессия
выбра: выбрал выбрать
голов: голову голове
сердц: сердце
образовательн: образовательные
как: какие каких
голос: голосов
страниц: страниц
покрыт: покрытия
пл: пл
фильм: фильмов
загруз: загрузив
высок: высокое высокой высокая
реальн: реальные реальных реальными
изначальн: изначально
точн: точно
рол: роли
выступа: выступать
наверняк: наверняка
воспользова: воспользоваться
сфер: сфере
установлен: установленного
откр: открыть
способ: способ
наход: находясь
никак: никакие никаким
бюджетн: бюджетные
термин: термина
клик: клик
big: big
copilot: copilot
ruvd: ruvds
data: data
arsen: arsen
kesn: kesn
dr: dr
saluev: saluev
cloud: cloud
factori: factory
pushtaev: pushtaev
twitter: twitter
vova: vova
java: java
mqtt: mqtt
raspbian: raspbian
soltanoffsu: soltanoffsu
text: text
id: ide
api: api
alisichkin: alisichkin
python: python
kivi: kivy
vmihaylov: vmihaylov
russian: russian
io: ios
ai: ai
normalisht: normalisht
xcode: xcode
javascript: javascript
vd: vds
market: market
openai: openai
zigbe: zigbee
ctype: ctypes
vk: vk
pycharm: pycharm
habr: habr
kera: keras
numpi: numpy
jame: james
craxti: craxti
object: object
engin: engineering
davinci: davinci
hzge: hzge
code: code
ru: ru
natur: natural
scientist: scientist
android: android
pascal: pascal
languag: language
js: js
alrusdi: alrusdi
youtub: youtube
raspberri: raspberry
sd: sd
tensorflow: tensorflow
rss: rss
piter: piter
gildedros: gildedrose
sansanychseva: sansanychseva
grigoryvp: grigoryvp
linux: linux
wut: wut
homm: homm
chatgpt: chatgpt
sam: sam
dimitryabramov: dimitryabramov
process: processing
product: productivity
alizar: alizar
productivityinsid: productivityinside
facebook: facebook
refresh: refresh
telegram: telegram
jessi: jessy
vlad: vlad
vsecod: vsecoder
dmitryspb: dmitryspb
kralek: kraleks
django: django
yandex: yandex
vpn: vpn
ph: ph
pi: pi
time: time
chao: chaos
scorobei: scorobey
rubi: ruby
