встал: встал
случ: случиться
оценк: оценки
банк: банк банка банке
понима: понимали понимать
стат: стать статью статье статьи статей статья
оказа: оказалось
стар: старую
инвестор: инвесторов
рабоч: рабочих рабочими рабочие рабочей
стал: стала стали стало
мнен: мнение мнению
составлен: составлению
указан: указания
стаж: стажем
став: ставить
реализова: реализован
работ: работа работе работой работы работу
показыва: показывают показывать
арх: архив
получен: получения
инфраструктур: инфраструктура
сто: стоит
обидчив: обидчивость
критическ: критически
каск: касках
тз: тз
ти: ти
менеджмент: менеджменте менеджментом менеджмент
пункт: пунктов
финанс: финансы
интеграц: интеграции
стечен: стечения
банальн: банальной
публикац: публикации
скопирова: скопировать
готовн: готовность
макс: макс максим
подел: поделиться поделюсь
процессн: процессный
благодар: благодаря
котор: которое котором которым
провест: провести
сборок: сборок
благ: благо
бывал: бывалого
шаг: шагов
прав: правило права
связа: связанных
оригинал: оригинален
манифест: манифест
компромиссн: компромиссные
либ: либо
проект: проектам проекты проект проектов проекте проектами проекта
связ: связь
появля: появляется
майк: майка
профил: профиль
дела: делает делал делают делать делаю
приветств: приветствую
статик: статик
проектн: проектной проектном проектная
документац: документации документацией
дискусс: дискуссию
верс: версию
маркетинг: маркетинг
каноничн: каноничной
прост: простой простые простых
альтернатив: альтернативу альтернативы
позвол: позволю
рубл: рублей
занима: занимается занимаюсь занимаются занимаемся
свободн: свободно
зап: запись
следова: следовать
встрет: встретила встретить
разумеет: разумеется
уровен: уровень
нов: новые новая новой
умеет: умеет
ног: ногу
внешн: внешних
медийн: медийная
част: часть частые частого
устро: устроено
субъект: субъекта
журна: журнал
слов: словами слова слово
литератур: литературе
выжимк: выжимка
постоя: постоянно
системн: системно
сдела: сделать сделала сделал
сложн: сложных сложно сложный сложного
уточнен: уточнений
подчеркн: подчеркну
совет: советы советую советов
примен: применить
пут: пути
пример: пример
ноч: ночью
расчет: расчет
персонал: персоналом
систем: системы системе система системах
мечтател: мечтателей
выход: выходили
строительств: строительство строительстве
рефакторинг: рефакторинг
выдвига: выдвигали
идиот: идиот
частн: частное
обрабатыва: обрабатывать
ресурс: ресурсе ресурсов
метод: методом методов
процесс: процессов
вильховск: вильховский
групп: группы группами групп
коммуникативн: коммуникативные
сакральн: сакрального
свойств: свойствами свойств
требован: требований
хотел: хотелось хотел
подряд: подряд
бесплатн: бесплатная
помога: помогает
материа: материала
помощ: помощью
отсортирова: отсортировать
отвернул: отвернулся
гугл: гуглить
приложен: приложений
разработчик: разработчик
здоров: здорового
чувак: чувак
интерпретац: интерпретацией
вклад: вклад
промышлен: промышленном
уважен: уважение
текст: текст
показател: показателя показатель
универсальн: универсальные
желан: желание
стейкхолдер: стейкхолдеры
наоборот: наоборот
навык: навыки
интерес: интересующимся интересуется
сравнен: сравнению
программист: программист программистом программистов программистам
закон: закону
зарегистрирова: зарегистрировано
росс: россии
регистрац: регистрация
убед: убедить
имеет: имеете
гипотез: гипотеза
словосочетан: словосочетания
каза: казалось
счита: считался
причин: причинам причин причине
архитектурн: архитектурных
цел: целые
шедевр: шедевры
цен: цены ценой
интервьюирован: интервьюирования
кажд: каждого
руководител: руководителя руководитель руководителем
пройд: пройдемся
дзен: дзен
канал: канале
множеств: множество
директор: директор
создава: создаваемых
отличн: отлично
спор: споров
канба: канбан
пятер: пятеро
налич: наличие наличии наличия
стратег: стратегии стратегий
закономерн: закономерно закономерность
сюд: сюда
настоя: настоящих настоящие
петропавловск: петропавловске
глобус: глобус
список: список
знаком: знакомы
отполирова: отполированного
типов: типовые
дизайн: дизайн
бюджет: бюджета
концепц: концепции
виджет: виджете
клиент: клиентов клиентам
коротк: короткие
телеграмм: телеграмм
так: таких
общен: общении
поменя: поменять
техническ: технической технический технического техническая технических техническим
баз: баз база базе
фев: фев
разниц: разницу
посыла: посылать
собира: собираемся
обсуд: обсудим
предпочита: предпочитают
некотор: некоторые
застав: заставить
рассмотр: рассмотрим
потенциальн: потенциальные
введен: введение
количеств: количество количеством
соглашен: соглашений соглашение
твор: творят
логичн: логичностью
добав: добавить
просмотр: просмотров
специальн: специальных специальной
методик: методика
кредит: кредитом
анкетирован: анкетирования
объем: объеме
скаж: скажем скажу
друг: другом другими другим
закр: закрыть
семенюк: семенюк
зон: зону
приход: приходят
правильн: правильно
воображен: воображение
поня: понять
подчинен: подчиненных подчиненные
менеджер: менеджеров менеджерам менеджера менеджер менеджером
компан: компания компаниях компаний компании
рассказыва: рассказывал рассказывать
степен: степени степень
ограничен: ограниченных
программ: программы
вчер: вчера
получа: получаю получать
действ: действий действиями
главн: главная главный
венчурн: венчурных
митигирова: митигировать
вовлечен: вовлеченности
привет: привет
стратегическ: стратегическим
отдел: отдела
имеют: имеют
пиар: пиар
созда: создать
проявлен: проявление проявлением
спрогнозирова: спрогнозировать
ран: ранее
кейс: кейс
исход: исходя
гик: гиков
интернет: интернет интернете
сплочен: сплоченности сплоченность
радиоактивн: радиоактивные
тем: тема
самопиар: самопиаром
сбалансирова: сбалансированной
основател: основатель
применя: применяют
пришл: пришли
полн: полном
администрирован: администрирование
знан: знания знаний
превышен: превышением
комментар: комментарии комментариях
рамк: рамках
сотрудник: сотрудника сотрудники сотрудник сотруднику
проч: прочие
работа: работают работать работаем работал работаю
сильн: сильно
детал: деталях
песочниц: песочницы песочница
долг: долгом долг
долж: должен
вызва: вызвала
услуг: услуги
подписчик: подписчиков
кандидат: кандидату
проанализирова: проанализировал
натягива: натягивается
блог: блог
фреймворк: фреймворками
числ: числе
автоматизац: автоматизации
требуем: требуемый
сложност: сложности сложность
присво: присвоить
сотруднича: сотрудничать
исправля: исправляюсь
привед: приведу
автор: авторы авторов автором
выйт: выйти
очеред: очередь
чита: читать
отсвечива: отсвечивают
подход: подход подходит подходы подходом
положен: положения
тестирован: тестирования
быстр: быстро
совр: совру
бизнес: бизнесов бизнеса бизнесе бизнес
декомпозиц: декомпозиции
характеристик: характеристик
бумаг: бумагу
внедрен: внедрению
распространен: распространенной распространенная
реш: решил решили
лаборатор: лаборатория лаборатории
везен: везения
генеральн: генеральный генеральную
общ: общем
зада: задал
состо: состоит
недел: недель недели
набор: набор
расскажут: расскажут
профессиональн: профессионального
налаживан: налаживания
лайфхак: лайфхаки
может: можете
унификац: унификацию
мног: многим многие
зависим: зависимость зависимости зависимостей
люб: любить любой любят
директ: директ
непрофессионализм: непрофессионализма
язык: языка
обязательн: обязательных
транш: траншами
разн: разных
взял: взяли
образн: образно
год: годом
конкретн: конкретной
гравитац: гравитация
зачаст: зачастую
создан: создания
особ: особых
аудитор: аудиторией
фси: фси
самозанят: самозанятых
знает: знает
одн: одним одно
продаж: продажами
выстрел: выстрелят
мар: мар
широк: широкой
согласн: согласны
наблюден: наблюдения
реклам: реклама рекламы
знаеш: знаешь
разбер: разбер
грант: гранта гранту грант
корпоративн: корпоративный
функциона: функционал
свидетельств: свидетельствует
одинаков: одинаково
инструмент: инструменты инструмент инструментов инструмента
команд: команда команды команду команде командами команд
итак: итак
ознаком: ознакомиться
плюс: плюс
уникальн: уникальных
использован: использования
запрос: запроса запросы запрос
горазд: гораздо
войт: войти
фонд: фонды фонда фонд
конечн: конечного
аккаунт: аккаунт
сомнен: сомнения сомнениям
состав: составить
газпромбанк: газпромбанк
автоматизир: автоматизируется
бухгалтер: бухгалтерия
сраз: сразу
сколков: сколково
порядк: порядка
подробн: подробно
выража: выражаются
обанкрот: обанкротиться
яндекс: яндекс
новост: новостей новости
перв: первую первая
проведен: проведения
цифровиз: цифровизуется
приня: принять
прогнозирова: прогнозировать
достоинств: достоинства
камчатск: камчатском
написа: написать написано
гайд: гайд
поиск: поиска поиск
автоматизирова: автоматизировать
заказчик: заказчику заказчиками
неудобн: неудобной
равн: равной
короч: короче
голов: голове
образовательн: образовательные
как: какие
участник: участниками участники участников
голос: голосов
индикатор: индикатор
рассматрива: рассматривать
применим: применимо
прошл: прошлым прошлой
количествен: количественной количественно
реальн: реальном
кроет: кроется
рол: роли
точн: точнее
риск: риски
дешев: дешево
способ: способов
признан: признание
доказа: доказать
продукт: продуктом продукта
ретроспектив: ретроспектива
признак: признак
конференц: конференции
рекоменд: рекомендую
разговарива: разговаривать
заявк: заявку заявки
информацион: информационных
найм: найма
ввод: ввода
щекочет: щекочет
конц: конце
учет: учетом
предлага: предлагаю
обзор: обзор
успех: успеха
появ: появился появилась
случа: случае случается
трудозатрат: трудозатраты
домен: домене доменного доменных доменные доменным
мозг: мозгом
вернут: вернуться
планов: планового плановые
а: ай
вообщ: вообще
единствен: единственным
соискател: соискателям
о: ой
неприятн: неприятность
п: п
парсинг: парсингом парсинг
резидент: резидентом
дава: давайте
техподдержк: техподдержка
показа: показать показаться
поэт: поэтому
мин: мин
мир: мире
изолент: изоленты
писа: писал
повторяем: повторяемостью
исследован: исследование
скор: скорее скоро
феврал: феврале
классическ: классический
выраз: выразить
сообщен: сообщений
получ: получили получил получилось получить
подтвержда: подтверждают
публик: публикой
важн: важно
провел: провели
аргумент: аргументы
списк: списков
ищет: ищет
час: часов
чат: чате
столкнул: столкнулась
внутр: внутри
млн: млн
прям: прямая прямо
сдава: сдавать
индустр: индустрии
возражен: возражения
нарушен: нарушением
кстат: кстати
больш: большие большой
контекстн: контекстной
начин: начиная
счет: счет
токсичн: токсичность токсичные
карьер: карьера
офис: офисе
полезн: полезными полезна полезно полезны
эффективн: эффективного эффективный
мерф: мерфи
развернут: развернутую
ввид: ввиду
смогл: смогли
видел: видел
работодател: работодателя
методолог: методологии
эфир: эфира
пыта: пытался пытаюсь
мож: можем
бесполез: бесполезен
сотн: сотню
момент: момент
обсужден: обсуждение
отклик: откликов
пообща: пообщаться
основн: основные
неплох: неплохо
развернул: развернули
подготов: подготовил
решен: решений решения
скликиван: скликивания
самура: самурай
удив: удивить
консалтингов: консалтингового
комментирова: комментировать
средн: средний
личн: личных личным
нужн: нужных
поздн: поздно
вакуум: вакууме
аккуратн: аккуратные
секрет: секреты
далек: далекое
хаб: хабы
описан: описания
убира: убирать
послуша: послушать
выполня: выполняемой
результат: результат результаты результатом
опыт: опытом опыта
красив: красиво
трудоемк: трудоемкость
рынок: рынок
подразумева: подразумевает
бессердечн: бессердечной
ваканс: вакансию вакансия вакансии
настройк: настройка
дал: дали далее
контекст: контексте
пониман: понимании понимания
документ: документы
прочтен: прочтением прочтение
предложен: предложенные
сравнива: сравнивать
входя: входящие
мечта: мечтаем
ссылк: ссылка ссылку
фрейморк: фрейморка
подойдут: подойдут
дам: дам дамой
сходн: сходными
рафинирова: рафинированном рафинированным
дан: данных данил
дат: дать
имен: имени именах именам
изложен: изложенным
хват: хватить
перевед: переведена
детальн: детальным
ладн: ладно
модул: модуль
опрос: опросов
кон: коня
вредн: вредные вредных
митап: митап митапа
деньг: деньги
мся: мся
мук: мук
заран: заранее
тикет: тикетов
детализирова: детализированы
оцен: оценить
следован: следовании
глобальн: глобальный
непрофессиональн: непрофессиональный
вмест: вместе
тезис: тезисах
принтер: принтере
разбор: разбором
кред: кредит
жив: живое
обнов: обновить
объект: объекта
разработк: разработкой разработке разработку разработка разработки
закладк: закладки
уверен: уверенность
зажева: зажевало
программн: программного
заня: занялась заняли
руководств: руководство
почита: почитать
преимуществ: преимуществах
пост: посте
минут: минут
дел: деле
вопрос: вопроса вопросы вопрос вопросом вопросе вопросов
ближайш: ближайшего
рассказа: рассказали рассказать
априорн: априорное
стремительн: стремительно
пошагов: пошаговое
устройств: устройство
размер: размера размеров
ваш: ваших вашего
докладыва: докладываю
ответ: ответят ответить ответы
никт: никто
проектирован: проектировании проектирование
срок: сроки сроков срок
собствен: собственное собственного
размышля: размышляю
идеал: идеале
дьявол: дьявол
красот: красотой
держа: держать
август: августе
бизнесм: бизнесмен
расширен: расширения расширение
материал: материале
мегапроект: мегапроекты
хабр: хабр
смен: сменить
отношен: отношения
иска: искали
продолжительн: продолжительность
односложн: односложных
мысл: мысль
последн: последние
искрен: искренне
месяц: месяцев месяц
сам: самая самые
стартап: стартапам стартапа
бз: бз
туториа: туториал
оказыва: оказывается
посмотр: посмотрите
называ: называть называется
вероятн: вероятности
выполнен: выполненных выполнения
касперск: касперского
длин: длина
управлен: управление управлением
экстремальн: экстремальное
уважа: уважать
руковод: руководил руководят
руковож: руковожу
смысл: смыслах
начина: начинают начинал
внедр: внедрен
очередн: очередного очередной
вер: верю
западн: западные
вс: вс
популярн: популярные
дич: дичи
мужчин: мужчин
подошел: подошел
сво: своем своим свой
веб: веб
распределен: распределения
программирован: программирование
нача: начать началось
жалк: жалко
реша: решать
отобража: отображаемые
специалист: специалисты
порог: порог
станов: становятся
гк: гк
тест: тестов
истин: истины
явля: является являются
барроуз: барроуза
тимлид: тимлидов тимлида тимлидам
сайт: сайта сайтов
обеспечен: обеспечения
научпоп: научпоп
технолог: технология технологии
задач: задачу задачи задач задачей
выясн: выяснилось
задан: задание
техпис: техписов техписа
пар: парит пару
задумк: задумка
базов: базовые
треб: требуется требуют
задума: задумался
зовут: зовут
истор: историей истории
двум: двумя
пробл: проблем
ещ: ещ
факт: факты факт фактов
гибк: гибкой
сел: сели
сем: семи
легк: легко
вид: виде
сет: сети
конфиденциальн: конфиденциальность
умен: умение
защит: защитой
внов: вновь
спецовк: спецовках
договор: договориться
стрем: стремится
альтернат: альтернатив
хоч: хочу
рейтинг: рейтинг рейтинга
компетенц: компетенций
известн: известная
структурирова: структурированы
постав: поставить
поток: потоки
кратк: краткая
слегк: слегка
поддержк: поддержки поддержка
принцип: принципе принципу
стоимост: стоимости
хорош: хорошие
ид: идеи
им: имен
наш: нашей нашим нашу наших
недожда: недождавшись
ин: иные
сия: сияет
ит: ит
пользовател: пользователями пользователи
просьб: просьбой
стройк: стройка
успешн: успешным
авторск: авторская
над: надеюсь
большинств: большинство
умн: умной
сил: силу силами
син: синей
порядочн: порядочности
попроб: попробую
регулярн: регулярно
информац: информация
ключев: ключевых
анализ: анализом анализ
забра: забрать
умолч: умолчу
понят: понятий понятиях
берет: берет
ко: ко
поговор: поговорить
заточ: заточен
подготовк: подготовка
кордицепс: кордицепса
кастомн: кастомной
коллег: коллег коллега
запуск: запуск
нативн: нативные
обстоятельств: обстоятельств
польз: пользуйтесь польза
познаком: познакомиться
потрачен: потраченными
рассмотрен: рассмотрения
сервисдеск: сервисдеск
побед: победа
мо: мое
сист: систему систем
качеств: качестве качеством
выбор: выбора
лан: ланит
государств: государства
измерим: измеримого
проблем: проблемы
поближ: поближе
сов: сова
раздел: разделы
скажут: скажут
уборк: уборку
унифицирова: унифицированного
единообразн: единообразном
лучш: лучшая лучшие лучших
владимир: владимир
управля: управлять управляемым управляют
небольш: небольшой
дума: думать думаю думает
относ: относятся
крайн: крайне
возможн: возможности возможность возможно возможных
оп: опыт
интересн: интересно интересное интересные
артефакт: артефактов артефакты
кида: кидать
увелич: увеличилось
дает: дается
кульгин: кульгин
проактивн: проактивным
хочет: хочет
крупн: крупных
крут: крутые
неуспешн: неуспешным
меша: мешает
гриб: гриба
натолкнул: натолкнуло
растет: растет
прежд: прежде
архитектур: архитектуры
контент: контентом
откр: открыть
миллион: миллиона
наход: находится
баллад: баллада
никак: никаких никак
источник: источником
каков: какова
magic: magic
vladimir: vladimir
aimfirst: aimfirst
govern: governance
devop: devops
xmldatafe: xmldatafeed
hr: hr
microsoft: microsoft
lab: lab
clusterfuck: clusterfuck
evgeniir: evgeniir
enrico: enrico
elena: elena
bank: bank
twitter: twitter
dev: dev
gtd: gtd
faq: faq
axelu: axelus
block: blocks
smirnov: smirnov
credit: credit
cto: cto
group: group
toxic: toxic
ik: ik
roma: romas
adl: adl
manag: manager
makasin: makasin
cord: cord
otu: otus
servic: service
semenyuk: semenyuk
vk: vk
desk: desk
vilkhovskii: vilkhovskiy
scrum: scrum
architectur: architecture
habr: habr
descript: description
rfq: rfq
nmivan: nmivan
ru: ru
offlinecrm: offlinecrm
log: log
milfgard: milfgard
cio: cio
kasperski: kaspersky
kubernet: kubernetes
clickfraud: clickfraud
youtub: youtube
notion: notion
rss: rss
git: git
standish: standish
dmitriizolotov: dmitriizolotov
rko: rko
dimitriopolu: dimitriopolus
novikov: novikov
chatgpt: chatgpt
crm: crm
pastukhova: pastukhova
erp: erp
agil: agile
facebook: facebook
ntsaplin: ntsaplin
telegram: telegram
dbartolom: dbartolome
commerc: commerce
gitop: gitops
michael: michael
googl: google
pallazzo: pallazzo
seasadm: seasadm
spotifi: spotify
report: report
kredi: kredis
sashageo: sashageo
pmbok: pmbok
chao: chaos
