говор: говорят
обзавел: обзавелась
расскаж: расскажу
копирайт: копирайт
стат: стать статью статье статьи статья
леж: лежит
стар: старую стараясь старое старая старых
улож: уложились
рабоч: рабочий
стал: стала
памятник: памятников
перееха: переехать
ангел: ангела
мнен: мнение мнению
локац: локации
последств: последствия
повторя: повторять
работ: работе
центр: центре
показыва: показывать
дополнительн: дополнительные
север: севера
арт: арт
винтажн: винтажной
поигра: поиграть
пол: пол
сто: стоят
человек: человеком
менеджмент: менеджмент
лет: летом
мобильн: мобильных мобильного
морск: морского морской
знакомств: знакомство
публикац: публикации
скопирова: скопировать
карт: карте карту карт карты
человеческ: человеческого
благодар: благодаря
назван: название
котор: которую которым которое котором
денег: денег
уб: убили
видеокарт: видеокарты
кофеин: кофеином
прав: правами
реинкарнац: реинкарнацией
карман: карману
либ: либо
уч: учимся
проект: проекты проектов
профил: профиль
дела: делаются
подарок: подарок
подкаст: подкаст
верн: верного
засед: заседая
верс: версию версия
читальн: читальный
вывел: вывел
защ: защите
маркетинг: маркетинг
некогд: некогда
прост: простой
движк: движке
зал: зал
свободн: свободное
лиц: лица
встрет: встретить
ермейкин: ермейкин
пса: пса
уровен: уровень
нов: новые новых
умеет: умеете
медийн: медийная
монетизац: монетизация
част: часть
программатор: программатора
цифров: цифровыми
кана: канал
гейминг: гейминг
надоел: надоело
внимательн: внимательные
определен: определение
рожден: рождения рождению
сложн: сложный сложных
родител: родители
ориентац: ориентации
примен: применить
расшифрова: расшифровать
пример: примере
юрков: юрковым
ноч: ночь
засижива: засиживался
систем: системы
выход: выхода
узна: узнать узнаете узнала
невероятн: невероятной
государствен: государственных
летн: летний
прята: прятался
персональн: персональных
частн: частных
перебра: перебрались
труд: труды
подросток: подросток
нема: немало
лета: летать
бесед: беседы
сша: сша
ресурс: ресурсы
метод: методы методов
майнкрафт: майнкрафт
процесс: процесс
нарративщик: нарративщик
техник: техники
выпуска: выпускают
ненавидел: ненавидела
хотел: хотелось
культур: культура
актуальн: актуальную актуальной
киберспорт: киберспорт
продолжа: продолжали продолжаю
случайн: случайный
подряд: подряд
вечер: вечера вечер
продвижен: продвижение
нрав: нравилось
материа: материал
современ: современных
помощ: помощью
гнетущ: гнетущую
потерпел: потерпела
приложен: приложение приложения
разработчик: разработчиками разработчиков разработчиком разработчики разработчика
киберпанк: киберпанк
безупречн: безупречно
опасн: опасный
лор: лора
вклад: вклад
будущ: будущих будущем
заманчив: заманчива
шит: шитья
сын: сына
томм: томми
нул: нуля
хостов: хостовую
делюксов: делюксовая
придумыва: придумываем придумывать придумывал
рост: рост
мисс: миссию
негодя: негодяи
слил: слил
задумыва: задумывались
регистрац: регистрация
несанкционирова: несанкционированное
тестирова: тестировали
допуст: допустить
заглядыва: заглядывайте
убед: убедиться
найден: найденной
счита: считать
линкор: линкора
отлича: отличаются
сэр: сэра
кажд: каждой каждого
руководител: руководителя
опечатк: опечатки
головоломк: головоломки
оков: оковами
настро: настроить
российск: российским российскими
дзен: дзен
палуб: палубы
множеств: множество
нервишек: нервишек
создава: создавать
коммерческ: коммерческих
директор: директора
искусствен: искусственного искусственному искусственный
кэнегем: кэнегема
веден: ведения
поездк: поездка
сегмент: сегмента
рассека: рассекать
серьезн: серьезным
прекрасн: прекрасная
графическ: графическое
желез: железом железо
отечествен: отечественными
сюд: сюда
професс: профессия профессию профессиям
настоя: настоящее
коммент: комментов
список: список
след: следующим
нашел: нашел
дизайн: дизайн дизайне
вымышлен: вымышленной
так: таких
геймер: геймером
пыл: пылилось
нашумевш: нашумевшая
техническ: техническая
фев: фев
заметн: заметно
вылавлива: вылавливали
лабиринт: лабиринт
привлекательн: привлекательной
звуков: звуковое
некотор: некоторые
монитор: монитором
рассмотр: рассмотрим
подума: подумал
пират: пиратов пиратам
зно: зной
количеств: количество количестве
служб: службы
соглашен: соглашение
увлека: увлекаюсь
оформлен: оформлением
гер: герой
добав: добавить
просмотр: просмотров
друз: друзей
футуризм: футуризме
интеллект: интеллекта интеллект интеллекту
анатом: анатомия
зон: зонам
дракон: драконов дракона
тайл: тайлов
кластер: кластере
компан: компаний компании компания
ограничен: ограничений
программ: программ программы
ежедневн: ежедневным
разбира: разбираем
действ: действия действующий
велик: великого
вовлечен: вовлеченным
привет: привет
игрок: игроков игрока игроки игроку
дайджест: дайджест
имеют: имеют
использ: использует
магазин: магазин
созда: создала создают
композитор: композитор
имеющ: имеющая
лампов: ламповый
помн: помните
кейс: кейс
отдельн: отдельную отдельным
стол: столь
влюблен: влюбленных
агитир: агитирующих
выполн: выполнено
интернет: интернета
игров: игровой игрового игровые игровых
тел: тела
тем: тема
вячеслав: вячеслава
полн: полная полное
администрирован: администрирование
дважд: дважды
зрител: зрителя
знан: знания
рассудок: рассудок
знал: знали
комментар: комментарии
проч: прочее
компьютер: компьютеров
работа: работают
песочниц: песочницы песочница
услуг: услуги
подтолкнул: подтолкнуло
блог: блога блог
бессмыслен: бессмысленно
версетт: версетти
чист: чистое чисто
исследова: исследовать
франшиз: франшиз
сложност: сложности
девайс: девайс девайса
автор: авторы авторов автором
ролев: ролевую
очеред: очереди
чита: читать
новинк: новинки
превраща: превращаются
тестирован: тестирование
нынешн: нынешнего
оста: остались
быстр: быстро
вконтакт: вконтакте
перевал: перевалом
принима: принимать
предмет: предмета
бумаг: бумага
распространен: распространение
портативн: портативное портативный портативную портативной портативным
реш: решил решили
генеральн: генеральным
общ: общей
геймд: геймдев
бит: бита
защища: защищают
вдохновля: вдохновлялись
зада: задался
набор: набор
армянск: армянской
реж: режим
включ: включая
серг: сергей
свидан: свиданий свидание
сред: среду среди
социальн: социальной
вдохновл: вдохновлена
редактор: редакторы редактором
чувств: чувство
мног: многим
посвящен: посвященный
люб: любите любит любят
язык: языка
фэнтез: фэнтези
останов: остановите остановились
наблюд: наблюдая
коллектив: коллектива
фактор: фактором
захватыва: захватывающий
демидов: демидовым
взят: взять
реверс: реверс
гот: готов
разн: разных разным разному
маг: магии
люд: людям людей
отвеча: отвечаю
год: годах
конкретн: конкретно
открыва: открываете
ожидан: ожидание
интерв: интервью
ревиз: ревизий
парол: паролем
законодательств: законодательство
создан: создания создании
демоверс: демоверсией демоверсию
потеря: потерять
вывод: выводу
прич: прич
приш: приш
ближ: ближе
привод: приводило
знает: знаете
постара: постараюсь
одн: одним одно
кройк: кройки
выстрел: выстрела
мар: мар
реклам: реклама
разбер: разберем
подб: подбит подбил
корпоративн: корпоративный
прив: прив
расширя: расширяющей
подборк: подборкой
команд: команда
издател: издателей
корабл: кораблей корабля корабли корабль
обсчитыва: обсчитывали
микроконтроллер: микроконтроллеров
платформ: платформ платформы
потрат: потратил потратили
войн: войны
щекотан: щекотанием
войт: войти
аккаунт: аккаунт
топ: топи топить
глаз: глазами
прохожден: прохождения прохождениями прохождении
сраз: сразу
смартфон: смартфоны смартфон
убийств: убийства
похож: похожа
яндекс: яндекс
новост: новости
существ: существует
перв: первого первой
хадкорн: хадкорных
пиратств: пиратство пиратства
написа: написать написали
добр: добро
поиск: поиска поиск
изменен: изменениям
автоматизирова: автоматизировать
образовательн: образовательных образовательные
как: какую какие
детств: детстве
голос: голосов
тся: тся
атмосфер: атмосферу
прошл: прошлого прошлым прошлый
оппонент: оппоненту
обход: обхода
гаджет: гаджеты
втор: вторая
точн: точно
сбав: сбавил
рол: роли рол
точк: точки
напрасн: напрасны
сфер: сфере
способ: способы
форм: форм
мер: меры
ретроспектив: ретроспектива
компьютерн: компьютерные компьютерных компьютерная компьютерный компьютерной
продукт: продуктами
доказа: доказать
меч: меча
рекоменд: рекомендуют
быва: бывают
найт: найти
информацион: информационной
успел: успел
образ: образов
конц: конца
найд: найден найдены
сюжетн: сюжетной
геро: героев герои героях
маленьк: маленького
обзор: обзор
электроник: электроника электроники
случа: случай
появ: появилась
запуска: запускаем
доступ: доступ
вернут: вернуться
сетев: сетевые
принос: приносит
наскуч: наскучила
александр: александр александром
джон: джона
и: ии
й: й
л: л
галочк: галочки
вселен: вселенной
личност: личностям
ожида: ожидают
ошибок: ошибок
редкост: редкость
х: х
клонирова: клонировал
логическ: логические
одиночк: одиночке
сезон: сезон
поэт: поэтому
мин: мин
убийц: убийцы
мир: мире мир
писа: писать
исследован: исследование исследования
совершен: совершенно
идеальн: идеальное
диск: диск
феврал: февраля феврале
удаст: удастся
фокусирова: фокусировалась
получ: получить
происхожден: происхождению
тактик: тактика тактике
перевод: перевод
важн: важную
кров: крови
рук: рукой
час: часов
метр: метро
индустр: индустрии
мюллих: мюллиха
руб: рубились
больш: большую большой большое большая
китайск: китайских
иде: идея
шифрова: шифровать
длительн: длительная
офис: офисе
шифрован: шифрования
направлен: направлениях
игр: игра игр игру играх играми игре игры
полезн: полезного
инжиниринг: инжиниринг
миниатюрн: миниатюрные
заядл: заядлым
художник: художников
смогл: смогли
редк: редкого
ост: оста
мог: могу
полноцен: полноценные
злобн: злобного
момент: момент момента
заседан: заседание
пообща: пообщаться
основн: основном
артдиректор: артдиректор
поведа: поведать
основа: основавшего
бонус: бонусы бонусов бонусами
сознан: сознания
обзавест: обзавестись
рыцар: рыцарям
решен: решения
биограф: биографии
создател: создателя
средн: средний среднего
советск: советская советскую
секрет: секретов секреты
дольш: дольше
хаб: хабы
выбира: выбираем
хак: хак
разогрет: разогреть
рынок: рынок
чрезмерн: чрезмерном
настройк: настройка
дал: далее дал
документ: документы
прочтен: прочтение
ссылк: ссылку
оправдыва: оправдываются
зата: затаившихся
реал: реалиях
загадочн: загадочного
расследован: расследования
жен: жены
дан: данный данной данного
дат: дать
установ: установил
имен: имени
дизайнер: дизайнеры
квест: квест
вертолетик: вертолетиком
детальн: детальной
камен: камень
вывезл: вывезли
пожалова: пожаловать
соединен: соединения
функц: функцию
половинк: половинка половинкой
продюсер: продюсером продюсера
понадоб: понадобится
вирус: вирус вируса
изоляц: изоляции
диван: диване
дво: двоих
незакон: незаконное
вмест: вместо
разбор: разбор
зарабатыва: зарабатывает
боярск: боярского
чин: чинить
переработок: переработок
обнов: обновить
разработк: разработкой разработку разработка разработки
закладк: закладки
разработа: разработанная
уточкин: уточкина
неразведа: неразведанным
ван: ван
программн: программное
метрик: метриками
белоснежн: белоснежные
пост: поста
дел: деле делюсь
вопрос: вопросом
студ: студия студию студии
поощря: поощрять
игра: играл играть
устройств: устройство
заверш: завершена
размер: размера
переход: переходить
текстов: текстовую
ваш: вашего
детект: детектив
ответ: ответ
инд: инди
усил: усилия
пространств: пространства
полност: полностью
несмотр: несмотря
покупк: покупке
антипиратск: антипиратское
копирован: копирование
понрав: понравится
замк: замка
разнообраз: разнообразить разнообразия
людьм: людьми
материал: материалами
поднима: поднимается
мегапроект: мегапроекты
хабр: хабре хабр хабра
аа: ааа
обучен: обучения
подбит: подбитые
иска: искал искать
обща: общался
ножниц: ножницы
коробок: коробок
наста: настала
услыша: услышать
последн: последние
клеток: клеток
месяц: месяца месяц месяцев
портативок: портативок
поднадоевш: поднадоевшее
сам: самая самые самым
альянс: альянсе альянсом
родств: родства
бе: бей
стартап: стартапам
крафт: крафта
жанр: жанре жанр
переда: переданную переданы
школьн: школьных
тотальн: тотальных
бо: бой боя боев
подобн: подобного
абсолютн: абсолютно
бу: бу
выполнен: выполнения
гост: гости
управлен: управления
билд: билд
неожида: неожиданно
нашл: нашлась
беспощадн: беспощадно
антагонист: антагонист
вед: вед веду
начина: начинающих
очередн: очередной
популярн: популярнее популярное
вс: вс
сопровожден: сопровождение
горн: горным
покаж: покажу
развод: разводиться
простор: просторы
научн: научно
цвет: цвет
окажет: окажетесь
сво: свой
скоростн: скоростными
программирован: программирование программированием
нача: начали
однопалубн: однопалубных однопалубные
порог: порог
станов: становилось
прода: продали
возникл: возникло возникла
появлен: появлением появлению
вещ: вещи
зарожден: зарождения
законч: закончил
развит: развитие
представ: представим
кубик: кубики
сайт: сайта
дн: дн
обеспечен: обеспечение
научпоп: научпоп
технолог: технологий технологию технологии
предсто: предстоит
происход: происходят
задач: задачи
различн: различными
неочевидн: неочевидные
трет: третью
сомнительн: сомнительно
смогут: смогут
пар: пару
искусств: искусство
треб: требуют
ел: ели
истор: историю истории история
зовут: зовут
зрен: зрения
напиш: напишу
цифр: цифрами
крэг: крэг
пробл: проблем
ещ: ещ
сер: серии серию серь серия
лонгрид: лонгрид
вид: вида
сет: сеть сети
конфиденциальн: конфиденциальность
злых: злых
защит: защиты защитить
мастер: мастер
внов: вновь
доход: доходов
ромер: ромеро
красн: красными
хот: хотят
автосгенерирова: автосгенерированных
дне: дней
эпох: эпоха
хоч: хочу
рейтинг: рейтинг рейтинга
дом: дом
известн: известной
эстетик: эстетика
крыл: крылья
поток: потоки
сид: сидя
поддержк: поддержка
угодн: угодно
игростр: игрострой
пройдет: пройдете
дню: дню
дня: дня
доб: добилась
принцип: принцип
хорош: хорошую
плакат: плакатов
любим: любимая любимыми
оборот: обороты
им: имена
ютуб: ютуб
ит: ит
полюб: полюбил
просьб: просьбам
ретр: ретро
школьник: школьников
большинств: большинству
геймдизайн: геймдизайн
разрабатыва: разрабатывалась
план: план
товарищ: товарищи
информац: информацию информация информацией
схож: схожую
барахл: барахла
безум: безумия безумие
замеч: замечено
трат: тратить
ровн: ровно
замен: заменить заменив
интуиц: интуиции
требова: требовало
объедин: объединились
сборк: сборку
ко: ко
поговор: поговорим
например: например
подготовл: подготовлю
артем: артемом
запуст: запустить
рекомендац: рекомендации рекомендациям
извращен: извращение
нативн: нативные
шифр: шифрует
музык: музыкой музыка музыки
прокачк: прокачка
вок: вок
уровн: уровнях уровней
мо: моего моей
громк: громкие
портрет: портрет
консол: консолей консоль консолями консолях консоли
сидет: сидеть
душ: душ
отобра: отобрала
сидел: сидели
постиг: постиг
выбор: выбор
онлайн: онлайн
проблем: проблемой проблема
обнаружен: обнаружения
сервер: сервером
баланс: баланс
раздел: разделы
пицц: пиццу
настолк: настолку
лучш: лучшие лучших лучшего
небольш: небольшой
облегч: облегчили
возможн: возможность возможности возможно
интересн: интересно интересное интересным
коробк: коробках
выбра: выбрали выбрать
направ: направить
утр: утро утра
хочет: хочет хочется
все: всей
крут: крутым круто
пк: пк
сюжет: сюжет
потряса: потрясающее
оранжев: оранжевый
изначальн: изначальный изначально
архитектур: архитектуру архитектуры
гараж: гараже
выступа: выступаю
амальгам: амальгаме
откр: открыт открыть
наход: находимся находится
потер: потере
ро: роемся
ленин: ленину
big: big
ps: ps
devop: devops
papabubadiop: papabubadiop
dragon: dragons
skyrim: skyrim
katyabelkina: katyabelkina
plai: play
robot: robotization
twitter: twitter
gta: gta
ragequit: ragequit
electron: electronics
app: app
kumykov: kumykov
ivansychev: ivansychev
pvp: pvp
thelea: thelea
junior: junior
surviv: survival
mattel: mattel
habr: habr
firstvd: firstvds
gui: gui
greenolor: greenolor
brother: brothers
engin: engine engineer engineering
panzer: panzer
iii: iii
youtub: youtube
rampart: rampart
rss: rss
bodyawm: bodyawm
mistikan: mistikan
arduino: arduino
wumpu: wumpus
vita: vita
civil: civilization
lozga: lozga
unreal: unreal
creation: creation
art: art
horror: horror
alizar: alizar
facebook: facebook
black: black
klimenski: klimensky
store: store
substack: substack
dungeon: dungeons
excel: excel
googl: google
nurk: nurked
atom: atomic
datascientist: datascientist
magic: magic
dyu: dyu
data: data
ryuzotakayami: ryuzotakayami
lic: lic
deck: deck
lad: lad
baba: baba
cloud: cloud
school: school
asya: asya
gpd: gpd
seeklai: seeklay
pix: pix
drm: drm
hunt: hunt
hsbi: hsbi
evid: evidence
gamedevil: gamedevils
gpu: gpu
vc: vc
heart: heart
promolif: promolife
vk: vk
intellivis: intellivision
minecraft: minecraft
game: games
skillfactori: skillfactory
scientist: scientist
timeweb: timeweb
hero: heroes
eduard: eduard
psp: psp
kubernet: kubernetes
tylerskald: tylerskald
switch: switch
factorio: factorio
alikberov: alikberov
ignatchuk: ignatchuker
pcj: pcj
homm: homm
kit: kit
tandyvis: tandyvision
steam: steam
yaga: yaga
human: human
phanerostroi: phanerostroi
ttd: ttd
pixon: pixonic
telegram: telegram
creepi: creepy
friction: frictional
multiplay: multiplayer
window: windows
singleplay: singleplayer
mark: marks
caviar: caviar
