визитн: визитная
встал: встали
случ: свой
говор: говорится говорят
гнат: отнимет
понима: понимаю
консольн: консольным
оттуд: оттуда
расскаж: статье
стат: стать статьи прочитано вулкана серверах
оказа: оказаться
стар: вернуться старое
обычн: мышей
вводн: вводные
рабоч: превратить решаться
составлен: составлением составления
мнен: мнении мнение
приверженц: противостояние
указан: указания
разлож: разложил
категорическ: категорически
повторя: повторять повторяющихся
завис: зависит зависят
работ: работа работы работе
показыва: показывать
проблематик: проблематики проблематику
дополнительн: дополнительные
сценар: сценарии сценарий
терминал: терминале
хаут: хауту
пол: пол поле
инфраструктур: инфраструктуру
человек: человека
слома: сломать
менеджмент: менеджмент
поступ: поступил
лет: лету
интеграц: интеграцию
каса: касается
разговор: разговор
то: той
знакомств: процессе
структур: структуру
суд: судя
публикац: разделы
скопирова: скопировать
попрост: попросту
разбива: разбивают
подел: поделив
человеческ: человеческими
котор: котором которым
скучн: конфиги
осозна: осознаю осознанно
пор: наворотами
вертика: вертикали
эксперимент: эксперименты экспериментами
связа: связано связанные связанное
прав: правило
числов: числовой
вовс: вовсе
либ: либо
уч: учиться
двига: аналоговое
проект: проекты проект
высыпа: высыпаться
относительн: относительно
профил: профиль
дела: делает
упомн: упомню
документац: документацию
режим: режима режимы режиме
джентльменск: джентльменских
верс: версии старую
маркетинг: маркетинг
просветлен: просветленный
прост: простой простого
прием: устареванию приемы
голлум: ношусь
рубл: рублем
свободн: свободный
занима: занимается
постро: попробую
следова: следовать
зат: затею
лиц: лица
карточк: карточка
уровен: уровень
очевидн: очевидной очевидно
нов: новые
придума: придумать
внешн: внешнюю
клавиш: клавиши клавишей
медийн: блог
част: часть частый
слож: сложилось
традицион: традиционных
слов: слов словам словами чистом
осво: освоить якобы
наворот: современный
якоб: адепты
сдела: сделать сделан
определен: определенной определенные
кольц: голлум
особен: особенностями особенностях
сложн: сложный сложных сложно
беспрекословн: беспрекословно
совет: советуют
примен: применить
активн: активно
русск: русском русского
штук: штука
вперед: вперед
пример: примеров
нош: конфигом
динамичн: динамично
процедур: процедур
класс: класса
завоева: расскажу
переписыва: конечного
мнемоническ: мнемонически
разбиен: разбиение
текущ: текущей
нивелирова: нивелировать
читател: читателя
лидер: лидерами лидером
машин: находящиеся
процесс: конфигурация процесс
класт: класть
недешев: недешево
дружк: дружки
достойн: достойным
дружн: дружно
актуальн: актуальным
комфортн: конфигурационный результате
расстановк: расстановка расстановке
неужел: неужели
подряд: подряд
бесплатн: бесплатными
материа: построить
современ: современные супер современное
помощ: помощи способы
неко: некоем
приложен: приложением приложений приложение
вагон: вагон
разработчик: разработчик разработчики разработчика
здоров: здорово
тонк: тонкие
попытк: попытка
вклад: сюда
промышлен: промышленных
отступ: отступов
текст: тексту текст текста
универсальн: универсальности
наоборот: наоборот
мышк: двигаем
единожд: единожды
нуж: нужен
неподготовлен: неподготовленным
грамотн: грамотные
прочита: прочитаете знакомства
нул: нуля
интерес: интересующий
средств: средства
роков: гнаться
программист: программист программисту
отключ: отключить отключите
минимальн: минимальные
плох: плохого
обширн: обширная
регистрац: войти
толк: толком
универсал: универсален
наяв: наяву
цикл: циклу
счита: считаю считает считают считаются
отладк: отладки
заморачива: макросы
противоположн: противоположных
цел: цель
настро: освоив статья донастраивать
дзен: яндекс дзене
взаимодейств: взаимодействие взаимодействуют
коммерческ: коммерческие
директор: директории
отличн: отличными
прыгн: горы
затронут: затронуть
серьезн: серьезным
частност: частности
графическ: графического графический графических графические
использова: использовать
уточня: уточняющие
установл: компьютере
достаточн: достаточно
подсветк: подсветки
примерн: примерно
форматирован: форматирование форматирования форматировании
плюшк: причесанный
сюд: варианте
коробочн: установлен
список: список
наглядн: контексте
замечательн: замечательные
след: следует
строк: строки
дизайн: дизайн
помим: помимо
попыта: попытался
клиент: клиента клиент клиентов
так: такую таки такого таких материал
вулка: жерло
нормальн: нормальный
картин: картину
баз: инструмент базами
техническ: дзен
фев: фев
заметк: заметка
причеса: настроенный
привыкнут: привыкнуть
собира: разработки
описыва: описываемое
некотор: пойд
противостоян: очередное
рассмотр: наглядности
обуча: обучающих
конфиг: вторая любит своим
удивительн: удивительно
количеств: количество
введен: введением
сложносочинен: сложносочиненных
соглашен: документы
попа: дней
встро: встроены
добав: добавить
просмотр: просмотров статей
оставл: оставляя
обкатк: проходили
конфигурац: конфигурацию конфигурации июл конфигураций
скаж: скажем
представля: представляется
рандомн: рандомно
виртуальн: виртуальных
нынч: нынче
друг: другом другими друг
приход: случаев
правильн: правильно
компан: компании сайта
степен: степени степенью
рассказыва: переписывал
программ: обычный программы
ограничен: ограниченные ограниченный
получа: получается
разбира: разбирается
пят: пятая
велик: велик
перечен: перечень
привет: пишем
интерактивн: интерактивные
состоян: берем
топоним: топонимов
использ: использующие иначе использует используют
визуальн: визуальное
вручн: вручную
префикс: префикс
созда: создать
колдовск: колдовской фишкой колдовском
объемн: объемного
помн: помнит
ролик: ролики огромное
нын: ныне
отдельн: отдельными отдельный отдельно отдельные
занов: заново
хвалебн: хвалебных
пятиминутн: пятиминутных
тем: тема роликов теме
полн: полные
администрирован: администрирование
пользовательск: пользовательские
десят: десятого
параграф: параграфам
подгружа: подгружает подгружать подгружаются
бер: рабочие
комментар: комментарии хорош комментариями
клиентск: клиентским
двоеточ: двоеточий
проч: прочего
автодополнен: автодополнение
сочетан: сочетания
компьютер: предполагаем компьютер
работа: работают работать работающих работает
сильн: сильно
аналогов: общаетесь
песочниц: хабы песочницы
бег: полезные
услуг: услугам конфиденциальность
необходим: необходимость необходимо
блог: корпоративный
несвязн: несвязным
интерфейс: интерфейс
скрипт: скриптов скриптами скрипты
адепт: виде
чист: терминального
сложност: сложности
параметр: параметров
вниман: вашему
автор: авторы вклад автором
выйт: выйти
очеред: очередь
чита: читать
локальн: локальный находятся
положен: положения
подход: подхода
чароде: чародеям
пойд: модульность
попада: попадают
придет: придется
явн: явные
подгруз: подгрузил
расписа: расписать
оста: остается
быстр: комфортно быстро
разбив: разбивая
сложноват: сложновато
тип: типа типы типов
внедрен: внедрением
набра: набрали
распространен: распространенный
статическ: статическую
реч: речь
реш: решил решено
общ: общем общее демонстрацией
остав: оставить
специфическ: специфических
состо: состоит
реж: режим
поддержива: поддерживают поддерживать
включ: включено включен
устарева: возможность
конфигурацион: конфигурационных вниманию
кусочек: кусочек
удобн: удобно удобный
бенефициар: бенефициаром
жерл: прыгну
сред: средах
редактор: редактор колдовского текстовым редакторов редакторе
прикоснут: прикоснуться
мног: многие многих
люб: любом любой никто
зависим: зависимости
язык: языке языков языка
стил: стиля
целесообразн: целесообразным
правд: правда
гор: роковой
разн: разные разный разному
завтр: завтра
подвержен: общим
прелесссст: забрать
графома: графомана
производител: производителя
год: годам
использу: используя
целев: целевом
нюанс: нюансами
конкретн: конкретно конкретные
применен: применения
встроен: встроенное встроенный встроенными
создан: плюсы
потеря: боюсь
вывод: вывода вывод
прич: причем
конвейер: конвейеров
фолд: фолды фолдами
производств: производстве
знает: знаете
постара: постараюсь
одн: одни одном попалась
реклам: медийная
попадет: попадете
настольк: настолько
корпоративн: услуги
инструмент: инструментами рассматривать инструментов плюшками
команд: команды командой
достоверн: достоверно
плюс: слова
огранич: ограничено ограничен
находя: редактировать
врод: вроде
разбег: разбегу
соблюда: создания
десятк: десятков
использован: использование использованию
запрос: запросы запросов
передвига: передвигаться
войт: аккаунт
конечн: важны
аккаунт: авторов
лингвистическ: лингвистическим
глаз: глаза
сраз: сразу
секц: секции
упомина: упоминать
вполн: вполне
жела: желаемой
яндекс: мегапроекты
новост: новости
существ: существует
бог: богов
перв: первую первым гондор первого
достижен: достижением
бок: бок
гайд: гайдов
поиск: поиск
автоматизирова: автоматизированных
равн: равно
донастраива: приходилось
исполнен: исполнения
образовательн: нативные
как: каком каких какие какую какими каким какого
эдак: эдакие эдаким
голос: голосов
кат: бегом
нединамичн: скучные
рассматрива: оговоримся
применим: применимости применимого
высок: высокой
реальн: реальной
втор: понятиям
точн: точно
риск: риск
точк: точки
однозначн: однозначно
способ: способа кое способу способе способ способом
бесчислен: бесчисленных
напрям: напрямую
продукт: продукта
доказа: доказали
выспа: выспаться
грамматическ: грамматическим
нейрон: нейронным
максимальн: максимально
найт: найти
компромисс: компромисс
провер: проверяя
образ: образом
ввод: мышкой
вызов: вызовы
окн: окнами окно
конц: конце
предлага: предлагаю
соглас: согласен
маленьк: маленькая
случа: случае большинстве
запуска: запускался
практическ: практически
вернут: поддержка
вернул: вернулись
бесконечн: бесконечная
четверт: четвертая
омн: омни
обновлен: обновления
утвержда: утверждать
янв: янв
схем: схема
вообщ: вообще
макрос: вводим
субд: субд
преврат: позволяет
дава: давайте
одиночн: одиночной
логическ: логические
поэт: поэтому
модификатор: модификатором
напиха: напихать
мин: мин
вариант: вариантов вариант коробочном
редактирова: помощью
предприят: предприятием
писа: привет
безопасн: безопасно
скор: скорее
линтер: линтеры
терминальн: писать
нажа: нажали
оправда: оправдан
получ: настроив
морфологическ: морфологическим
хост: нном
дистрибутив: дистрибутиве
важн: преимущества
провел: провел
город: городить
списк: списков
рук: руку
час: часов
внутр: внутри
прям: прямо
тридцат: тридцати
перемеща: перемещается перемещаться
движен: движений движением движения
кстат: кстати
латиниц: латиницы
больш: большой большому
заморож: заморожены
мест: место места местами месте
иде: идея
счет: счет счету
предполож: предположить
вход: входа
полезн: дополняя
накоп: вопросу
устанавлива: удалялись устанавливаться
вспомн: вспомнить
набива: набивать
сформулирова: разумным
окружен: окружении
жизн: жизни
раскладк: раскладками
фортепиа: танец
мог: могу
сокращен: сокращения
лиценз: лицензий
пыта: пытаются
мож: можем
момент: момент
смож: сможем
развива: развиваются
дополн: соблюдать
основн: основных основном основной
популяр: популярен
сможет: сможете
решен: решений
загугл: загуглить
средн: средний средней среднего
личн: лично
нужн: нужный нужное нужны
устаревш: устаревшей
аккуратн: аккуратно
хаб: публикации
результат: обкатку
даб: дабы
вызыва: вызывать
продвинут: продвинутыми продвинутого
прелессссст: кольцом
полож: положа положил
настройк: настройки базе
дал: далее
контекст: инструменты
последовательн: последовательно
танец: изящный
документ: компаний
прочтен: прочтение
предложен: предложениям предложений
сравнива: использую
ссылк: ссылку
дан: данных данному данный данном данная
имел: имел
дат: дать
указа: указанного указать
хват: хватило
код: кодами кодом редактором кода коду
модул: модулям
использует: используете
вряд: вряд
рубрик: рубрику рубрике
обновля: обновляться
функц: функциями функций
используем: используемые
запят: запятые запятых
доступн: доступны
возника: возникает
оцен: оценить
перегружен: перегруженного
следован: следование
минимум: минимумах
уход: уходить
обознач: обозначить
разбор: разбором
всевласт: конфиг
ошибк: ошибки
достич: достичь
синтаксис: синтаксиса
обнов: обновить
объект: объектов
настроен: машинах
разработк: комфортной разработка
закладк: закладки
руководств: руководства
заблужден: заблуждение
растолстет: растолстеть
молниеносн: молниеносно
преимуществ: некоторые
подцеп: подцепиться
пост: посте
корпус: корпусам
итог: итоге
реляцион: реляционных
минут: минут
дек: дек
дел: дело
разгорел: комментариях
вопрос: мыслей
полета: полетаем
конвенц: конвенциям
устройств: устройстве информация
текстов: пользоваться текстовые текстовый текстовом
переход: переходов
ваш: вашим настройка
мемуар: мемуаров
преслед: преследую
проход: устанавливались
попрактикова: попрактиковаться
никт: всевластья
полност: полностью
покупк: покупкой
нажат: нажатым
сталкива: сталкивается
собствен: собственную
модальн: модального
драйвер: драйвер
уда: заменить
оговор: сравнивать оговориться
расширен: расширения расширений
материал: материалах материалу
рефлекс: рефлексов
мегапроект: стартапам
целостн: целостность
хабр: хабре хабр
передов: передового
пишут: пишут
обща: редактора
прибавк: ощутимую
саш: прелессссть
куч: кучу
эпизодическ: эпизодической
мысл: остального
последн: последней последнее
манер: манер
сам: самых самый самым
набира: набирают
бд: бд
цветов: цветовая
стартап: стартапа образовательные
туториа: туториал
возвраща: возвращаться
инач: скорости
организова: организовать
переда: переданы
школ: школы
бо: прелесссссть
вероятн: вероятностью
развертыван: развертывания
точност: точности
управлен: управление
супер: устаревает
жутк: жутко
ненормальн: ненормальными
космос: космосе
смысл: смысла
заключа: заключается
древнеегипетск: древнеегипетских
предполага: коробки
начина: начинающего
отдаст: саша
очередн: очередную разгорелось
тонкост: тонкости
постел: постели
вс: вс
начн: начнем
цвет: цвета
плагин: плагин плагинам плагинов плагины плагинами
сво: нединамичные потерять
веб: веб
программирован: программирование
нача: начать
авг: быстром
реша: задачи
порог: порог
реализ: реализуется
забыва: забывает
фишк: партию
станов: становится
замеча: замечать
значительн: значительно
парт: фортепианную
явля: является являются таким
огород: огород
редактирован: ноя редактирования
нужда: нуждаются
вещ: вещей вещи вещах
помес: помеси
законч: закончились
ощутим: получить
легас: легаси
сайт: устройство
мыш: долой мыши
научпоп: научпоп
задач: рассмотрим задач
файл: файлов файла файлами файле файлы файл
проникнут: проникнуться
пользова: заморачиваться
трех: трех
различн: различные
хвата: хватает
трет: третья
воплот: воплотить
пар: пары пара
перейт: перейти
нном: удал
базов: базовые
инструментар: инструментарий
истор: истории
гондор: завоевать
зрен: зрения
ход: ходить ходу
пробл: проблем
сет: сетям
вид: сформулировать
конфиденциальн: соглашение
навсегд: навсегда
науч: научимся
разумн: накопилось
естествен: естественным
контролирова: контролировать
хот: случится
памя: память
позволя: программа
избыточн: избыточный
дне: поддержкой
платн: платный платную
рейтинг: рейтинг рейтинга рейтингов
скорост: скоростью прибавку
дол: первая
способн: способно
горяч: горячие
сторон: стороны
постав: локально
поток: потоки
поддержк: рассказывает техническая поддержки
остальн: приверженцев
угодн: угодно
модульн: настроил
родн: родные родной
предназнач: предназначены
хорош: одна
библиотек: библиотеку библиотеки
пуст: пусть
комплексн: комплексной
им: имен
оборот: оборотов
предыдущ: предыдущем
наш: нашего
ютуб: ютубе
пользовател: пользователя пользователей
придаст: придаст
над: надеюсь
большинств: большинства тему большинство
тележк: тележка
разрабатыва: разрабатывает
план: планы плана
попроб: ним
сервис: сервисом
оперативн: оперативном
составля: составляют
информац: информацией информации песочница
выгодн: выгодно
сход: сходятся
ключев: ключевых
изящн: рабочий
видим: видимо
удален: редактирование удаленном поставить
хозяйств: хозяйство
философ: философии
забра: хотят
замен: порой
жадн: жадные
дополнен: дополнения
предварительн: предварительного
плюшек: плюшек
пересказ: пересказами
расставля: расставляла
переста: перестают
понят: приемам
ко: коих собрал
поговор: поговорить
размещен: размещения
чертовск: код
собра: хосте
отнимет: отдаст
заточ: заточены
запута: запутать запутано
например: например
коллег: коллегам
повествован: повествование
наворочен: навороченным
мануал: мануалов
вставк: вставки
понятн: понятно
рекомендац: рекомендации
нативн: реклама
сме: смею
огромн: просмотрено
польз: пользы
воз: воз
уровн: уровне уровня
отлич: отличие
сна: сна
сне: сне
упорств: упорством
отдых: отдыха
исходн: исходного исходным исходными
качеств: качестве
онлайн: онлайн
пиш: авг
но: чертовски
сервер: сервер удаленных
раздел: разделить регистрация
дожида: дожидаться
автоматическ: автоматического автоматически
вынесен: вынесенными
нек: некие неких неким
удаля: удаляла собирался
сумбурн: сумбурным
лучш: лучшем лучшего лучшие лучших
од: од
либет: либета
дума: думает
формат: формате форматах
примечательн: примечательным
разворачива: разворачиваться
пойдет: пойдет
крайн: крайне
возможн: возможностями удаленный возможным возможно
интересн: интересная
коробк: состоянии
отображен: отображения
демонстрац: являлись
палат: палате
сердц: сердце
кладут: кладут
непосредствен: непосредственно непосредственного
адекватн: адекватный адекватного
взгляд: взгляд
трога: трогать
прежд: прежде
наверн: наверное
устареван: подверженным
изначальн: изначально
воспользова: воспользоваться
диалект: диалекте
радикальн: радикально
откр: открыл открыть
июл: кат
поимпровизирова: поимпровизировать
наход: настроить
русскоязычн: русскоязычных
опенсорсн: опенсорсного
никак: никак никакого
навигац: навигация
studio: studio
stupid: stupid
sourc: source
rsludg: rsludge
filetyp: filetype
pcdesign: pcdesign
ssh: ssh
wyswig: wyswig
kiss: kiss
rembo: rembo
protocol: protocol
dap: dap
twitter: twitter
simpl: simple
ysomad: ysomad
zend: zend
neo: neo
vim: vim
api: api
text: text
id: ide
rilken: rilkener
group: group
init: init
github: github
varanio: varanio
adapt: adapter
rail: rails
sinoni: sinoni
check: check
nosterx: nosterx
nailxx: nailxx
dreamka: dreamka
languagetool: languagetool
vk: vk
vimscript: vimscript
http: https
habr: habr
server: server
ru: ru
crackidocki: crackidocky
phpstorm: phpstorm
ctrl: ctrl
lsp: lsp
languag: language
klvov: klvov
trokhymchuk: trokhymchuk
sql: sql
youtub: youtube
rss: rss
ftplugin: ftplugin
cachealot: cachealot
linux: linux
men: men
rko: rko
alexrussianpyth: alexrussianpyth
nvim: nvim
jetbrain: jetbrains
debug: debug
os: os
org: org
facebook: facebook
start: started
telegram: telegram
aboyarinov: aboyarinov
plugin: plugins
php: php
lua: lua
neovim: neovim
inteleph: intelephence
vimrc: vimrc
delphinum: delphinum
paul: paul
open: open
rubi: ruby
