опробова: опробовал
говор: говоря говорят
рф: рф
криптограф: криптографии криптография
копирайт: копирайт
стат: стать статье статьи статья
обычн: обычных
стар: старую старых
рабоч: рабочем рабочими
стал: стало
мнен: мнение
нелишн: нелишним
неуместн: неуместные
работ: работа работу работы работ
правок: правок
показыва: показывает показывать
сценар: сценариев сценарии сценарий
видеообработк: видеообработки
пляжн: пляжный
получен: полученный
инфраструктур: инфраструктура
сто: стоило
купальник: купальниках
менеджмент: менеджмент
каса: касается
тр: тр
присутств: присутствии
должн: должны
публикац: публикации
скопирова: скопировать
означа: означает
благодар: благодаря
котор: которую котором
перешл: перешли
осен: осенью
моделирован: моделировании
статистик: статистики
уч: учился уч
либ: либо
проект: проекты проекте
совместн: совместного
упроща: упрощаем
профил: профиль
дела: делает делали делать делаем
проектн: проектной проектно проектных
документац: документации
вывед: выведено
верс: версии версий версию версия
невооружен: невооруженным
маркетинг: маркетинг
прост: простой
ауд: аудио
позвол: позволил позволила
сосед: соседями
типографск: типографской
свободн: свободного
лиц: лицами лица
совместим: совместимость
уровен: уровень
нов: новый нового новой новые
птд: птд
нож: нож
медийн: медийная
част: часть части
цифров: цифровой цифровых цифровом
слож: сложилась
устро: устроился
слов: словам
привнес: привнес
кана: канала
усовершенствова: усовершенствованы
нны: нный
определен: определению определенном
сдела: сделай
внимательн: внимательности
сложн: сложный сложнее
капот: капотом
любител: любителей
примен: применены применить
бутерброд: бутерброды
нот: нот
пример: примерах пример
хранилищ: хранилище
систем: система системы
выход: выход
строительств: строительства
транскодирован: транскодирование
государствен: государственного
частн: частных
разбиен: разбиение
заблокирова: заблокировать
арсенал: арсенале
ресурс: ресурсов ресурсы
машин: машина
метод: методов
процесс: процессами процесс процессы процессов
аппарат: аппаратов
техник: техники
требован: требования
постепен: постепенно
нововведен: нововведения
культур: культура
актуальн: актуальны
продолжа: продолжаем
подряд: подряд
помоч: помочь
бесплатн: бесплатно
вечер: вечерам
перенест: перенести
бэкап: бэкапов
современ: современном современных современной
нарушител: нарушителей
помощ: помощью
автокомпозитор: автокомпозитор
приложен: приложение приложений приложения
разработчик: разработчиков разработчик разработчики
киберпанк: киберпанк
вклад: вклад
программиру: программируя
жител: жителей
будущ: будущем
серверн: серверная
фильтр: фильтров
прекрат: прекратила
сын: сына
нул: нулю
помножен: помноженная
средств: средства средство средств
протестирова: протестировать
закон: закону законное
рост: роста
зарегистрирова: зарегистрированные
мисс: миссия
регистрац: регистрация регистрации
завоеван: завоевания
цел: целый
кажд: каждом
выходн: выходных
российск: российскими российская
дзен: дзен
множеств: множество
искусствен: искусственного искусственный
графическ: графических графический
использова: использовать использовали
логик: логику
музыкальн: музыкальное музыкальная музыкального музыкальным музыкальные музыкальному
строчек: строчек
желез: железо
повседневн: повседневных повседневной
достаточн: достаточно
сюд: сюда
настоя: настоящее
список: список
след: следующие
напомн: напомнить
дизайн: дизайн
производительн: производительности производительность
концепц: концепция
отслежива: отслеживать
встраиван: встраивания
клиент: клиенты
оптическ: оптического
коротк: короткой
так: такого
публикова: публиковать публиковали публиковалась
видеотехник: видеотехника
перевест: перевести
поменя: поменяется
сниз: снизить
техническ: техническая технические
хран: храните
стойк: стойкой
фев: фев
сочиня: сочинять сочинял сочиняет
внесл: внесла
собира: собираемся
рутин: рутинная
некотор: некоторые
предпочита: предпочитают
монитор: мониторы
потенциальн: потенциальной
количеств: количество
соглашен: соглашение
древн: древнем
проектировщик: проектировщиков
добав: добавить
просмотр: просмотра просмотров
содержат: содержат
специальн: специальные специальный
методик: методики
видеоплеер: видеоплеер
зна: зная
обкатк: обкатки
объем: объемом
сквозн: сквозное
сканирован: сканирования
интеллект: интеллект интеллекта
скаж: скажем
похудевш: похудевшая
рандомн: рандомным рандомные
друг: другом другими
закр: закрыли
приход: приходится
сбор: сбора
аппаратн: аппаратную
останет: останется
компан: компанией компания компаний компании
рассказыва: рассказывали рассказываю рассказываем
программ: программа программ программы
ограничен: ограниченным
коммуникац: коммуникаций
главн: главной главных
состоян: состоянии
месторожден: месторождений
дайджест: дайджест
использ: использует
созда: создающих создают
магазин: магазинов
композитор: композиторе
ран: ранее
объемн: объемная
кейс: кейс
отдельн: отдельным отдельные
сохранен: сохранением
выполн: выполнила
колоссальн: колоссальный
оригинальн: оригинальной
привычн: привычным
телекоммуникацион: телекоммуникационных
астроном: астрономии астрономия
пришл: пришло
администрирован: администрирования администрирование
фотограф: фотографии
почтов: почтовые
зерка: зеркало
залива: заливаете
комментар: комментарии
клиентск: клиентские клиентских
сотрудник: сотрудники сотрудников
компьютер: компьютеров компьютере компьютеры компьютера
работа: работает работать работающие
долг: долгов долгое
песочниц: песочницы песочница
услуг: услуги
телефон: телефон
заслужива: заслуживает
доработа: доработано
блог: блог
необходим: необходимо
числ: числе
доработк: доработка доработки
интерфейс: интерфейс
модел: модель
сложност: сложности
вниман: внимания
одобр: одобрено
видн: видна
девайс: девайс
автор: авторы авторов автором
очеред: очередь
чита: читать читайте читали
новинк: новинках новинки новинка
виде: видео
локальн: локально
разрешен: разрешении
разбир: разбираясь
лебедев: лебедева
расписа: расписаться
быстр: быстрое быстрого быструю быстро
типичн: типичный
принима: принимать
тип: типа типами
характеристик: характеристики
бумаг: бумаги
мультимед: мультимедиа
внедрен: внедрения
портативн: портативный
печа: печать
альтернативн: альтернативные
реч: речь
реш: решили
отрасл: отрасль отраслях
общ: общая общий
объ: объем
обслуживан: обслуживание
недел: недель
набор: набор
музыкант: музыкантов
включ: включая
грамот: грамоты
профессиональн: профессиональных
сред: среду
тестов: тестовых
может: можете
редактор: редакторы редактора редакторов
мног: многие
разнообразн: разнообразно
люб: любой любая
язык: языка
фон: фоны
снял: сняли
фронтенд: фронтенд
распозна: распознанных
гор: горами
правд: правда
разн: разных
документооборот: документообороте документооборота
планет: планеты
отсканирова: отсканировать
год: годы
открыва: открывать
мач: мачу
применен: применение
создан: создания создание
облак: облако облака
прич: причем
расход: расходы
эмулирова: эмулировать
подп: подпись
видеохостинг: видеохостинг
телескоп: телескопов
одн: одно
мар: мар
настольн: настольные
реклам: реклама рекламы
прид: прид
корпоративн: корпоративных корпоративные корпоративный
бумажн: бумажная
подборк: подборку
инструмент: инструменты инструментом инструменте инструментов
распространя: распространяется
ток: токены
команд: команда
ведущ: ведущих
объединя: объединяет
экземпляр: экземпляры
стен: стена
мусор: мусор
электрон: электронного
десятк: десятки десятков
смотрет: смотреть
использован: использование
платформ: платформу платформы
потрат: потратить
поскольк: поскольку
союзн: союзных
март: марте
песн: песни
войт: войти
нечт: нечто
безграничн: безграничные
процессор: процессоры
аккаунт: аккаунт
динамик: динамиками
состав: составить составе
подпис: подписью
глаз: глазом
автоматизир: автоматизируй
счаст: счастью
сраз: сразу
производ: производит
смартфон: смартфона
подробн: подробности
похож: похоже
вполн: вполне
скача: скачать
яндекс: яндекс
новост: новости новость
существ: существует
перв: первой первыми
умнож: умножим
достижен: достижения
написа: написать написана
сейф: сейфе
поиск: поиск
автоматизирова: автоматизировать
изменен: изменений изменения
неудобн: неудобно
ритм: ритмы
образовательн: образовательные
как: какие какого
голос: голосов
кат: катом
рассматрива: рассматривать
тся: тся
прошл: прошлая
высок: высокая высокой
реальн: реальную реально
гаджет: гаджеты
дисклеймер: дисклеймер
рок: рока
способ: способ способы
муксер: муксеров
мер: меры мерах
браузер: браузера браузеров браузеры
компьютерн: компьютерное
продукт: продуктом продуктов продукте продукт продукты продукта
улучшен: улучшений улучшения
конференц: конференций
мейнфрейм: мейнфреймы
информацион: информационном информационная
дорог: дорогу
предлага: предлагают
обзор: обзор
появ: появилось появился появилась появившемся
наподоб: наподобие
недоумева: недоумевать
частичн: частично
практическ: практически
вернут: вернуть вернуться
обновлен: обновление
бригад: бригады
д: д
янв: янв
швейцарск: швейцарский
вообщ: вообще
й: й
ожида: ожидает
редкост: редкостью
дава: давайте
х: х
ч: ч
отправ: отправить
распечата: распечатать
редактирова: редактировать
мин: мин мини
вариант: варианты
посовремен: посовременней
писа: писали
совершен: совершенно
безопасн: безопасность
этап: этапе
девушк: девушки
диск: диске
адресат: адресату
новгород: новгорода
аналог: аналог аналога
получ: получили получила получим
публик: публике публикуется
распечатк: распечатку
останут: останутся
город: городе
подушк: подушка
рук: руки
час: часа
внутр: внутри
прям: прямо
индустр: индустрии
тональн: тональности
подписк: подписке
софт: софт софта
больш: большим большая
мест: места
счет: счету
карьер: карьера
офис: офиса
инженер: инженеров
шифрован: шифрования шифрование
игр: играх
полезн: полезна
телегр: телеграм
эффективн: эффективно
редк: редко
минимизирова: минимизировать
волейбол: волейбол
ост: оста
жал: жалуются
жизн: жизни
оригина: оригинала
мож: можем
наступа: наступает
момент: момент
максимизац: максимизация
шрифт: шрифты
лишн: лишним лишнего
исполня: исполняемый
лестниц: лестницы
неплох: неплохо
дошл: дошла
почт: почту
решен: решении решения
офисн: офисные
владельц: владельцы
высококлассн: высококлассных
средн: средний среднее
домашн: домашнем домашняя
хаб: хабы
сжат: сжатия
пикч: пикчу
нужд: нужды
послуша: послушать
выполня: выполняемых выполнять
трудоемк: трудоемкая
обозначен: обозначение
настройк: настройка
дал: далее
богат: богатая
документ: документы документов
прочтен: прочтение
ссылк: ссылку
выросл: выросло
дан: данными данный
поедеш: поедешь
дат: дате
установ: установить
код: кода код
коп: копии копия
загрузк: загрузки
очк: очки
предлож: предложить
самописн: самописные
доступн: доступны
звук: звук
консюмеризм: консюмеризма
сохран: сохранена
кодек: кодеков
любовн: любовные
муж: мужьям
обнов: обновить обновили обновил обновиться
объект: объекты
разработк: разработкой разработке разработку разработка разработки
закладк: закладки
незаменим: незаменимая
разработа: разработан разработали
танц: танцев
увидет: увидеть
жил: жила
перифер: периферия
высокопроизводительн: высокопроизводительных
программн: программное программную
спутник: спутника спутники спутников
поколен: поколения
потомк: потомкам потомки потомков
худш: худшем
почита: почитать
резервн: резервное резервные
учитыва: учитывать
релиз: релиз релиза релизе
преимуществ: преимущества
укладыва: укладывающие
обеспеч: обеспечить
инк: инков
дел: деле
вопрос: вопрос
бесполезн: бесполезная
студ: студию студии
жит: жить
внутрен: внутренние
устройств: устройствах устройство устройств
размер: размере размера размер
прикладн: прикладные
ваш: вашему вашего
башнипинефт: башнипинефть
москв: москвой
проектирован: проектирования
собствен: собственный
копирован: копирование
нефтянк: нефтянке
территор: территории
уда: удал удалось
алгоритм: алгоритмы
расширен: расширения
вдво: вдвоем
мегапроект: мегапроекты
хабр: хабре хабр
видеоконференцсвяз: видеоконференцсвязь
посмотрет: посмотреть
практик: практика
последн: последний
искрен: искренне
сам: самый
лезет: лезет
гибридн: гибридный
стартап: стартапам стартапа
куплен: купленные
бубн: бубном
туториа: туториал
инач: иначе
переда: передать
посмотр: посмотрим
вероятн: вероятно
выполнен: выполнением
гост: гостей
управлен: управление управления
записк: записки
наслед: наследием
нашл: нашли
распознаван: распознавания распознавание
женщин: женщин
орбит: орбиту
представл: представлены представлен
юридическ: юридическими юридические
век: века
жно: жное
вел: вели
начина: начинающих
стандарт: стандартом
очередн: очередную
популярн: популярное
вс: вс
сотрудничеств: сотрудничество
непрошен: непрошеные
мужчин: мужчины
научн: научно
слал: слали
плагин: плагинов
гб: гб
веб: веб
программирован: программирование
распределен: распределенное
специалист: специалистов
порог: порог
реализ: реализующих
станов: становится
значительн: значительно
парт: партию партии партия
олимпийск: олимпийских
редактирован: редактирования
свод: сводя
раздут: раздутых
законч: закончилась
развит: развитие
представ: представили представить
сайт: сайта сайтов
администрир: администрирует
станут: станут
обеспечен: обеспечение
контрол: контроль контроля
оборудован: оборудования
научпоп: научпоп
технолог: технологии
задач: задач задача задачи
файл: файлов файлу файлы
происход: происходит
пользова: пользоваться
трех: трех
поеха: поехали
различн: различного
сегодняшн: сегодняшнего
пар: пару
треб: требуется требуют
нефтян: нефтяные
инструментар: инструментария
истор: истории история
ход: ходить
ещ: ещ
легк: легко
мелод: мелодий мелодии мелодию
вид: виде
конфиденциальн: конфиденциальность
защит: защиты
нескольк: нескольких
одобрен: одобрения
дне: дней
эпох: эпоху
рейтинг: рейтинг рейтинга
компетенц: компетенции
способн: способности
известн: известно
аккомпанир: аккомпанирующих
постав: поставить
сторон: сторон сторонние
вкс: вкс
поток: потоков потоки
поддержк: поддержка
остальн: остальной
тысяч: тысячу
виндов: виндового
дня: дня
предназнач: предназначены предназначено
денежн: денежная
наш: нашего нашу
ин: иные
республик: республик
ит: ит
пользовател: пользователям пользователей
берестян: берестяные
минималистичн: минималистичный
разрабатыва: разрабатывающих
план: планы
швец: швеция
сервис: сервисы сервисах сервисов
информац: информация информации
облачн: облачного облачные облачных
группировк: группировки
земл: земли
ключев: ключевые ключевыми
анализ: анализ
демуксер: демуксеров
удален: удаленных
трат: трата
спуст: спустя
имитац: имитация
ки: киев
понят: понятия
сборк: сборку
обработк: обработки
крыльц: крыльце
например: например
кишочк: кишочками
мойофис: мойофис
токен: токенам
отправля: отправлять
вне: вне
кастомн: кастомный
самостоятельн: самостоятельно
запуст: запустили запустила
презентац: презентации презентаций
рекомендац: рекомендации
нагрузк: нагрузку
запуск: запуск запуска
соответств: соответствующие
нативн: нативные
музык: музыку
архитектор: архитекторов
ступеньк: ступеньки
движок: движок
январ: января январе
разбежа: разбежалась
свет: свете
отлич: отличие
консол: консоли
сист: систем
ноутбук: ноутбуки ноутбук ноутбуком
декордер: декордеров
накоплен: накопленные
забуд: забудь
вычислительн: вычислительная
комплект: комплект
наскольк: насколько
онлайн: онлайн
проблем: проблемами проблема
сервер: сервер сервере серверы
раздел: разделы
автоматическ: автоматическом
ны: ны
блокировк: блокировки
лучш: лучшие лучших
механизм: механизм
космическ: космические
оз: озу
формат: формате формат
дума: думаете
относ: относится
пойдет: пойдет
интересн: интересные интересного
возможн: возможности возможно
ос: ос
планшет: планшетом
выбра: выбрала
перекодир: перекодируется
файлохостинг: файлохостингах
аккомпанемент: аккомпанемента
перенос: переноса
хочет: хочет
крупн: крупное
страниц: странице
пк: пк
загруж: загружена
бывш: бывших
стабильн: стабильный стабильно
архитектур: архитектуре архитектуры
выпуст: выпустили выпустила
наверняк: наверняка
контент: контента
стандартн: стандартный
откр: открыть
обрывк: обрывки
наход: находится
справля: справляется
кнопк: кнопками
рн: рн
непонятн: непонятные
misic: misic
blackstrip: blackstrip
sourc: source
obieesupport: obieesupport
ruvd: ruvds
data: data
dii: diy
seleditor: seleditor
bim: bim
ogg: ogg
twitter: twitter
ragequit: ragequit
reserch: reserch
host: host
slidelab: slidelab
ffmpeg: ffmpeg
powerpoint: powerpoint
appstor: appstore
jira: jira
app: app
ab: ab
soni: sony
mp: mp
chrome: chrome
selectel: selectel
vaio: vaio
io: ios
atlassian: atlassian
periki: perikis
magichappen: magichappens
itu: itu
pro: pro
vc: vcs
bashnipineft: bashnipineft
miran: miran
maco: macos
starlink: starlink
vk: vk
aw: aws
zr: zr
habr: habr
firstvd: firstvds
iphon: iphone
xorowmeist: xorowmeister
lenovo: lenovo
globalsign: globalsign
wine: wine
ru: ru
pine: pine
simbirsoft: simbirsoft
postscript: postscript
tini: tiny
monrev: monreve
songwrit: songwriter
admin: admin
drobushevkii: drobushevkiy
mac: mac
youtub: youtube
myoffic: myoffice
rss: rss
linux: linux
doremir: doremir
rko: rko
muzz: muzz
vgn: vgn
yconilev: yconilev
nvidia: nvidia
mine: mining
gi: gis
su: su
alizar: alizar
greiv: greiv
center: center
facebook: facebook
telegram: telegram
store: store
pdf: pdf
googl: google
simbirsoftqa: simbirsoftqa
alexeynepomnyashchikh: alexeynepomnyashchikh
mailion: mailion
window: windows
open: open
mark: marks
scorecloud: scorecloud
