нейрон: нейронной нейронов нейронные нейронных нейронная
магистральн: магистральных
найт: конвертация
максимальн: достижению
готов: архитектуру
преобразован: продакшн
говор: говоря
провер: проверить
впоследств: впоследствии
фактическ: фактическими
значен: значения значений
независим: независимыми
образ: задачах образ
стат: стать цитирования статье статьи статья интернете
сравн: сравнить сравним
оказа: оказалось число
стар: вернуться
диагностик: диагностики
преходя: преходящей
стал: стало
окс: окс
указан: предложения
окт: курса
стад: стадию
успех: успехи успехов какого
повторя: повторяются
работ: работу
инвазивн: инвазивной
громоздок: фреймворке
показыва: показывать
реагирова: алиса
вернут: поддержка
впечатлен: впечатление
получен: получении полученные
инфраструктур: инфраструктуре
пол: пол
датасет: овский мнистовского
янв: янв
д: молекул
словар: ссылками
менеджмент: менеджмент
идентифицирова: людей
изменя: изменять
мобильн: мобильных мобильное
присутств: реагировала
структур: информации взаимосвязанных
публикац: разделы
скопирова: скопировать
карт: картами
х: графовых
логическ: логические
подел: хочу
сезон: сезон
наилучш: наилучших
ишем: ишемию ишемии
взаимосвяза: изучения
э: э
карл: карло
котор: графов преграда
мин: мин
вариант: взгляд
холестерин: холестерина
эксперимент: экспериментов начинать
экг: экг
клиническ: клинических клинические
исследован: исследованиях исследования
шаг: шагом
связа: страниц
безопасн: безопасность
этап: этапах этапов
проверя: проверяются
вовс: плохо
уч: успеха учится игр
проект: проектов проект нативные
связ: социальных
вперв: впервые
классическ: классических классическим классической классическими
профил: профиль
сут: сути
провед: проведено проведем
получ: получить
разрыв: разрыва
вложен: вложенных
перевод: образов перевод
роберт: доктора
верс: старую
подводн: вид
маркетинг: маркетинг
побочн: побочные
компилируем: сравнению
грандиозн: грандиозных
разобра: разрешения
час: часов
прост: простой простая
внутр: алисе
предобучен: предобученной
массачусетск: массачусетского
рус: рус
подлин: подлинность
языков: языковых
заодн: заодно
интриг: интригующим
свободн: выложили
ложн: ложному
автоэнкодер: выбросы введение
лиц: распознавания
лекарствен: лекарственного
сжима: автоэнкодером
разумеет: массовым
повышен: х плане
уровен: уровень
нов: новый новые новых новое
придума: дело
умеет: умеет
выделя: предсказание
больш: автоэнкодеры
медийн: корпоративный
мест: узкие
част: решили
иде: локальный
предсказан: расширение
традицион: традиционных
вход: входило вход входе
литератур: литературе
пригодн: пригодное
слов: отношениями
направлен: направлении
мнистовск: тренингу
аналогичн: аналогичным
игр: игры играм знаю
граф: словами обработки структуре
одновремен: одновременно одновременная
сдела: сделать сделаем
определен: определения словари определение математическому
телегр: телеграм
сложн: сложный придумать
капот: капот
прогнозир: прогнозирует
представлен: представленной текста
камн: подводные
генерац: генерацией генерации генерация
совет: советует
примен: применить
сердечн: сердечных сердечно
жизн: жизни
пример: примеров примере
выпада: сжимается
преград: привычная
коронарн: коронарных коронарной
систем: относиться
выход: выходе
сокращен: сокращение сокращением
лиценз: свободной
генерирова: генерировали генерировать
технотекст: технотекст
преобразу: вовсе
принципиальн: принципиальную
труд: тся
графов: смыслы вопросы
текуч: текучие
основн: основные основных основная
сверточн: типов ускорить
курс: флагманского
машин: машинного машинное
метод: методами метод данного методам методов
одномоментн: одномоментной
выявл: выявлено
решен: возможном
бинарн: бинарной
превзойт: превзойти
входн: входных
почк: раком
актуальн: почки
провод: проводятся
светлоклеточн: гистологических
средн: средний
флагманск: нашего
поздн: поздние поздней
спотыка: которую
подряд: подряд
хаб: публикации
описан: описание
вылож: задачи
помощ: помощи помощью
приложен: приложение приложений приложения
результат: результата результатов результат результатами
разработчик: файлов
вызыва: вызывает
здоров: здоровье
опыт: поделиться
вычислен: вычисления
декодер: декодера декодер
конвертац: встречаются
настройк: дзен
обнаруж: железа
вклад: сюда
дал: далее
матричн: матричными матричные
генеративн: генеративно
жидк: жидкая
текст: перевода статей
кардиолог: кардиологами
ядер: ядер
документ: компаний
прочтен: прочтение
будущ: будущее
предложен: представление предложенной
ссылк: связанных ссылку
фильтр: фильтрует
профильн: профильными
нул: нуля
интерес: интерес
средств: средства
имел: имела
дан: данных данные данной преимуществ
сравнен: сравнение производительность
потребова: потребовалось
установ: установить
картинк: картинку собственные
фаз: фазами фазы фазой
плох: справляется
код: код кодом
рост: привело
помогл: помогло
регистрац: войти
сократ: заметно
медицинск: медицинских
выявля: выявляющая
технологическ: технологического
суточн: суточное
генератор: генератор
эффект: эффекты
счита: считают
формирован: формировании
причин: причину
цел: обучить
старт: подробности
тредм: тредмил
экстраполяц: экстраполяции
предлож: предложен
кажд: каждому каждого
возраст: возраст
лекарств: лекарство
гистологическ: наборов
оцен: оценена
хрякус: хрякус
дзен: мегапроекты
кодер: кодера
сегментац: сегментации
вмест: вместе
директор: директор
искусствен: искусственного искусственный
обнов: обновить
име: имеем
разработк: разработка
закладк: закладки
частност: частности
налич: наличие наличия
использова: использовать лиц
важ: ним
продакшн: поставки
направл: направлены
желез: хорошего
значим: значимое
установк: установки
учитыва: учитывать
сюд: числа
послойн: послойным
ткан: нормальные
преимуществ: актуальности
список: список
всколыхнул: всколыхнули
институт: института
дек: дек
дел: думаю деле делятся кюблера
вопрос: вопрос общие
дизайн: дизайн
производительн: накладываемых интерпретируемости
концепц: концепции наука
игра: играть играющее
отслежива: отслеживать
попыта: многих
устройств: песочница
попробова: решил
изучен: отношений
нормальн: содержат
перевест: перевести
сниж: веса
собствен: распознавать
переписа: переписал
баз: базе
техническ: языка
обезвред: снижая
измен: изменяя радикально
мощн: мощная
диагностическ: диагностической
суток: суток
алгоритм: алгоритмы
фев: фев
заметн: сверточную
людьм: разными
расширен: графа
отслеживан: отслеживания
материал: производительности
мегапроект: стартапам
хабр: хабр
сэконом: позволяет
обучен: обученную обученной прибегая обученных обучения обученная сэкономить обучением обучение
некотор: уч некоторые добавления
лечен: лечения лечение
отношен: определенными указанием
рассмотр: рассмотрим
обуча: обучающих
зно: зно
количеств: количество количества
введен: июн
сант: санта
соглашен: документы
таргет: таргеты
добав: добавить
просмотр: просмотров
содержат: целью
практик: доходит
клеток: клеток
зна: знаем проблема
синтетическ: синтетических синтетические
цитирован: используются
сам: использован самых самые
интеллект: интеллект интеллекта
представля: представляет
настраива: настраиваются
друг: другом друг
стартап: программы
туториа: туториал
возвраща: возвращает
переда: передаются
сбор: сбор
подобн: подобных
посмотр: посмотрим
называ: называемых называемую выпадающие
вероятн: вероятность
кластер: определить
компан: компании сайта
рассказыва: рассказывает
выполнен: выполнения
ограничен: некоторых
программ: образовательные
управлен: управление
точност: точность точности
получа: получаем
ежедневн: ежедневно
распознаван: например
заболеван: заболеваний
привел: глубокого
созд: созда
смысл: скрытые
заключа: идея
вольност: некоторой
начина: разумеется практики
вес: сократить весов
поражен: поражения
прогноз: прогнозов прогнозах
вс: вс
популярн: росту
колонок: внутри
ускор: магии
семантическ: семантического
имеют: имеют
использ: использует использующихся многие
раз: увеличения
щепотк: имитация
созда: создано создал создана создать
рак: светлоклеточным
поэкспериментирова: поэкспериментировать
имеющ: узлов
ран: раннюю ранних ранние
веб: системы
кейс: кейс
программирован: программирование
распознава: начинаешь
авг: камни
реша: решать
пациент: пациенту пациентов
специалист: специалистами
порог: порог
интернет: датасет
тест: тест
го: эксперименты
реализац: реализацию реализации реализация
явля: является
узк: обезвредить
узл: кластеров
чисел: рукописных
подгон: мая
прибег: сетки
применя: применять
привычн: выбросами
пришл: пришлось
полн: полный
администрирован: администрирование
развит: развития открытые
начальн: начального
представ: представить
сайт: устройство
сгенерирова: сгенерированных сгенерированные
соревн: соревнуются
знан: тренировка
терр: терри
научпоп: научпоп
комментар: комментарии
задач: частые задачу популярности возможных
хроническ: хронических
обществен: общественности
файл: найти
поставк: громоздок
тренинг: статью
нейросет: нейросеть нейросетей нейросетям минимакс
работа: работающего работают
достигнут: достигнут
долг: долгих
песочниц: хабы песочницы
патолог: патологию патологии
услуг: конфиденциальность
базов: базовой
треб: требует требующим
блог: блог
необходим: необходимо
накладыва: ограничений
фреймворк: натренированы
истор: истории
числ: большое произвольное
обуч: попробовать
модел: модель моделей модели моделями
сгенериру: сгенерируем
сетк: готовой
сложност: сложности
параметр: параметров
автор: авторы вклад автором
реакц: реакции
тренировк: вариант
сер: серией серь
чита: читать
выпаден: концепция
сет: сеть сети сетей
вид: виде удобный
спектральн: щепотка
конфиденциальн: соглашение
сосудист: сосудистых
локальн: поддерживающих
подход: подход
разрешен: повышение
ишемическ: ишемической
мастер: мастерим
доход: чисел
науч: научить
курир: курирующих
изоморн: сверточные
неэффективн: оказаться
наук: спотыкаются наук
тип: выделяют
позволя: позволяющим лицензией
воспринима: разному
хоч: дом
рейтинг: рейтинг рейтинга
скорост: скорость
соблюд: соблюдая
дискриминатор: дискриминатор
удобств: удобством
дом: умный
реш: метода разработчики
способн: способны
уравнен: уравнения
лаборатор: лаборатории
структурирова: структурированных структурированные
общ: д
объ: объ
коронарограф: коронарографии
поток: потоки
обслуживан: обслуживания
поддержк: техническая
набор: набора классификации
коллапсир: делимся
рукописн: датасета
поддержива: колонок
глубок: глубокой глубоким развитие
доб: нейросети
хорош: знаний
библиотек: библиотека библиотеки
классификац: окт
пуст: пусть
подсет: подсети подсетей
аугментац: аугментацию
удобн: преобразование
реалистичн: реалистичных
сред: связей
прогнозирован: прогнозирования
социальн: граф
наш: старту
мног: текстов изоморные
наблюда: наблюдаемому наблюдаемых наблюдают
интерпретируем: повышения
снят: снятое
ищ: авг
язык: настройка компилируемыми
заказ: заказу
умн: яндекс
заглянут: заглянуть
план: неэффективным
фактор: факторы факторов
информац: имеющейся информацию информация
выброс: называемые обнаружить сложно
мониторирован: мониторирование
пратчетт: пратчетт
гот: важен
разн: выброс восприниматься
выгляд: выглядит
анализ: анализа анализах
показух: показуха
маг: спектральной
скрыт: ищем
овск: подгон
люд: присутствующих
математическ: понятна
белков: структур
выявлен: выявлении
ликвидн: ликвидные
дополнен: дополнение
имитац: аппроксимация
добавлен: опытом
сборк: сборки
применен: применение применении
обработк: напрямую
создан: создания создании создание
нейросетев: нейросетевого
например: идентифицировать
кюблер: роберта
одн: одном одному одно
монт: монте
агрегатор: агрегатор
мар: мар
артер: артерий
настольн: настольным
наблюден: наблюдений наблюдению
увеличен: разобрано
реклам: медийная
подд: определению
аппроксимац: коллапсирующие
калибровк: калибровки
корпоративн: услуги
пода: подается подаются
понятн: интуитивно
соответств: соответствуют соответствующей соответствует
запуск: запуска
нативн: реклама
огромн: огромное
достоверн: достоверность
интуитивн: выпадения
сло: слоев слои
миокард: миокарда
ма: обучению
здорова: алису
доктор: решении
мощност: мощностей
инструкц: инструкцию
использован: использование использования использованием
уровн: уровне
самонадея: го
побед: победы
поскольк: поскольку
испытан: испытаний испытания
войт: аккаунт
соедин: соединены
исходн: исходной
качеств: качество
превосходств: превосходство
массов: языками
конечн: конечного
аккаунт: лучших
кодировщик: кодировщика кодировщик
табличн: табличных табличные
вычислительн: вычислительных
счаст: самонадеянно
точ: точь
штуковин: штуковина
молекул: белковых
проблем: проблемы счастью
но: ноя
подробн: людьми
алис: учим вольности заключается
бот: бота
раздел: регистрация
автоматическ: автоматической
болезн: болезни
кросплатформен: кросплатформенного
всяческ: всяческих
прикрепл: прикреплено
натренирова: обучении
жела: желаемого желаемый желаю
вполн: вполне
яндекс: здороваться
новост: новостей новости
лучш: авторов лучшие
существ: существующие существует
перв: первым
чувствительн: чувствительность
бог: бога
достижен: препятствующие
дума: думать думает трудом
относ: которым
операц: операциями
поиск: поиск поисков
возможн: среди возможность возможно материалом
интересн: интересно
побежда: побеждает
триумфальн: триумфальные
основ: основе
открыт: открытая графовые
нечестн: нечестно
сердц: сердца
образовательн: проекты
хочет: хочется
как: добиться
определ: задач
препятств: места
голос: голосов
содерж: содержится
страниц: веб
многозадачн: многозадачным многозадачное
рандомизир: рандомизируются
лицензирова: лицензировано
адаптир: адаптируются
встреча: встречал ткани
взгляд: самый
тся: подда
пр: пр
наследствен: наследственные
высок: высокое высокая
реальн: реальному реальными
выборк: выборки
произвольн: преобразуем
архитектур: изменить архитектура архитектуры
состязательн: состязательных состязательная
точн: точными
изображен: изображений изображение изображения
риск: риска
радикальн: максимальной
точк: точками
переработа: переработанные
установлен: установленного
откр: открыть
форм: форме
июн: раза
мет: мета
справля: картинки
напрям: попытались
компьютерн: компьютерных
даниэл: даниэла
продукт: продукт
признак: признаков
доказа: доказана
минимакс: готов
sourc: source
data: data
di: di
stabuev: stabuev
timurabdualimov: timurabdualimov
yayai: yayay
spirali: spiralis
twitter: twitter
vova: vova
rive: rive
school: school
honyaki: honyaki
md: md
hex: hex
datret: datret
api: api
dati: dati
convolut: convolutional
python: python
github: github
qt: qt
multipl: multiple
alphago: alphago
io: ios
ai: ai
alphazero: alphazero
worksolut: worksolutions
gpu: gpu
prevision: previsione
javascript: javascript
graph: graph
otu: otus
esrgan: esrgan
vk: vk
letter: letters
spektral: spektral
habr: habr
kera: keras
numpi: numpy
bicikar: bicikar
unet: unet
scienc: science
parilo: parilo
neural: neurale
dilet: diletant
skillfactori: skillfactory
isomorph: isomorphism
android: android
artem: artem
atari: atari
divan: divan
tabulari: tabulari
network: network
youtub: youtube
rete: rete
teachabl: teachable
mil: mil
tensorflow: tensorflow
rss: rss
coronarographi: coronarography
guinmoon: guinmoon
gan: gan
dmitriizolotov: dmitriizolotov
pytorch: pytorch
kap: kapping
machin: machine
datretregressor: datretregressor
man: man
sam: sam
glukkazan: glukkazan
readm: readme
cnn: cnn
panasyuk: panasyuk
alizar: alizar
learn: learning
gnn: gnn
neuro: neuro
facebook: facebook
telegram: telegram
hardrockmaniac: hardrockmaniac
mlflow: mlflow
googl: google
hub: hub
la: la
vectorplu: vectorplus
alphafold: alphafold
mnist: mnist
open: open
datretclassifi: datretclassifier
instanc: instance
