банк: банк банка банке
рф: рф
консольн: консольные консольным
расскаж: расскажем
стат: стать статью статье статьи статей статья
оказа: оказался
стар: старую
стал: стало
неуместн: неуместные
объясн: объясним
пропускн: пропускной
работ: работа работе работы работу
завис: зависят
правок: правок
показыва: показывает показывать
дополнительн: дополнительной
сценар: сценарий
предсказа: предсказать
пляжн: пляжный
получен: полученный
сто: стоило
просматрива: просматривать
приятн: приятных
критическ: критически
те: тесь
лен: лень
купальник: купальниках
менеджмент: менеджмент
тк: тк
множествен: множественное
мобильн: мобильному мобильного
присутств: присутствии
знакомств: знакомство
публикац: публикации
скопирова: скопировать
график: графику графики
подел: поделиться
жестк: жесткая
назван: названии названий
благодар: благодаря
котор: которое которую которыми
примечан: примечание
заголовок: заголовок
связа: связаны связанные
прав: право
обратн: обратных обратного
проверя: проверяем
либ: либо
проект: проектах проекты
связ: связи связь
появля: появляется
вперв: впервые
профил: профиль
дела: делает
байт: байт
тестер: тестеров
документац: документации
подкаст: подкасты
верн: верн
полага: полагаться
верс: версии версию версия
маркетинг: маркетинг
книг: книг книги
разобра: разобравшись разобраться
прост: простой просты
движк: движка
персонализирова: персонализированные
позвол: позволят позволяя
лис: лиса
справ: справиться
типографск: типографской
постро: построена
занима: занимаюсь
полномоч: полномочия
уровен: уровень
нов: новый нового новую новой новые новая
внешн: внешнее
медийн: медийная
част: частью часть части
перегрузок: перегрузок
цифров: цифровых цифровом
слож: сложилась
устро: устроен
опубликова: опубликован опубликовал
слов: слово
промисификац: промисификация
цп: цп
отказ: отказа
нны: нные
сдела: сделать
сложн: сложных сложно сложными сложный
примен: применить применит
пут: пути
пример: примеру пример
русск: русский
вперед: впереди
подверж: подвержены
систем: системы
баннер: баннер баннера
трудн: трудно
заблокирова: заблокировать
текущ: текущее
ресурс: ресурсов ресурсы
атакова: атаковать
метод: методы
процесс: процессов
техник: техник
выпуска: выпускайте
нных: нных
противн: противном
актуальн: актуальной актуальны
продолжа: продолжает продолжаем
букв: букв
подряд: подряд
рынк: рынке рынка
современ: современных современной современном современный современного
помощ: помощью
нарушител: нарушителей
приложен: приложениями приложения приложений приложениям
лож: ложится
разработчик: разработчиков разработчикам разработчик разработчики
здоров: здорово
опасн: опасности
вклад: вклад
интегрирова: интегрированные
альф: альфа
будущ: будущими будущем
выделен: выделенном
прекрат: прекратила
нуж: нужен
сын: сына
прочита: прочитать прочитали
нул: нулю
нацел: нацелены
задержк: задержкой
агрессивн: агрессивная
сравнен: сравнение
программист: программистам
отключ: отключил
борьб: борьба борьбе
протестирова: протестировал
картинк: картинка
конкурентн: конкурентная
мисс: миссия
регистрац: регистрация
помож: поможем
тестирова: тестировать тестировал
извест: известен
убед: убедиться
издательск: издательский
имеет: имеете имеет
цикл: цикл цикла
некорректн: некорректно
счита: считаю
эффект: эффекты
причин: причин
цел: целях целом целей
отлича: отличаться
лент: лентой
кажд: каждым каждом каждую
асинхрон: асинхронные асинхронности асинхронность
настро: настроить
российск: российских
дзен: дзен
подписок: подписок
канал: канале каналы
взаимодейств: взаимодействий
создава: создавать
десктоп: десктопов
веден: ведения
использова: использовать
графическ: графическом графического графический графические
логик: логику
музыкальн: музыкальными
достаточн: достаточно
добавля: добавляют добавляем
указател: указателей
сюд: сюда
спрята: спрятанный
список: список
затронул: затронули
знаком: знакомимся
иконок: иконок
отраж: отражено
след: следует
строк: строку
организац: организацию организации
дизайн: дизайн
производительн: производительностью производительность
невозможн: невозможно
концепц: концепций
попыта: попытаюсь
статус: статус
клиент: клиенты клиент
распростра: распростран
так: такими таком таких таким
картин: картину
уязвим: уязвимостей уязвимостях уязвимости
поменя: поменялась
событ: событий
баг: багов баг
баз: базу
техническ: техническая
цельн: цельную
фев: фев
неявн: неявное
разниц: разницу
ггц: ггц
привлекательн: привлекательными
звуков: звуковые
размыва: размываться
откуд: откуда
некотор: некоторое некоторые некоторых
предпочита: предпочитают
авторизац: авторизации
рассмотр: рассмотрим рассмотрев рассмотрю
потенциальн: потенциальной
клавиатур: клавиатурой
количеств: количество количества
залг: залго
соглашен: соглашение
добав: добавить
просмотр: просмотра просмотров
специальн: специальные
методик: методика
зна: знаю
услов: условиях
сквозн: сквозном
сканирован: сканирования
скаж: скажем
исчерпыва: исчерпывающего
виртуальн: виртуального
закр: закрыть
питер: питер
ознакомлен: ознакомления
приход: приходится
роутер: роутеры
наступ: наступила
железн: железно
компан: компанией компаниях компания компаний компании
степен: степени
программ: программы
коммуникац: коммуникации
главн: главной главному главных главного
действ: действии
фундаментальн: фундаментальных
соответствен: соответственно
обеспечива: обеспечивают
низк: низкой
фич: фичи
элемент: элементов
октябр: октябре
исследу: исследуем
волну: волнуясь
привет: привет
поможет: поможет
состоян: состояние
использ: используется
изуч: изучили
парсер: парсером
созда: создали создать созданного
ран: ранее
кейс: кейс
жерар: жерар
стронгл: стронгли
отдельн: отдельным
взаимоотношен: взаимоотношениями
гик: гиков гики
сохранен: сохранением
передач: передачу передачи
интернет: интернет интернета интернету интернете
предоставля: предоставляет
реализац: реализации реализация
оптимизац: оптимизация оптимизацию оптимизации
тем: тема тему теме
полн: полное полный
уделя: уделять
администрирован: администрирование
знат: знать
пользовательск: пользовательские
знан: знания знаний
комментар: комментарии
бет: бета
клиентск: клиентская клиентской
сотрудник: сотрудники
компьютер: компьютером компьютеру компьютере
работа: работают работающие работать работает работаю
сильн: сильно
песочниц: песочницы песочница
блок: блока
услуг: услуги
блог: блог
необходим: необходимости необходимо необходимы
интерфейс: интерфейсы интерфейса интерфейсе
сложност: сложности сложность
вниман: внимание
несовместим: несовместимость
посредств: посредством
девайс: девайсе
автор: авторы автор автором авторов
выйт: выйти
очеред: очередь очередей
чита: читать
новинк: новинками
виде: видео
локальн: локально локальную
пойд: пойд
разрешен: разрешения
тестирован: тестирование
расписа: расписаться
быстр: быстрым быстрее быстрого быструю быстро
заключен: заключение
тик: тики
типичн: типичный
принима: принимать
тип: типа типов типе
продемонстриру: продемонстрируем
бумаг: бумаги
портативн: портативный
статическ: статические
печа: печать
альтернативн: альтернативные
реш: решил решили
общ: общая
недостатк: недостатки
стка: сткая
виртуализац: виртуализация
состо: состоит
реж: режим
недел: неделю
поддержива: поддерживает
обм: обмена
сред: среди
зациклен: зацикленного
лайфхак: лайфхаки
слыш: слышим
может: можете
корутин: корутины
ядр: ядра
абсурдн: абсурдной
люб: любого любые
сущност: сущностями
язык: языка
происходя: происходящее
фронтенд: фронтенд
табл: табло
разн: разных разные
документооборот: документообороте документооборота
освоен: освоения
отсканирова: отсканировать
создад: создадим
разв: разв
год: годах годы
открыва: открывать
потребля: потребляют
беспоко: беспокоясь
погруз: погрузились
применен: применение
ставк: ставки
парочк: парочкой
создан: создания
конвейер: конвейера конвейеру
привод: приводит
подп: подпись
мал: малое
одн: одна одним
прим: прим
широк: широко
согласн: согласно
наблюден: наблюдения
реклам: реклама рекламы
разбер: разбер
прид: прид
корпоративн: корпоративный
бумажн: бумажная
потребн: потребность
одинаков: одинаково
глубж: глубже
инструмент: инструмент
огранич: ограничил
иконк: иконка иконках иконки
мусор: мусор
уникальн: уникальность
электрон: электронного
использован: использование использования
поскольк: поскольку
войн: войнами войны
облегча: облегчают
март: марта
войт: войти
процессор: процессора
конечн: конечными
аккаунт: аккаунт
состав: составить
трюк: трюки
подпис: подписью
протокол: протокол протоколов протоколы протоколом протокола
счаст: счастью
сраз: сразу
компиляц: компиляцию компиляцией
смартфон: смартфона
обозревател: обозреватели
яндекс: яндекс
новост: новостей новости
заголовк: заголовка
существ: существует
перв: первой первом первые
написа: написано
гайд: гайда
поиск: поиска поиск
проброс: проброс
изменен: изменение
неудобн: неудобно
основ: основе
голов: голове
сборщик: сборщик сборщика
образовательн: образовательные
как: какие каких
определ: определ
заним: занимая
голос: голосов
тся: тся
высок: высокими высокая высокий
установлен: установленный
шпион: шпионить
мем: мемам
способ: способов способ способы
мер: меры
браузер: браузеров браузерами браузеры браузере браузер браузера браузерам
отправител: отправителей
напрям: напрямую
доказа: доказать
ретроспектив: ретроспектива
улучшен: улучшения
рекоменд: рекомендуются рекомендую
быва: бывают
максимальн: максимально
информацион: информационная
вызов: вызова вызовов
конц: концов конце
предлага: предлагает
сэндбоксинг: сэндбоксинг сэндбоксинга сэндбоксингом
обзор: обзора обзор
появ: появился
случа: случае случаев случаях
наподоб: наподобие
запуска: запускают
вернут: вернуться
принос: приносит
обновлен: обновленного обновления
отвлека: отвлекать
д: д
янв: янв
вообщ: вообще
единствен: единственном
сбойн: сбойным
й: й
доминир: доминирует
потреблен: потребление
парсинг: парсинга
ошибок: ошибок
централизова: централизованные
ч: ч
недооценива: недооценивать
показа: показаться
интерпретатор: интерпретатора
отправ: отправить
распечата: распечатать
поэт: поэтому
ы: ы
зафиксирова: зафиксировал
редактирова: редактировать
мин: мин
вариант: варианты
памят: памяти
мир: мир
совершен: совершенно
безопасн: безопасность безопасности
скор: скорее
чрезвычайн: чрезвычайно
классическ: классической
адресат: адресату адресатов
сообщен: сообщения сообщение
галла: галлан
подтвержда: подтверждает
хост: хосты хост
перевод: перевод переводить
распечатк: распечатку
фронт: фронта
дистрибутив: дистрибутивов
важн: важны важной
производн: производные
национальн: национальной
рук: руки
компрометац: компрометации
час: часа
сосредоточ: сосредоточилась
столкнул: столкнулся
метр: метро
внутр: внутри
зловредн: зловредные зловредным
выпущен: выпущенной
индустр: индустрии
могл: могли
подписк: подписки
сбыл: сбылись
приготов: приготовили
софт: софт
больш: больших большими
задержек: задержек
начин: начиная
иде: идея
ждат: ждать
вход: входит
убытк: убытками
игр: играх
полезн: полезны
принудительн: принудительного принудительно
эффективн: эффективную
исчерпа: исчерпаны
устанавлива: устанавливаете
гран: грани грань
доставля: доставлять
редк: редких
расшир: расширить расширяя
волейбол: волейбол
представлен: представленных
генерац: генерации
жал: жалуются
погружен: погружение
аутентификац: аутентификации
авторизацион: авторизационных
переводчик: переводчика
лишн: лишнего
исполня: исполняются
основн: основного основных основной основном
основа: основаны
скрыва: скрывает
злонамерен: злонамеренных
привест: привести
утечк: утечках утечками
решен: решения
офисн: офисные
передава: передавать
баскетбольн: баскетбольной
создател: создателей
средн: средний средние средними
живет: живет
личн: личном
отч: отч
кнопок: кнопок
аккуратн: аккуратны
меня: меняющихся
хаб: хабы
сжат: сжатия
повыс: повысить
бенчмарк: бенчмарки бенчмарк
выполня: выполняется
результат: результатов результат результаты
жизнен: жизненного
красив: красивая
распоряжа: распоряжаемся
подразумева: подразумевает
настройк: настройка
дал: далее
пониман: понимание понимания
документ: документы документов
прочтен: прочтение
предложен: предложения
ссылк: ссылку
выросл: выросли
транспортн: транспортный транспортных транспортного
дан: данных данные данными данной
эксплойтинг: эксплойтинг эксплойтинга
воспроизводим: воспроизводимыми воспроизводимые
привязан: привязанность
код: кода код кодом
перевед: переведя
модул: модули модулей
коп: копия
соединен: соединении соединения соединение
функц: функции
микроархитектур: микроархитектуры
мся: мся
ландшафт: ландшафт
новостн: новостные новостной
новичк: новичков
изоляц: изоляции
крадущ: крадущее
заран: заранее
консюмеризм: консюмеризма
сохран: сохранить
политик: политика
увидел: увидели
обнов: обновить
миллисекунд: миллисекунды
читалк: читалку
объект: объекты
разработк: разработкой разработке разработка разработки
закладк: закладки
разработа: разработан
злодейств: злодейство
трекинг: трекингом
загружа: загружают
уверен: уверенно
начал: начале
возвращен: возвращение
программн: программное
преимуществ: преимущества
важност: важность
пост: посте пост
ориентирова: ориентирован
дек: дек
дел: деле
вопрос: вопросов
бесполезн: бесполезная
рассказа: рассказать
стремительн: стремительно
жит: жить
сохраня: сохранял
внедря: внедряет
внутрен: внутреннюю
устройств: устройствам устройство устройства
текстов: текстовые текстового текстовых
проигра: проиграл
ваш: ваших вашего вашем
изучен: изучение
полност: полностью
усил: усилить
собствен: собственными
измен: изменили
раст: раст
территор: территории
расширен: расширения расширение расширений
внушительн: внушительным
мегапроект: мегапроекты
хабр: хабр
уничтожа: уничтожает
ад: ад
претенд: претендует
ртыван: ртывания
куч: кучу
посмотрет: посмотреть
эксплойт: эксплойтить
практик: практика
последн: последнее
посмотрел: посмотрели
сам: самый самых самыми
лезет: лезет
отображ: отображая
стартап: стартапам
туториа: туториал
подключен: подключения
тотальн: тотальное
подобн: подобные
посмотр: посмотрим
называ: называют называется
вероятн: вероятно
господств: господство
наслед: наследием
принят: принята
предназначен: предназначенный
цепочк: цепочки
женщин: женщин
браузерн: браузерный браузерных браузерные браузерными
умолчан: умолчанию
век: века
жно: жной
стандарт: стандартом
обязан: обязанностью
вер: верить
вс: вс
прогноз: прогнозов
непрошен: непрошеные
начн: начну
област: области
сво: своим
веб: веб
программирован: программирование
отобража: отображать
порог: порог
станов: становятся становится
значительн: значительной значительно
атак: атакует
олимпийск: олимпийских
явля: является
редактирован: редактирования
появлен: появлению
вещ: вещей
свод: сводя
раздут: раздутых
прибег: прибегая
ощутим: ощутимую
компилятор: компилятора
сайт: сайта сайты сайтами сайте сайт сайтов
дн: дн
обеспечен: обеспечения обеспечение
контрол: контролем контроля
научпоп: научпоп
технолог: технологиями технологию технология технологии
происход: происходит
задач: задачу задачи задач
хвата: хватает
сегодняшн: сегодняшней сегодняшнем
пар: пара
базов: базовые
треб: требуют
истор: истории история
довер: доверия
ход: ходу ходить
двум: двумя
пробл: проблем
ещ: ещ
преемник: преемника
сер: серь
легк: легко
вид: виде
конфиденциальн: конфиденциальность конфиденциальности
сет: сетью сети сеть
жд: жд
краст: красть
защит: защиту защиты
кибербезопасн: кибербезопасность
влия: влияет
хот: хотят
позволя: позволяет позволяющих
эпох: эпоху
хоч: хочу
дни: дни
рейтинг: рейтинг рейтинга
скорост: скорость
дом: дом
способн: способности
известн: известно
структурирова: структурированы
постав: поставить
сторон: сторон сторонние
поток: потоки
кратк: краткий
поддержк: поддержка поддержки поддержку
смотр: смотрим
остальн: остальной остальными
глубок: глубокое
доб: добь добиться
микрозадач: микрозадачи
предназнач: предназначена
пуст: пусть
предыдущ: предыдущем предыдущий
наш: нашими нашей
пользовател: пользователя пользователям пользователей
сюрприз: сюрпризов
большинств: большинстве большинство
минималистичн: минималистичный
разрабатыва: разрабатывать
сервис: сервисов сервис сервисе
автобус: автобусе
информац: информацию информация информации
поставля: поставляются
прогрессивн: прогрессивных
замет: заметил
трат: трата
зных: зных
предварительн: предварительного
предустановлен: предустановленными
крошечн: крошечное
обработк: обработка обработки
соперник: соперниками
сцеплен: сцепленность
собра: собрать
бастион: бастион
младш: младшими
ассоциац: ассоциации
запута: запутаться
например: например
кастомн: кастомный
коллег: коллега
миров: мирового
увеличен: увеличению
вор: ворует
понятн: понятно
рекомендац: рекомендации
нагрузк: нагрузками нагрузкой
нативн: нативные
верхнеуровнев: верхнеуровневый
польз: пользу
рассмотрел: рассмотрели
рассмотрен: рассмотренных
стран: странное странно
январ: январе
свет: свете
мо: мо моих моего
консол: консолей консоли консоль
компоновк: компоновке
му: му
сист: систему
свеж: свежие
распредел: распределена
хром: хром
пиш: пишем
проблем: проблемы проблемам проблема
сервер: серверами сервера серверы
поставщик: поставщиками
раздел: разделы
намн: намного
автоматическ: автоматически
маркировк: маркировки
блокировк: блокировки
лучш: лучшие лучших лучшего
механизм: механизм
управля: управлять
борот: бороться
небольш: небольшое
крайн: крайне
возможн: возможности возможное возможного возможность
оп: опыт
интересн: интересно
обещан: обещаний обещания
отображен: отображения
хочет: хочет
перенос: переносилось
крупн: крупные крупных
анрилейтед: анрилейтед
иэн: иэн иэна
страниц: страницы странице
ориентир: ориентирующиеся
поведен: поведение
выступа: выступать
контент: контента контент
диспл: дисплей
изображен: изображения
преимуществен: преимущественно
откр: открыть
миллион: миллиона
справля: справляться
кнопк: кнопки
потер: потери
источник: источники
слуша: слушаем
css: css
ruvd: ruvds
quic: quic
santri: santry
twitter: twitter
promis: promise
jit: jit
slack: slack
action: action
brave: brave
api: api
catch: catch
allsettl: allsettled
coffe: coffee
tileksamiev: tileksamiev
shape: shape
io: ios
ipv: ipv
javascript: javascript
omyhost: omyhosts
node: node
shpankov: shpankov
carbonyl: carbonyl
maco: macos
ponemon: ponemon
browsh: browsh
habr: habr
ispsystem: ispsystem
explor: explorer
globalsign: globalsign
itsumma: itsumma
programmerguru: programmerguru
ru: ru
safari: safari
postscript: postscript
bravesoftwar: bravesoftware
patientzero: patientzero
js: js
requestanimationfram: requestanimationframe
institut: institute
webassembl: webassembly
falkon: falkon
youtub: youtube
rss: rss
web: web
turbofan: turbofan
rko: rko
sportmast: sportmaster
man: manning
dunai: dunai
map: map
connect: connections
alizar: alizar
transmiss: transmission
facebook: facebook
vivaldi: vivaldi
googl: google
ibm: ibm
tl: tl
justjeremi: justjeremy
gbiz: gbiz
kolayandr: kolayandr
quick: quick
data: data
firefox: firefox
lab: lab
microsoft: microsoft
mihailgok: mihailgok
dr: dr
gov: gov
cloud: cloud
technolog: technologies technology
protocol: protocol
wasm: wasm
webpack: webpack
uk: uk
html: html
thenabl: thenable
chrome: chrome
requestidlecallback: requestidlecallback
edg: edge
mozilla: mozilla
vd: vds
vk: vk
http: http https
nzeemin: nzeemin
lake: lake
internet: internet
udp: udp
preview: preview
ignit: ignition
android: android
timeweb: timeweb
admin: admin
piter: piter
mairon: mairon
linux: linux
design: design
await: await
xss: xss
techmeat: techmeat
tcp: tcp
breach: breach
chromium: chromium
avx: avx
cost: cost
race: race
manifest: manifest
telegram: telegram
control: control
async: async
pdf: pdf
sparkplug: sparkplug
ph: ph
window: windows
mark: marks
barakadama: barakadama
