нейрон: нейронная
быва: какими
максимальн: собрать важно
оценк: оценки
говор: начали
влиян: прямом
расскаж: расскажем расскажу
успел: прибыль
найм: найме
стат: стать статье статьи статья
туп: тупых
стар: поддержка
рабоч: типичный
дорог: дорогу
мнен: мнение
предлага: понятия показателя
обзор: периферия
появ: побегом
случа: коем
един: едиными
реализова: средствами
центр: центр
заход: заходите
завис: зависит
работ: начать горжусь
показыва: показывать
практическ: торчинский
дополнительн: помощью
доступ: доступе
вернут: главное
мероприят: данного
предел: выхода
съ: ра
тщательн: деталям
инфраструктур: инфраструктура
вмешива: вмешивается
учебн: учебный
связн: связного
мил: милая
датасет: датасет датасетом датасеты
человек: человека
санкц: санкций
д: д
слома: интернет
менеджмент: менеджмент
л: л
мобильн: мобильных мобильное
тетрад: тетрадей
неприятн: неприятных
должн: должна
пайпер: назов
публикац: разделы
скопирова: скопировать
карт: карты карт
мотоцикл: мотоциклом
многофункциональн: поговорить
подел: поделимся
логическ: тюрьмы
поэт: удалось
координир: внутренних
котор: видеосервис
денег: денег
времен: прогнозирования
мин: мин
вариант: описывается цене
влюб: влюбились
мир: мире
эксперимент: экспериментов
исследован: начинается
этак: этакая
шаг: первые
прад: галерее
репортаж: репортаж
совершен: сканирования
идеальн: тюрьма
прав: правило
связа: загадки
участвова: обо
этап: этап этапа
проверя: проверяют
отмет: отметим
внезапн: внезапно
диск: стких
проект: расходников нативные
связ: систем
появля: появляются
затруднительн: затруднительно
начнет: начнет
заб: изображение
обозрим: поколения
относительн: появились
профил: профиль
дела: интеллектом претензии
шутк: шутка шутке
получ: получили получилось получим получить
ритейлер: ритейлера
перевод: перевод
верс: старую
важн: пультом самых
маркетинг: маркетинг
город: славном
комментиру: выбираем
ритейл: ритейл
рук: телевизором
прост: простой простыми
внутр: внутри
шанс: игре
нно: определ
прям: прямо переоценке
задачк: занимательные
зал: зале
пушкар: пушкарев
индустр: индустрии
занима: занимаемся
тенденц: современные
повышен: участия
уровен: уровень
нов: новые новых
переоценк: говорить
выделя: выделяется
софт: железом
больш: проводит видели
медийн: корпоративный
тинькофф: дима
част: большую продажами
динамическ: построение
алекс: пайпер
карьер: карьера
слов: слов словам слова слово
офис: какое варианты дома
инженер: кейс
направлен: направлений
обезличен: обезличенных
игр: логические поучаствовать номерами
полезн: полезное полезность
системн: рабочий
сдела: сделать производства бывают
определен: определения данной
эффективн: рекомендации задач
видет: видеть
сложн: сложный сложно
демонстрир: наслаждений
обманут: обмануть
извлечен: извлечения
охранник: приходит
капот: капотом
тиндер: тиндере
печат: печати
генерац: нейросети
видел: видео
совет: критериях
примен: применить
денис: денис
жизн: примеры
русск: русский
вперед: забегать
пример: советы хочет
кит: тащит
фигурир: загадке
персонал: персоналом
приставк: смарт элементом
систем: прибыли
выход: группы
лиценз: проприетарную
момент: текущий
шрифт: шрифтами
развива: развивать координирует
основн: классифицируются
продакшен: используйте
микросервис: производительность
расходник: доступности
сожален: последовательности
вышл: вышло
текущ: руках
стких: последовательность
аромапалочк: аромапалочки
классифицир: мероприятия
ресурс: решения
машин: машинном поговорим машинное
метод: использовать
лидер: инженер
процесс: процесс многие
групп: мочной офиса
стероид: нежелательно
решен: вариантов
нных: нных
актуальн: тема
провод: пользователь
средн: средний продаже
личн: пульт
комфортн: максимально
продолжа: советуем
нужн: компаниях
разметк: разметкой
помест: поместилась
номер: пустых
влюбл: влюбл
подряд: подряд
хаб: хабы
приготовьт: рассмотрим
рынк: управления исследования
вочкин: вочкин
телевизор: пульты часть
выбира: проектируем
помощ: решать каждому
современ: определение
немал: немалая
приложен: приложение приложений корпоративных
магн: китая
разработчик: разработчик разработчика
результат: дополнительного
красив: красивых
опыт: личному опыта
склад: похож
заключ: двое
дад: нужны
выигра: шанс
настройк: дзен
дал: далее
интегрирова: интегрировать
генеративн: большое
текст: текстов текст текста
показател: использование
пониман: понимание
последовательн: необходимую нной
документ: авторов
прочтен: прочтение
предложен: предложения
будущ: обозримом
ссылк: ссылку
мадрид: городе
тусовщиц: тусовщица
перестанут: делать
переведут: перестанут
повестк: остается
средств: стандартными
свобод: выиграть
дан: данных обмена тенденции жить
дат: дата
установ: мощности
картинк: склад
пульт: приставки воспринимают первого иным лучших
плох: плохо
код: продакшн
росс: россии
модул: модулей
найдет: дня
задумыва: данность
регистрац: войти
освобожден: стратегию
нежелательн: крайне
ситуац: ситуация
пояснен: пояснения
генератор: генератор
виноват: виноват
камер: находятся камере
привяза: привязанными
авит: кострыкина
донат: донаты
цен: адекватной
построен: игра
бунин: олега
сообща: охранник
доступн: краткий стоимости технологии
кажд: доступными буквально каждого
возника: возникают
возраст: возраст
галер: наверняка
дво: фигурируют
дзен: мегапроекты
глобальн: глобальная
остров: островов
множеств: множество
любовн: любовное
создава: изучили
искусствен: работаем искусственный
ошибк: ошибки
идут: процессы
жив: вернуться
обнов: обновить
настроен: настроение
разработк: разработкой разработка разработки
закладк: закладки
частност: частности
довод: микросервисы исправляем
детекц: детекция детекцией детекции
прибыл: конечную
использова: пойдет
перифер: компаний
мфу: сломаться
продакшн: типов
желез: компанией железе
занимательн: поехали
стратег: предлагаем продумать задаче
поколен: второго
прыга: прыгает
примерн: примерно
поучаствова: возможность
сюд: развивает
девушек: девушек
хейт: хейт
настоя: настоящее
гарантир: прогноза
зрелищ: завораживающее
белоснежн: решили
преимуществ: преимущества
список: список
цит: цит
загадк: сегодняшней освобождения
след: следующего
совпаден: совпадениях
строк: строка
дел: дело деле первым
вопрос: вопросы вопрос вопросами вопросов
тащ: белоснежной
дизайн: дизайн
производительн: высокая
славн: доводилось
жит: хакатона
внутрен: похоже менеджер
устройств: печатающие информация
текстов: превращать
хакер: хакер
коротк: хакатоны
проход: проходит проходить
так: таких
ответ: ответ
никт: никто
картин: прада
поменя: поменялась
собствен: помощи
техническ: настройка технических
торчинск: евгений
уда: реализовать
фев: фев
материал: предыдущим
симпатичн: симпатичная
мегапроект: стартапам
описыва: зависимостей
хабр: хабр
угл: углом
обучен: обучения обучение
некотор: некоторые
рассмотр: области
количеств: количество
соглашен: документы
режисс: кресло
даунгрейд: даунгрейда
рекрутер: рекрутер
добав: добавить
просмотр: просмотров
ряд: ряд временных
сад: босха
нанима: нанимающих
синтетическ: синтетической
месяц: месяцев
досрочн: досрочно
зна: опыту
услов: коммуникациям
сам: дорабатывали
сканирован: магнит
интеллект: интеллект искусственным
друг: любого друг друга другу
мочн: съ
стартап: программы
туториа: туториал
инач: иначе
приход: камеру
дим: рядов
школьн: школьных
наслажден: земных
рендеринг: рендеринг
запущ: момент
спонсирова: спонсировать
менеджер: менеджеров чемпионов
платформен: кросс
компан: руковожу сообществ компании группа
программ: программах образовательные
ограничен: условиях
прирост: прирост
управлен: управление пультов
коммуникац: эффективным
точност: повышение
получа: получал
проектиру: тщательно
главн: победить
компьютерщик: компьютерщика
глубин: приключению
распознаван: распознавания распознаванием
представл: представлен
обеспечива: обеспечивать
руковож: технологиями
элемент: важных
начина: другого
привет: привет
кострыкин: олеся
рубеж: рубежа
прогноз: точности
единообраз: единообразие
ускор: ускорить
использ: использует случае
област: шаги
кросс: приставками
горж: которыми
изуч: набор
сво: создавали своим
веб: веб
интерпретирова: интерпретировать
кейс: успешный
присажива: компонента
программирован: продакшене
влюблен: влюбленных
прилета: прилетал
нача: части компьютером установить берут
реша: пришлось
даст: даст
порог: порог
гк: блоги
попробу: попробуем
интернет: лицензию
полигон: полигонов
хранен: хранение
испанщин: мадриде
хечум: николай
появлен: появление
тем: устройства
пришл: поэтому
полн: полной
уделя: работе
администрирован: администрирование
развит: развития
пользовательск: пользовательского
представ: представить
сайт: устройство сайтов
агностическ: агностический
изгиба: изгибаться
научпоп: научпоп
технолог: работаю сделал
комментар: комментарии
праздн: празднует
задач: задачи метафора тинькофф
мелоч: каждую
подпал: подпалим
рамк: рамках
проприетарн: переведут
пользова: удобно
метафор: идеальная
поеха: присаживайтесь
нейросет: стратегией генеративных нейросеть
трет: выйдет
компьютер: компьютеры любимым
сильн: сильный
работа: работать работал практически софтом
детал: внимания
заворажива: написанное
песочниц: публикации песочницы
выбежа: выбежали
сегодняшн: игры
услуг: конфиденциальность
видеосервис: платформенный
кандидат: кандидат кандидата кандидатов
блог: блога сюда блог
необходим: использования
фреймворк: фреймворк фреймворкам фреймворков
накладыва: накладываются
зовут: зовут
истор: истории
бессмыслен: бессмысленных
интерфейс: интерфейса
скрипт: скрипты
праздник: праздник
модел: моделей модель моделью модели
сложност: сложности сложность
ещ: ещ
ирокез: ирокезом
вниман: уделяем
исправля: комментируем
сел: сел
комнат: пределы
автор: авторы автор сайта автором авторам автора
чита: читать
сет: сеть
вид: теории
конфиденциальн: соглашение
виде: генерации
превраща: способных глубины
чтен: чтение чтения
информатик: начало
приключен: приготовьтесь
сбермаркет: сбермаркет
доход: доходит
дойт: дойти
теор: дадим
естествен: обработки
оста: точно остаемся
быстр: быстрого быстро
обеща: обещают
типичн: демонстрирует
наук: наук
влия: влияет
хот: обзор
тип: метод
воспринима: знаю
объединен: объединение объединении
бумаг: проблемы актуальная
неоднократн: разрабатывали
рейтинг: рейтинга дисков
статическ: статических
дол: доля
дом: идут
реч: программирование
отрасл: отраслей
реш: стране
способн: нейросетей
олег: конференции
общ: общем
сторон: стороне
босх: картину
поток: потоки
кратк: найдете кратко
сид: сидит
поддержк: техническая поддержки
любов: любовь
состо: состоит
данност: приставок
набор: неполный
берут: относительно
рукописн: рукописного
тысяч: тысячи
включ: включая
дня: повестке
рукописк: рукопиской
претенз: ним
профессиональн: профессиональный
стоимост: информацию
обм: ограниченного
повод: повода
библиотек: библиотеки библиотека библиотек библиотекам библиотеке
пуст: одинаковых
удобн: удобного насколько
любим: комнаты
сред: среди
прогнозирован: стратегии
предыдущ: ознакомиться
наш: бумагой наших
ин: пользоваться
ит: ит
мног: бумаги
пользовател: комфортным
люб: любим любит любой пульта
зависим: динамических
успешн: жизни
хостинг: хостинг
плат: платит
компонент: компонентов собственного
язык: языкам естественного
фон: фонах
наз: заключ
сил: авито
биометрическ: биометрическую
сопряж: рассматривать
разрабатыва: мелочь
фактор: факторов
регулярн: регулярно
евген: гаджеты
информац: работу песочница
совмест: совместить
правд: правды
земн: сад
разн: разные
продакш: архитектора
письм: письмо
ключев: ключевых
выгляд: выглядит
хакатон: рейтинг живым
соседн: выводить
люд: пользой
дневник: дневник
отвеча: отвечать
приставок: телевизоров
английск: английском
использу: используя
пакет: пакета пакетов пакет
нюанс: нюансах нюансы
конкретн: конкретной
предъявля: предъявляют
добавлен: добавлением
интерв: интервью
критер: видах
зачаст: зачастую
понят: основные
равнодушн: равнодушны
сбер: сбер
ко: зрелище
обработк: обработка машинного
поговор: хотим ретроспектива
создан: создания
собра: постарались
вывод: одному
производств: проекта
знает: знаете
например: например
постара: делом
одн: одна свободу
продаж: доступных продуктом
правил: правилам
никола: сообществом
реклам: медийная
онтик: бунина
дтп: дтп
приб: гарантирует
корпоративн: услуги стероидах
рекомендац: предлагаются
нативн: реклама
одинаков: соседнюю
идеа: доводим
совету: материалом
сми: сми
огромн: огромное
команд: команда участвовать
произвест: произвести
плюс: плюс
ознаком: успели
сообществ: внутренние людей сила
польз: сообщества
дорабатыва: неоднократно
архитектор: системного
субъективн: субъективность
мощност: средней
врод: вроде
рукоп: рукопись
уникальн: уникальна
стран: нашей странным странные странных
участ: эффективного
использован: результате сопряжено
побед: команду
запрос: текстовые запрос
побег: задачки связанные
пьян: пьяные
сист: систему свой
кресл: примерить
войт: аккаунт
качеств: качества
конечн: влиянии
аккаунт: ланит
выбор: выборы
лан: гк
наскольк: задумывается
разочарова: разочарованы
пирсинг: пирсингом
порядк: вперед
пиш: пиши
проблем: проблема учитывая
подробн: подробно
печата: многофункциональные
сервер: сервера
раздел: регистрация
половин: половина
похож: продакшена офис
пишет: пишет
продума: алекс
яндекс: яндекс
об: коротко
новост: новости
печатн: печатного
лучш: сделали лучшие
существ: максимальное
перв: порядку начал рынка
небольш: небольшая
формат: формата
проведен: проведения
ол: хечумов
написа: написать написала превращает
пойдет: речь
крайн: коде
поиск: поиск
интересн: интересно интересные
возможн: возможности сообщает
чемпион: лидер
основ: основе
американск: американские
коробк: данными
открыт: открытом
привыкл: привыкли
буквальн: идеала
учитыв: офисе
выйдет: будущем
образовательн: проекты
хочет: забыли
как: какие существующих языка
определ: ресурсов
крупн: крупного
неполн: картинке
голос: голосов
крут: крутятся
дмитр: дмитрий
смарт: делаем
страниц: страницы страниц странице
адекватн: мфу
кат: катом
меша: мешают
рокерш: рокерша
пайплайн: пайплайне пайплайн
рассматрива: продолжаем
встреча: встречается
взгляд: взгляд
тюрьм: тюрьму информатике побег
освобод: освободили
высок: онтико
копа: копаться
гаджет: рынке
втор: запущен
архитектур: архитектуры
точн: совершенно
забега: третье
наверняк: испанщине
изображен: изображений запросы
воспользова: воспользоваться
ра: режисс
сфер: сфере
стандартн: сожалению
откр: открыть
синтетик: синтетики
революц: революцию
наход: коробки
ретроспектив: связи
продукт: системы
пропада: пропадает
конференц: приложениях
непонятн: непонятным
big: big
sourc: source
depend: depends
ruvd: ruvds
rikki: rikki
ssg: ssg
devop: devops
followmyutopia: followmyutopia
sber: sber
react: react
befuddl: befuddle
hr: hr
hei: hey
polkovnikovnikita: polkovnikovnikita
avitotech: avitotech
pico: pico
twitter: twitter
ssr: ssr
dev: dev
text: text
api: api
ntoskernel: ntoskernel
axenix: axenix
python: python
freehabr: freehabr
zloirock: zloirock
ai: ai
imagen: imagen
voximpl: voximplant
secur: security
javascript: javascript
otu: otus
xcom: xcom
alex: alex
nativ: native
nikuson: nikuson
habr: habr
firstvd: firstvds
sly: sly
south: south
js: js
deadfost: deadfoster
youtub: youtube
sleep: sleep
result: result
raspberri: raspberry
rss: rss
michazaxm: michazaxm
vite: vite
southbridg: southbridge
evgeniitorchinskii: evgeniitorchinskii
sbermarket: sbermarket
erp: erp
facebook: facebook
geekman: geekman
handwritten: handwritten
face: face
nlp: nlp
googl: google
movix: movix
open: open
fnow: fnow
redux: redux
data: data
ixceller: ixcellerate
vue: vue
moscow: moscow
lab: lab
etna: etna
reactj: reactjs
unwrap: unwrap
deploy: deployment
cloud: cloud
itglob: itglobal
tech: tech
automl: automl
selectel: selectel
rail: rails
friflex: friflex
heart: hearts
downtim: downtime
core: core
flutter: flutter
servic: service
astro: astro
vk: vk
terraform: terraform
shop: shop
maxrokatanski: maxrokatansky
timeweb: timeweb
futter: futter
phenaki: phenaki
video: video
head: heads
rust: rust
gan: gan
olegbunin: olegbunin
mesh: mesh
tikki: tikki
svelt: svelte
recognit: recognition
htr: htr
telegram: telegram
accentur: accenture
pimenov: pimenov
pi: pi
hug: hugging
time: time
tinkoff: tinkoff
rubi: ruby
