обрат: обратите
быва: бывают
найт: найти
независим: независимыми независимых
значен: значение
образ: образом
стат: стать статье
экспорт: экспортам экспорты
бандл: бандла бандлов
стар: старую
найд: найден
указан: указания
случа: случае случаях
един: единый
работ: работа работы
завис: зависит
показыва: показывают
дополнительн: дополнительно дополнительных
сценар: сценариев
доступ: доступа
домен: доменах
вернут: вернуться
чанк: чанков чанку чанки чанк
экспортир: экспортирует экспортируется
получен: получения
конфликт: конфликта
сто: стоит
менеджмент: менеджмент
устраня: устраняет
вкратц: вкратце
должн: должны должна
структур: структуре
публикац: публикации
дава: давайте
означа: означает
скачива: скачиваемых
разбива: разбивает
отправ: отправить
поэт: поэтому
взаимосвяза: взаимосвязанных
котор: которое которыми
карм: карма
мин: мин
изображ: изображено
ум: умом
связа: связаны
проверя: проверяет проверяться
либ: либо
проект: проекте проекты проект проекта проектами
совместн: совместное совместно совместного
появля: появляется
относительн: относительный относительно
упроща: упрощает
профил: профиль
дела: делает делается
столкнут: столкнуться
получ: получится
вложен: вложенные вложенная вложенной
хост: хост
верс: версии версий версией версию версия
подводн: подводных
маркетинг: маркетинг
списк: списке
недоступ: недоступен
внутр: внутри
прост: простой простым
вебпак: вебпак вебпака
позвол: позволить позволит
занима: заниматься
уровен: уровень
нов: новую
больш: большое
медийн: медийная
част: части частей
файлов: файловой
иде: идея
ждат: ждать
динамическ: динамическая динамически динамические динамическим
полезн: полезно
сдела: сделано
эффективн: эффективность эффективнее эффективно
сложн: сложно
камн: камней
генерац: генерации
пут: пути путь
пример: примеры примере пример
инициализац: инициализации
мож: можем
переписыва: переписывать
микросервис: микросервисов
основн: основным
разбиен: разбиения разбиение
ресурс: ресурсами ресурсы
процесс: процессе
групп: группу
скрыва: скрывается
перемен: переменную
привест: привести
приведет: приведет
требован: требованию
решен: решение решения
постепен: постепенно
написан: написание написания
размест: разместить
комментирова: комментировать
средн: средний
нужн: нужны
помога: помогает
хаб: хабы
приложен: приложение приложении приложениях приложений приложением приложениями приложению приложения
выполня: выполнялось
разработчик: разработчик
попытк: попытки
ваканс: вакансии вакансий
настройк: настройка
дал: далее
документ: документы
прочтен: прочтение
корректн: корректно
идентификатор: идентификаторы
затащ: затащить
лов: ловим
заманчив: заманчиво
хостов: хостовым хостовому хостовое хостовом хостового хостовой
масштабируем: масштабируемость масштабируемую
дан: данными данные данной данная
имен: именем имени именах
указа: указали указать указан указанных
минимальн: минимальную
разделя: разделять
связыва: связывать
наслуша: наслушавшись
плох: плохо
код: код кода коде
модул: модулей модулями модулю модуля модуль модули модулях
регистрац: регистрация
коп: копия
убед: убедиться
усложн: усложнят
ситуац: ситуации ситуациях
каза: казался
отсутств: отсутствует
функц: функция функциями функцию функции
упрост: упростить
отказа: отказаться
загрузк: загрузку загрузка загрузки загрузке
цел: целом
инициализирова: инициализировано инициализировать
изуча: изучался
доступн: доступна
кажд: каждого
возника: возникать возникает возникают
настро: настроить
дзен: дзен
сохран: сохранить
глобальн: глобальной глобальную
вмест: вместе
отличн: отличный
ошибк: ошибкой ошибкам ошибками ошибка
синтаксис: синтаксис
кажущ: кажущейся
обнов: обновить
объект: объект
разработк: разработку разработка разработки
серьезн: серьезность
закладк: закладки
использова: использовать использоваться использована
хеш: хешей хеш хешах хеши
запрашива: запрашивает
загружа: загружаем загружаться загружает загружать загружаемых
установл: установлено
вычисл: вычислены
установк: установка
добавля: добавляется
гарантир: гарантирует
список: список
импорт: импорта импортом
сказа: сказано
выдел: выделены
произошл: произошла
минут: минут
след: следующем следует следующее
вопрос: вопрос
дизайн: дизайн
рассказа: рассказано
производительн: производительность
помим: помимо
заверш: завершится
устройств: устройство
размер: размер размера
переход: переходе
ваш: вашего
так: такую таких таким
ответ: ответ
генерир: генерирует
аннотац: аннотация
полност: полностью
техническ: техническая
уменьша: уменьшает
алгоритм: алгоритм
мегапроект: мегапроекты
хабр: хабр
некотор: некоторые некоторых
иска: искать
конфиг: конфиге конфигов конфиги конфига конфиг
количеств: количество
введен: введение
соглашен: соглашение
полез: полезен
добав: добавить
просмотр: просмотров
последн: последнее
месяц: месяцев
конфигурац: конфигурациях конфигурации конфигурацию
услов: условий
сам: самое самая
друг: другом другими друг друга другого
сутк: сутки
стартап: стартапам
возвраща: возвращает
запущ: запущены
посмотр: посмотрим
компан: компаний компании компания
выполнен: выполнения
программ: программы
получа: получаем получается
влож: вложены
разбира: разбираться
действ: действия
соответствен: соответственно
заключа: заключается
состоян: состояние
вс: вс
популярн: популярная
ускор: ускорить
начн: начнем
использ: используется использует используют
простот: простотой простоты
раз: раза
созда: создает создается создать
плагин: плагин плагином
сво: свой
веб: веб
взаимодействова: взаимодействовать
отдельн: отдельный
выполн: выполнен
предоставля: предоставлять предоставляемый
тег: теги
явля: является
тем: тему
полн: полного
администрирован: администрирование
пользовательск: пользовательские
сайт: сайта сайтов
определя: определяет
знал: знал
научпоп: научпоп
технолог: технологию технология технологии
файл: файл файлу
происход: происходит
комментар: комментарии
адрес: адрес
работа: работать
песочниц: песочницы песочница
долж: должен
блок: блоке
перем: перемен
услуг: услуги
уменьш: уменьшить
необходим: необходимо необходимости необходимый необходимы
блог: блог
плоск: плоская плоской
прод: прода
истор: истории
интерфейс: интерфейс
требуем: требуемой
пробл: проблем проблему
сложност: сложности
ещ: ещ
параметр: параметров параметром параметра параметр
вниман: внимание
автор: авторы авторов автором
очеред: очередь
легк: легко
конфиденциальн: конфиденциальность
локальн: локальных локальную
нигд: нигде
обменива: обмениваться
подход: подходите
явн: явного
необход: необходим
нескольк: несколькими нескольких
заключен: заключение
принима: принимается
разда: раздать
хот: хотите
позволя: позволяет
внедрен: внедрение
рейтинг: рейтинг
альтернативн: альтернативный альтернативное
синхронизирова: синхронизировать
реш: решила решить
общ: общего общие общих общими общему общий
поток: потоки
указыва: указывается указываются указываем указывать
перечисл: перечислены
поддержк: поддержка
совпада: совпадают
поддержива: поддерживается
включ: включены
библиотек: библиотеки библиотек библиотека библиотеками
обо: обоих
им: имен
наш: нашего
ин: иного
улучш: улучшить
может: можете
пользовател: пользователя пользователь пользователю
мног: многих
люб: любой
зависим: зависимость зависимости зависимостях зависимостей
успешн: успешной
компонент: компонент компонентов компоненты компонентом
избежа: избежать
язык: языка
останов: остановимся
публичн: публичный
сервис: сервисами
информац: информация
фронтенд: фронтенд
продакш: продакшен
разн: разными разных
выгляд: выглядит
удален: удаленной удаленного удаленное удаленных удаленные
содержим: содержимого
использу: используя используем
пакет: пакетов пакета
дочерн: дочернего дочерних дочерние дочерними дочернее дочерним дочернем
конкретн: конкретного
сборк: сборке сборками сборку
запис: записи
привод: приводит
знает: знает
запута: запутаться
например: например
одн: одна одну одним
отправля: отправляет
самостоятельн: самостоятельно
увеличен: увеличению
реклам: реклама
импортирова: импортировать
корпоративн: корпоративный
соответств: соответствующим соответствует
нативн: нативные
одинаков: одинаковый
инструмент: инструмент
доклад: докладов доклады
огромн: огромное
команд: команда
импортир: импортирует
объединя: объединять
использован: использование использования использовании использованием
запрос: запрос
смотрел: смотрели
войт: войти
аккаунт: аккаунт
разделен: разделение
сраз: сразу
проблем: проблемы проблема
подробн: подробнее
сервер: сервере серверах
раздел: разделить разделы
поставщик: поставщика
автоматическ: автоматическое автоматически
похож: похожие
яндекс: яндекс
новост: новости
существ: существующими
лучш: лучшие
перв: первого
формат: формате
коллиз: коллизий коллизии
корн: корня
написа: написаны
пойдет: пойдет
поиск: поиска поиск
возможн: возможным возможно
переписыван: переписыванием
основ: основе
ленив: ленивый
микросервисн: микросервисная микросервисную
сборщик: сборщиках
образовательн: образовательные
хочет: хочется
как: какую каких какие каким
определ: определили определены определен определиться
голос: голосов
страниц: странице
взгляд: взгляд
загруж: загружена загружая загружен загружены
загруз: загрузить загрузиться загрузилось
поведен: поведение
стабильн: стабильные
кроет: кроется
архитектур: архитектуре архитектуру архитектуры архитектура
воспользова: воспользоваться
дублирован: дублирования
пада: падало
откр: открыть
способ: способов
форм: форме
насмотревш: насмотревшись
браузер: браузере
источник: источника источник
modulefederationplugin: modulefederationplugin
uniquenam: uniquename
import: import
eager: eager
strictvers: strictversion
depend: dependency
optim: optimization
remot: remote
js: js
react: react
bootstrap: bootstrap
reactj: reactjs
youtub: youtube
button: button
twitter: twitter
webpack: webpack
web: web
lazi: lazy
host: host
markdown: markdown
mf: mf
html: html
share: shared
remoteentri: remoteentry
hashedmoduleidsplugin: hashedmoduleidsplugin
catch: catch
publicpath: publicpath
boumrz: boumrz
singleton: singleton
entri: entry
contain: container
nginx: nginx
facebook: facebook
telegram: telegram
modul: module
cdn: cdn
javascript: javascript
url: url
requiredvers: requiredversion
vk: vk
vitej: vitejs
true: true
http: https
habr: habr
fallback: fallback
feder: federation
