говор: говорят говорить
кассир: кассиры
банк: банк
понима: понимаю
расскаж: расскажем расскажу
значен: значение значениями значениям значения значениях значений
стат: стать статью статье статьи статей статья
стар: старую старый
рабоч: рабочее
стал: стали стало
мнен: мнение мнению
объясн: объяснить
став: ставить
реализова: реализовать
работ: работа работе работы работ работах
центр: центре
показыва: показывать
сценар: сценарием
касс: касс
пол: поле
сто: стоит
человек: человека человеком
ти: ти
специализирова: специализированной
менеджмент: менеджмент
экра: экранной
разговор: разговоры
тр: тр
мобильн: мобильное
присутств: присутствует
должн: должны
снижен: снижения
структур: структура структуру структур
публикац: публикации
скопирова: скопировать
подел: поделиться
котор: которую которому которым
денег: денег
провест: провести
пор: порой
моделирован: моделированию
эксперимент: эксперимент эксперимента
реферирован: реферирование реферирования
шаг: шаг
железнодорожн: железнодорожных
прав: правило правил правила
аудиозапис: аудиозаписи
обратн: обратно
уч: учил учимся
либ: либо
проект: проекты проектов проекта
связ: связи
профил: профиль
сут: сути
голосов: голосовые голосовых
кодировк: кодировке
читальн: читальный
верс: версию
маркетинг: маркетинг
обознача: обозначают обозначаться обозначаются
прост: простая простой простую простых простые
трафик: трафика трафике
ауд: аудио
позвол: позволит
зал: зал
справ: справились справиться
занима: занимаются занимаюсь
постро: построен
профессионал: профессионалы
встрет: встретить
уровен: уровень
очевидн: очевидно
нов: новые новое новая
убежд: убеждено
медийн: медийная
отражен: отражение
монетизац: монетизация
цифров: цифровых
традицион: традиционно
слов: слов слове словом словами слова слово
осво: освоить
завод: заводится
выжимк: выжимки
постоя: постоянными
сдела: сделать сделали
определен: определения определенной определению определение определений определенных
отзыв: отзывов
особен: особенности
сложн: сложным сложных сложно сложный сложная
демонстрир: демонстрируются
иерархическ: иерархических
примен: применить
пут: пути путь путем
речев: речевой
пример: примерах примере пример
русск: русский
расчет: расчет
систем: системы система системах системами
выход: выходе
класс: классы класс
узна: узнать
невероятн: невероятно
выз: вызов
труд: труд
нема: немало
читател: читателями
ресурс: ресурсов ресурсы
машин: машинное машинного
метод: методы методам методов
процесс: процесс
свойств: свойством свойство свойств свойства
приведен: приведенные
родченк: родченков
написан: написанием
нным: нными
продолжа: продолжаем
подряд: подряд
бесплатн: бесплатное
вып: выпить
рынк: рынку
продвижен: продвижением продвижения
нрав: нравится
современ: современных современное
помощ: помощью помощь
приложен: приложениями приложение приложении приложений
разработчик: разработчики
округля: округляют
салют: салют
декодер: декодере
вклад: вклад
метада: метаданных
текст: тексте текст тексты текстов текста
универсальн: универсальным универсальное
будущ: будущего
продовольствен: продовольственных
оплачива: оплачиваться
биграмм: биграммах биграммы
интерес: интересующимся
конкуренц: конкуренция
штраф: штраф
сравнен: сравнению
идентификац: идентификацию
эрзянск: эрзянский эрзянского
стихотворен: стихотворения
заявок: заявок
анализатор: анализатор
регистрац: регистрация
убед: убедить
ситуац: ситуация
счита: считаем считаю считать
причин: причина причине
конкурент: конкурентов
цел: целая цель целые цели
поминутн: поминутную
дзен: дзен
канал: каналам
множеств: множества
создава: создавать
коммерческ: коммерческим
искусствен: искусственный искусственных искусственной
замеря: замеряем
спор: споры
онтологическ: онтологическое онтологическая
налич: наличие
частност: частности
удочк: удочку
использова: использовать использовались
логик: логику логики
уточня: уточнял
примерн: примерно
сюд: сюда
професс: профессии
коробочн: коробочное
список: список
комисс: комиссию
знаком: знакома
терминолог: терминология
тематик: тематику
выдел: выделить
след: следующем следует следующим
микрофон: микрофонов
знаков: знаковое
концепт: концептов
дизайн: дизайн
концепц: концепция
попыта: попытаюсь
попробова: попробовал
клиент: клиента клиент
коротк: коротких
переосмыслива: переосмысливается
распростра: распростран
так: такую такими таком таких таким
событ: событие событий событии
баз: базе
техническ: техническая
условн: условно
фев: фев
заметн: заметно
триграмм: триграммы триграммах
головн: головной
символ: символов
собира: собирал
описыва: описывающими описывающих описывать
аналитик: аналитикой аналитика
противопоставля: противопоставляется
обсуд: обсудить
некотор: некоторое некоторой некоторыми некоторых
обуча: обучал
количеств: количество количества
такс: такси
чистот: чистоты
соглашен: соглашение
диалог: диалог
добав: добавить
просмотр: просмотров
содержан: содержанию
специальн: специальных
услов: условиям условии
объем: объеме
интеллект: интеллект
стро: строит строить
представля: представляют
друг: другим друг друга другу
юнистар: юнистар
диспетчер: диспетчеры
приход: приходят
правильн: правильное правильным
сбор: сбора
поня: поняли
компан: компаний компании
ограничен: ограничений ограниченное
программ: программ программы
коммуникац: коммуникации
получа: получается
действ: действия
главн: главное
россельхозбанк: россельхозбанк
элемент: элементы
рац: рации
привет: привет
рад: радио
использ: используют
имеют: имеют
созда: созданных создать
фин: финно
имеющ: имеющимся имеющем
кейс: кейсом кейса кейс кейсов
тезаурус: тезаурус
распознава: распознавать
отдельн: отдельно отдельный
интернет: интернет интернете
предоставля: предоставляем
включен: включение
событийн: событийными событийной событийного событийные событийная
применя: применяемой применять
официальн: официальных
пришл: пришлось
полн: полной полно
администрирован: администрирование
легенд: легенд
субъектн: субъектно
переговарива: переговариваться
знан: знаний знаниями
знак: знаков
комментар: комментарии
отрыт: отрытый
компьютер: компьютера
работа: работают работающая работает работаю
сильн: сильной сильных
песочниц: песочницы песочница
подсказк: подсказками
долж: должен
блок: блок
услуг: услуги
оставля: оставляет
инициац: инициации
блог: блог
необходим: необходимо
интерфейс: интерфейсы
чист: чистую
модел: моделях моделей модель моделью модели моделями
шум: шумах
сложност: сложности сложность
вниман: внимание внимания
привед: приведен
автор: авторы авторов автором
очеред: очередь
чита: читать читай
подход: подходов подхода подход подходами
положен: положения
самур: самурая
фрукт: фрукты
эксперт: эксперты экспертов
бизнес: бизнес
тип: типов
воспринима: воспринимаемые
характеристик: характеристик
реч: речи речь
реш: решил решили
отрасл: отрасли
общ: общем
объ: объ
специфическ: специфических
поддержива: поддерживать
релятивн: релятивным
обм: обмен
грамм: граммы
унификац: унификацию
мног: многим многие
наблюда: наблюдаем
люб: любые
сущност: сущности сущностей
стих: стихов стихи
язык: языков язык языка языки языке
фон: фоне
содержа: содержащихся содержащие
стил: стиле
взят: взятый
формулир: формулируется
распозна: распознать распознающая
машинист: машинисты
правд: правда
взаимосвяз: взаимосвязь
гот: готов
разн: разными разное разная разных разные
неожидан: неожиданностями
люд: людей
создав: создавая
выявлен: выявления
оперирован: оперирования
отвеча: отвечала
год: годах
использу: используем
таймер: таймер
конкретн: конкретных конкретный
зачаст: зачастую
неизбежн: неизбежному
произн: произнося
сбер: сбер
создан: создания создание
особ: особые
вывод: вывод
облак: облако облаке
искусн: искусных
сахар: сахар
запис: записи записях записей
философск: философской
нейросетев: нейросетевой
знает: знаете
одн: одно одним
прин: принят
широк: широкое
согласн: согласно
знаеш: знаешь
реклам: реклама рекламу
разбер: разберем разберемся
корпоративн: корпоративный
помощник: помощников
команд: команды команде
ознаком: ознакомиться
диджита: диджитал
уникальн: уникальную
электрон: электронной
десятк: десятки
смотрет: смотреть
использован: использование использования
платформ: платформе
овощ: овощи
запрос: запросы запрос запросам
войт: войти
нечт: нечто
аккаунт: аккаунт
марк: марки
генерируем: генерируемые
деятельн: деятельности деятельность
сраз: сразу
порядк: порядку
поступа: поступающих
бот: ботов
упомина: упоминают
похож: похожие
жела: желать
яндекс: яндекса яндекс
новост: новости
существ: существует
перв: первую первых первого первое
бол: боли боль
энкодер: энкодере
написа: написал написанного
поиск: поиск
заказчик: заказчика
запомн: запомнить
основ: основе
модельн: модельное
образовательн: образовательные
как: каком какими какие
определ: определиться определить
голос: голосов
матер: материи
топлив: топлива
кат: катом
субстанциональн: субстанциональным
переговор: переговоров переговоры
прошл: прошлых
амулет: амулетов
реальн: реальное реально реального реальный
втор: вторых
рол: роль
точн: точно
риск: риска
сфер: сфера сфере
установлен: установления
отраслев: отраслевой
способ: способ
форм: форме формы
мер: мера мерой мере
продукц: продукцию
продукт: продуктов
компьютерн: компьютерных
признак: признаков
напоминан: напоминаниями
обрат: обратить
нейрон: нейронной нейронную нейронных
акцентирова: акцентировать
максимальн: максимально
преобразован: преобразование
провер: проверено
перевоз: перевозят
информацион: информационных
занят: занятости
образ: образом
независим: независимыми
ввод: вводится
конц: конца
предлага: предлагают
окт: окт
соглас: согласились
рекламщик: рекламщиков
обзор: обзоров обзор
случа: случае
появ: появился
практическ: практического
доступ: доступ
вернут: вернуться
парадигм: парадигма
бесконечн: бесконечные
тарификац: тарификацию тарификации
переплачива: переплачиваете
контур: контур
комбинат: комбинат комбината
александр: александр
вершин: вершинами
громкост: громкость
янв: янв
словар: словарей
вектор: вектор
единствен: единственно
проглатыва: проглатывает
н: н
п: п
поезд: поезда
дава: давайте
скромн: скромного
х: х
сообщ: сообщу
поэт: поэтому
мин: мин
прописа: прописанным
отнест: отнести
мир: мире
предприят: предприятиям
миф: миф мифов
знают: знают
этап: этап
подписыва: подписывать
научен: научение
металлургическ: металлургический
говоря: говорящих
фокусирова: фокусировать
тренд: тренд тренды
столкнут: столкнуться
аналог: аналог
оправда: оправданно
получ: получили получилось получить
перевод: перевода переводить
несущ: несущий
важн: важно
онегин: онегина
экономическ: экономически
час: час
организован: организованности
столкнул: столкнулись
чат: чат
заодн: заодно
индустр: индустрии
дешевл: дешевле
выделя: выделяют
больш: больших большим большую большой большого большом
ответн: ответных ответные ответной
мест: место
карьер: карьера
длительн: длительность
направлен: направления направлениями
модифицирова: модифицировать
попаст: попасться
граф: графа графом
существен: существенно
смогл: смогло
пробова: пробовать
представлен: представление представленные представленных
генерац: генерации
деятел: деятели
населен: населения
формальн: формальным
пыта: пытаются пытается
переводчик: переводчик
сотн: сотни сотню
мом: мом
исполня: исполнять
принципиальн: принципиально
основн: основным основные основной основном
бренд: бренды
сможет: сможет
математик: математика
сознан: сознание сознания
подготов: подготовиться
потороп: поторопились
решен: решению решение решении решения
закупк: закупки
передава: передаваемый передавать
средн: средний средняя
нужн: нужна нужны
предметн: предметной предметное предметных
избежан: избежание
далек: далеких
хаб: хабы
описан: описанию описание описания
вылож: выложить
сжат: сжатый сжатые
ребр: ребрами
выбира: выбираете выбираем
эмбединг: эмбединга
выполня: выполняется выполнять выполняет
результат: результат результаты
вызыва: вызывать
введ: введены
настройк: настройка
дал: далее
онтолог: онтология онтологии онтологией онтологию
контекст: контексте
пониман: понимания
документ: документы документов
прочтен: прочтение
предложен: предложения
ссылк: ссылку
выросл: выросло
ключ: ключи
безлик: безликими
угорск: угорской
имет: иметься
дан: данных данные данными данной данным данном
сходств: сходства сходство
дат: дать
джет: джет
установ: установить
код: кода
поручен: поручений
ссылок: ссылок
соединен: соединения
деньг: деньги
брат: брать
построен: построения построенную
бложик: бложика
доступн: доступных
звук: звуки
возника: возникает
коф: кофе
оболочк: оболочку
вмест: вместо
финансов: финансовых
натяжк: натяжкой
интеллектуальн: интеллектуальной
синтаксис: синтаксису синтаксис
обнов: обновить
име: имеем
объект: объектов объекты
разработк: разработкой разработке разработка разработки
закладк: закладки
фрагмент: фрагмент
начал: начале
пушкин: пушкин
экспертн: экспертная экспертными
метрик: метрику
учитыва: учитывать
ориентирова: ориентированных ориентированные
итог: итоге
вездесущ: вездесущая
обеспеч: обеспечит
минут: минут
многогра: многогранным
слышн: слышны
дек: дек
дел: дело деле
объявля: объявляет
дем: демо
ближайш: ближайших
вопрос: вопрос вопросы
игра: играет
цитат: цитат
заверш: завершить завершив
устройств: устройство
пришел: пришел
текстов: текстовому текстовом
переход: переход
усил: усилий
срок: сроки
красот: красоты
правдоподобн: правдоподобными
алгоритм: алгоритм алгоритмы алгоритмов алгоритма
людьм: людьми
слыша: слышали
мегапроект: мегапроекты
хабр: хабре хабр хабра
обучен: обучения обучение
отношен: отношений
мысл: мысль
практик: практика
последн: последнее последних
месяц: месяц
неопределя: неопределяемым
сам: самое
качествен: качественно
детализац: детализации
жми: жми
стартап: стартапам
задава: задавать
называ: называют назывался
выполнен: выполнения
распознаван: распознавания распознавание
заправк: заправках
индивид: индивидов индивиды индивид
смысл: смыслу смысл
заключа: заключалась
умолчан: умолчанию
ассистент: ассистенты ассистентов
век: века
предполага: предполагается
стандарт: стандарты
очередн: очередное
семантическ: семантически семантический семантическими семантическое семантического
област: областей областях области
научн: научных научного научной
сво: сво своими своем
приемн: приемную
веб: веб
программирован: программирование программирования
нача: началась
авг: авг
реша: решал
специалист: специалисты специалистом специалистов
пород: породить
порог: порог
вопросн: вопросно
попробу: попробуем
транскрибиру: транскрибируем
явля: является являются
возьмет: возьмется
появлен: появлением
вещ: вещь
узк: узко узкую
хобб: хобби
сведен: сведения
развит: развитием развитие
первичн: первичная
сайт: сайта сайтах сайты
сгенерирова: сгенерировать сгенерированный сгенерированных
контрол: контроля
др: др
научпоп: научпоп
технолог: технологий технологии
задач: задачу задачи задача
файл: файлов
выясн: выясним
пользова: пользоваться
различн: различных
хвата: хватает
инженерн: инженерным
нейросет: нейросеть
диалогов: диалоговых
подойдет: подойдет
ед: едят
мордов: мордовия
искусств: искусства
базов: базовым
треб: требует требуется
истор: историю истории история
зовут: зовут
ход: ходит
вис: виси
факт: факт
ещ: ещ
сем: семьи
сен: сен
легк: легко
вид: виду видится виде
сет: сеть сетью сети сетей
жд: жд
конфиденциальн: конфиденциальность
умел: умела
сигарет: сигарет
науч: научить научиться
напряжн: напряжно
инфосистем: инфосистемы
естествен: естественных естественном естественного
договор: договор
контролирова: контролировать
позволя: позволяла позволяющий
хоч: хочу
предоставлен: предоставлении
рейтинг: рейтинг рейтинга
дом: домом
стандартизац: стандартизацию
способн: способную
визуализац: визуализация
известн: известно известные
дор: дорого
сторон: сторону
постав: поставить
поток: потоки
кратк: краткие кратко
поддержк: поддержка поддержку
остальн: остальных
призна: признать
родн: родное
ид: идеи
синоним: синонимы
нахожден: нахождению нахождения
предыдущ: предыдущей
наш: нашей нашем
улучш: улучшить
возьм: возьмем
реферат: реферат рефератов рефераты
республик: республике
азс: азс
объектн: объектная объектно
плат: платить
над: надеюсь
большинств: большинстве большинство
погна: погнали
умн: умным
трансформер: трансформеров трансформер
регламент: регламенту регламента
робот: роботы
измерен: измерения
евген: евгения
информац: информация информацией информации
описа: описаны описанные описать описан
выгодн: выгоднее
облачн: облачное облачная
схож: схожих
анализ: анализа
трудност: трудностями
несводим: несводимых
темпоральн: темпоральной
требова: требовалось
понят: понятия понятие понятий
ко: кое
поговор: поговорим
обработк: обработке обработки
катастроф: катастроф
порожда: порождать
например: например
правил: правилам
вне: вне
презентац: презентация презентации
нагрузк: нагрузки
акт: акты актов
соответств: соответствующих
нативн: нативные
акц: акции
сло: слоя
познаком: познакомимся
смыслов: смысловой
движок: движок
уровн: уровнем уровнях
гришечкин: гришечкин
отлич: отличить отличия
включа: включающих включала
сист: систему систем
спецификац: спецификации
качеств: качества качестве качество
выбор: выбор
наследник: наследником
наскольк: насколько
мтус: мтуси
онлайн: онлайн
проблем: проблема
но: ноя
алис: алиса
сервер: сервере
поставщик: поставщиками
раздел: разделы
вендор: вендоры вендоров вендором
автоматическ: автоматическое автоматического автоматической
выражен: выражения выражений
грузоперевозок: грузоперевозок
аббревиатур: аббревиатур
нек: некое
пожалееш: пожалеешь
унифицирова: унифицировать
лучш: лучшие лучших лучшего
лексик: лексики
механизм: механизм
управля: управлять
небольш: небольших небольшой
формат: формата формат
дума: думаю
умеют: умеют
промежуточн: промежуточный
крайн: крайней
возможн: возможностей возможность возможным возможно
переписыван: переписывания
будильник: будильник
насчита: насчитать
поверьт: поверьте
дает: дается
семантик: семантика семантики семантике
хочет: хочет
подтвержд: подтвержден
крупн: крупный крупных
упрашиван: упрашиваниями
рукотворн: рукотворные
упомянут: упомянутый
сюжет: сюжетов
опрометчив: опрометчиво
архитектур: архитектур архитектуры архитектуру
наверняк: наверняка
воспользова: воспользоваться
контент: контент
откр: открыть
миллион: миллионы
наход: находится
никак: никаких никак никакой
потер: потерь
термин: терминов
непонятн: непонятными
xx: xx
asr: asr
sourc: source
sanek: sanek
data: data
ganqqwerti: ganqqwerty
maxstroi: maxstroy
zoro: zoro
twitter: twitter
dev: dev
franki: franky
keyword: keywords
mastervlado: mastervlados
diana: diana
flow: flow
digit: digital
deliya: deliya
python: python
workflow: workflow
ai: ai
unistar: unistar
gpt: gpt
develop: development
real: real
weshid: weshid
automat: automatic
graph: graph
rubert: rubert
attent: attention
vk: vk
xeanst: xeanst
durham: durham
habr: habr
kirillkosolapov: kirillkosolapov
game: game
lsi: lsi
natur: natural
milfgard: milfgard
languag: language
youtub: youtube
summar: summarization
rss: rss
event: event
seo: seo
chatgpt: chatgpt
mine: mining
process: processing
jethabr: jethabr
wanderro: wanderro
alizar: alizar
wer: wer
valeriakhokha: valeriakhokha
klau: klaus
facebook: facebook
telegram: telegram
boldachev: boldachev
lstm: lstm
knowledg: knowledge
nlp: nlp
cointegr: cointegrated
speech: speech
amvera: amvera
open: open
