говор: говоря
криптограф: криптографы криптография асимметричной криптографов геннадий
фактическ: никакого
значен: хеш
стат: стать использоваться статья базы
сравн: схему
обычн: обычных
стар: вернуться
стал: стали
мнен: мнением мнениями
получател: отправителе получателем
таргетирова: таргетированной
став: ставится
реализова: реализовать реализовано
работ: механизм истории
рекламн: рекламным рекламный
дополнительн: дополнительный
зашифровыва: зашифровывается
сч: сч
незашифрова: открытом
получен: исходный полученные получения смог ошибки
человек: человеку
менеджмент: менеджмент
неспособн: пассивные
то: той
вкратц: вкратце
присутств: повлияет
надобн: вторых
должн: задержка должны
структур: уш временем
излиш: подобных
публикац: комментировать
благодар: благодаря
котор: которому последнее прикладное
выгрузк: загрузки
карм: комментарии
времен: сторонний
перешл: перешла
реализовыва: оставалось
свят: святым
регистрирова: третьих
обратн: выполняет
либ: либо
уч: клиентского
уш: приш
проект: нативные
связ: связи связь
видоизмен: видоизменить
относительн: относительно
профил: профиль
полага: тестирований
кодировк: полученный
верс: старую
маркетинг: маркетинг
маршрутизац: маршрутизации
трафик: трафика трафиком перераспределяющее
прост: получается
нно: картину
альтернатив: альтернативы
лин: линии
паразитизм: паразитизма паразитизм
сосед: соседями
проверк: постоянным отдельно
ложн: сообщение
дыр: дырой
налажен: налаженными
уровен: уровень
нов: новый прослушивать количества
внешн: очередь протоколом внешнего
медийн: блог
част: часть
сокрыт: сокрытие
субъект: субъекты субъектами списка субъектов субъект
слов: словами
литератур: литературе
перевернул: перевернула
замкнут: замкнутые
кана: канал тайного
постоя: постоянно производителя
нны: факт
определен: определения
сдела: необходимость
внимательн: посмотреть
особен: особенностью основные
сложн: сложный сложной
композиц: канала
безрезультатн: безрезультатной
пример: одном пример
анонимизац: анонимизации
хранилищ: хранилищ внутренее хранилища
итогов: итоговая
систем: системы
упрощен: прив
преобразу: прочитать
узна: узнать узнали
государствен: государственным
выд: шифрованная
частн: частным
труд: труда
путешеств: путешествие
ресурс: ресурсы
метод: методами
аппарат: аппаратом
групп: аккаунт
свойств: свойство свойства
картел: картель
перераспределен: сохранения
постепен: постепенно
нных: нных
нным: нным
продолжа: продолжают
номер: сохранять привязки
случайн: заполняясь
обраща: скрипта
современ: современных современной современный современном
помощ: помощи
лог: логи транспортирования
приложен: приложениями приложение приложения приложений
лож: участнику
разработчик: вакансия
секунд: контексте
вычислен: вычисления вычислении
асимметричн: воспользоваться
выстроен: выстроенные последовательно
серверн: серверной
прочита: которое
нейм: нейм
сыр: преобразованию поведение
задержк: поступаемые
интерес: интересов интересы
равновероятн: равновероятность
сравнен: сравнении
программист: криптограф
гипотетическ: гипотетически
минимальн: минимальными
связыва: котором
конкурентн: конкурентной
сквоз: проходят
регистрац: войти
отправлен: новых отправления
ситуац: ситуация
имеет: задачу каждого
счита: считать
отсутств: отсутствие
конкурент: конкурентов
утвержден: утверждения
цел: целью
отлича: принициально
граал: граалем
кажд: генерации каждым
переключа: легко
шла: шла
принициальн: алгоритм
дзен: яндекс
канал: каналах каналы участия
имплементац: содержит
множеств: отправление отправит множеством множеству
взаимодейств: взаимодействия
политическ: политические политических политическими
директор: работоспособность переходим
использова: хабре вышеописанного
графическ: типа
вышеописа: уч работы
функционир: публичные
достаточн: зависима
примерн: выглядить
список: список
паразитическ: паразитическим утверждаю
знаком: знакомых
выдел: выделяя
терминолог: моментов
повыша: преобразуем
след: архитектуру следующие сделать сводится
абонент: абоненту абонентами
дизайн: дизайн
производительн: низкой производительность
невозможн: невозможно невозможным
концепц: концепции концепцию
помим: помимо
отслежива: отслеживаемую
ят: ятся
клиент: клиенты клиентов клиент
так: такому такую такого таких таким
общен: общения
картин: глобальный
событ: событий
баз: базе теоретической
техническ: языка
хран: хранится храниться тестов внутренней
условн: условностями безразличны
назва: полученную
товар: товара товар товаре
собира: собираемую
турн: турне
некотор: криптографией
оберега: оберегаем
соглаша: соглашаться
количеств: количество получение количеству ограничены
введен: введение
соглашен: документы
логичн: логичные логичный
остава: оставались оставаться хорошей
добав: добавить
просмотр: просмотров
содержан: фактического
дополня: дополняем
друз: друзей
услов: условием
сквозн: имплементацию сквозное
представля: представляют представлять представляет
синтез: синтез
стро: протоколов
друг: другом другому другим друг друга соедин
правильн: правильным
теоретическ: теоретическая теоретически написана
прийдут: прийдут
тайн: тайный тайные тайных состояния
запущ: открываем
степен: некоторой
компан: авторов новости
программ: программ образовательные
коммуникац: коммуникации коммуникациях коммуникаций
получа: отправляемые значения потребителям схема
соответствен: соответственно
низк: использовании
наруша: нарушать функции
состоян: зависеть
рад: ради
наблюдател: наблюдателя внешний
имеют: имеют задачи
использ: используется некого остальными
созда: записи
имеющ: ложным
ран: ранее
кейс: кейс
исход: исхода
отдельн: запустятся
передач: передачи облегчить
сохранен: заключаться способа
тяжеловесн: вышеописанный
шеств: шествие
интернет: интернете
отличительн: отличительной
реализац: имеет реализация
тег: репозитории
тел: теле
тем: темы
применя: применять применяться
уделя: уделять
администрирован: администрирование
начальн: начальном запущены
знат: надобности
знан: знания
знал: наблюдатель
праздн: праздное
комментар: закладки
клиентск: клиентской возврат
абстрагируем: суммы
прощ: группа
адрес: адресов
проч: прочего
сильн: сильнее сильно
работа: проверим закрытом
переадресац: переадресацию
песочниц: авторы
долж: код
останавлива: останавливают
исключительн: исключительно исключительной
услуг: соглашение
оставля: оставляемая
произвед: произвед
телефон: номеру
проанализирова: проанализировать
необходим: исключить получаемые необходимо
гко: механизмом
блог: корпоративный
числ: числе
модификац: модификаций
ретранслир: качестве
интерфейс: назвать графический
период: сообщений нный
скрипт: результат запустим
чист: создания
сложност: сложности
вниман: внимания
видн: каналов
посредств: сквозь
автор: компании сайта автором
возврат: трафик
очеред: структура достанет очередей
локальн: локально
нигд: нигде
положен: ответ
посла: послать
аутентифицирова: аутентифицированном
тестирован: детерминирован
излишек: излишек
расписан: расписание
заключен: сервису
пользу: пользуемся
принима: конечного принимающая принимающему
тип: переводят отправляемых хранилище
реч: речь
общ: файловый общей общий
бит: биты бит битов случайными
разговар: разговарием
зада: нно
сред: среде
социальн: социальные социальной
может: реализации
ядр: статье построенный
люб: любыми любые любых любой любая
зависим: линейно
потреб: потребуется
язык: настройка
согласова: согласовали согласованный
захочет: захочет
обязательн: другу
содержа: последний
люд: людям людей
безразличн: ним
производител: принимает
вышесказа: основе
открыва: проходить
достанет: периода
критер: критерия обязательным отделяет
создан: излишен
храня: бд
приш: типу
запис: авторизируемся
одн: одним продемонстрировать легкозаменяемым предполагает
перераспределя: сохраняющее
наблюден: наблюдение наблюдений
перенаправля: сырых
реклам: рекламы медийная
настольк: настолько
приб: прибыли
корпоративн: услуги
прив: случай
масс: массы
одинаков: комбинациями
расширя: расширять
распространя: распространяемыми
плюс: функцию
объединя: объединять
огранич: ограничить плюс
таков: таковые минимум
выкача: браузере
электрон: электронная
участ: комбинацией соединениях
смотрет: смотреть
использован: редки использования изучения
запрос: примерно истинным скопилось
вследств: вследствие
авторизирова: регистрироваться
войт: вакансии
соедин: соединены следующему
существова: существовать
конечн: конечном интерфейсов
аккаунт: телефона
протокол: криптографических работает криптографический
деанонимизирова: деанонимизировать
репозитор: протокол
поступа: новые поступаемой
упомина: использование
зависет: пропорционально
декодиру: кодировке
похож: сутки
вполн: вполне
замедлен: замедление
яндекс: мегапроекты
апостериорн: апостериорные
новост: разделы
существ: существуют множества существует
заголовк: нужные
перв: особенности
создаст: создаст
авторизиру: страница
написа: могла
поиск: поиск
равн: равно равными
основ: непосредственно заключение
пропорциональн: прямо
образовательн: проекты
определ: определ
как: каком какого коммуниицирует
участник: участника участниками запросов участник участники участником участников
голос: хабы
напомина: напоминает
содерж: широковещательную
повлия: никак
окупа: окупаемыми
рассматрива: рассматривалась
тся: тся
пассивн: внутренние пассивных пассивного
заполн: отправляется
род: рода
высок: высокий критерий
втор: ответов
рол: представлен
точк: точками точки
рно: рной
способ: способен основного способ способами
форм: форме форму
мер: мере
избав: узлом
браузер: буквально
отправител: данных отправителем
узел: использует
напрям: связываются
готов: готовые готовых
преобразован: потребителя
провер: давайте доступе
приближ: приближены
информацион: специалист информационная
образ: образом прямолинейная
образовыва: образовывать
соглас: согласились
линейн: нагрузка
появ: появиться
случа: случаем критерием
запуска: директорию
доступ: коды
вернут: поддержка
парадигм: парадигме
отключен: отключение
бесконечн: бесконечности
сетев: сетевого сетевых сетевые
комбинац: комбинацию комбинация узла переключаться
обновлен: проверкам
гкост: гкость
послед: выгрузки основу
децентрализова: децентрализованные
утвержда: подобного
д: д
схем: операции архитектура видно следующей
единствен: единственной условности
незначим: незначимы
осуществлен: осуществление
л: л
загружен: повышаем
н: н
п: п
централизова: централизованные централизованных централизованным сможем централизованный
дава: проще
воедин: содержать
ч: ч
поэт: поэтому
отправ: очереди отправил отправить
мин: мин
отделя: единственное
мир: мир мире
неподчин: неподчин
назначен: иному назначения
совершен: вычислительные
безопасн: безопасные безопасных централизованными безопасный безопасными безопасность безопасным безопаснее безопасное безопасности
этап: этапе
скор: скорее
скоп: никакой
сообщен: сообщения генерирует ложить
аналог: аналогам
получ: получили скрипт
функционирова: работать
перевод: адаптеры
списк: списками обновления
экономическ: экономической экономических
час: час
прям: существование
могл: реализовывать
больш: большие большей большую большая
мест: место
файлов: файловые одно
планомерн: планомерно
шифрова: каким
предполож: предположить предположим
шифрован: сквозного шифрование
направлен: направленных
геннад: коваленко
согласовыва: заранее согласовывать
видет: видеть
устанавлива: упрощения
смогл: смогли
редк: достаточно
представлен: представления
генерац: устанавливает
пересказыва: пересказывать
излишк: излишком
мож: абстрагируемости
пыта: блокировать
максимизац: максимизация
момент: схожие ключевых момент
смож: вышесказанного
исполня: чистых
смог: сырой
основн: анонимная рассмотреть сторонние генерируются
единиц: загруженных
почт: почта
решен: решений решениями
передава: передаваться передаваемой
создател: предполагалось
комментирова: программист
нужн: выкачав
секрет: секрет
хаб: теги
выполня: субъекта
результат: результаты результату ответом
деанонимизац: деанонимизации деанонимизацию
рынок: рынок
ваканс: разработчик информационной вакансий
настройк: дзен
явлен: явление явления
дал: далее
контекст: увидеть
последовательн: множество
документ: компаний
прочтен: прочтение
рациональн: производительности
оффлайн: оффлайне
ключ: передачу согласовывает
конвертиру: получаем
дан: данный данном никаких данная данными данные данную данного степени
подавля: подавлять
код: исходные продолжим кодом
обеда: обедающих обедают
привязк: авторизироваться
соединен: базируется соединений
функц: ретранслирующей исполняющих
загрузк: присутствуют
централизац: централизация централизации
убежден: убеждениями
построен: мессенджер
доступн: доступными
заран: следующим
продемонстрирова: гкой
оболочк: оболочку
сохран: сохранить сохраняя
глобальн: сетях глобальное глобального
затягива: затягивающей
минимум: отличается
ошибк: получим
покупа: покупать
обнов: обновить
разработк: разработка
закладк: голосов
хеш: хранит
увидет: логам
уверен: уверенностью
сугуб: сугубо
лабораторн: единицу
почита: можете
изнутр: изнутри
итог: итоге
вжив: вживую
дел: деле
вопрос: вопрос
априорн: априорным
жит: жить
сохраня: ядра должен
внедря: внедряться
внутрен: внешней факте имеется внутреннего
устройств: песочница
размер: размеры
переход: переходя директории
элегантн: элегантные
прикладн: функционировать находится
проход: напрямую одинаковые
ответ: запрос ответить структуру декодируем
изучен: тяжеловесным
генерир: генерируется секунд период
полност: полностью
проектирован: проектирование
собствен: собственных собственные
переписк: переписками
измен: одному
следств: следствие
понрав: понравится
существован: существовании существования паразитическими
алгоритм: моменты
людьм: людьми
широковещательн: строит
мегапроект: стартапам
хабр: почитать хабр
абстрактн: абстрактными использовать абстрактности простой абстрактную абстрактные абстрактных
кук: заголовками
отношен: отношениям
транспортирован: воспользовались
куп: купили
базир: анонимизирующий
разлага: разлагаться
посмотрет: тип
ряд: ряд ряду
последн: изменить пытаемся
деанонимизир: воедино
монолитн: монолитными систем
сам: самые самый самым
бд: интерфейс
сутк: лучшие
стартап: программы
инач: иначе
потребител: роли запросы
переда: передал передать
подобн: выживания создателями подобной
вероятн: вероятностью
работоспособн: проверить
принят: принято
превосход: превосходить
представл: перенаправляет
смысл: смысле
умолчан: умолчанию
заключа: основная
предполага: предполагается назначению уровня
начина: начинают начинает
вс: вс
гким: адаптера
начн: адаптеров
раскаж: раскажу
сво: сво своими
программирован: программирование
нача: должна
специалист: работа
воссоздава: воссоздавать
станов: становятся становится
атак: атакующего атака атак
тест: созданы
истин: истинными битами
хранен: хранения
исключа: исключающее
явля: являемся являться являются является являлись
узл: остальным деанонимизирующим узлов запустится
свод: шифрования
спроектирова: спроектировать
первичн: первичного первичный
представ: представить
перед: переда
сайт: устройство
строен: теория
научпоп: научпоп
продолж: формат
перейд: проверки
задач: данной задачах задача задачей возьм
файл: файлами
ускорен: ускорение
пользова: пользоваться
трет: куками
смогут: смогут
достигнут: достигнуть
перейт: примера
нном: нному нном
истор: похожие
зрен: зрения
факт: узлам знали факта никому
ещ: ещ
сраста: срастаться
легк: можем
сет: сеть выстроенных сетями сети сетей
конфиденциальн: конфиденциальная конфиденциальность
вид: видит вида виду виды вид виде
обменива: обмениваются
присуств: присуствует
теор: статьи
вплот: вплоть
нескольк: нескольких
альтернат: альтернатив
памя: память
позволя: позволяет
легкозаменя: внимательно
паразит: паразитом паразитами
сумм: абстрактной
предоставлен: предоставления
рейтинг: карма
способн: способны способность способными
известн: известность
сторон: стороне стороны полагаться анонимизирующего стороной сторона
поток: потоки
поддержк: техническая
остальн: ключи некое
сговор: сговор сговору
родственник: родственников
хорош: анонимного хорошими
анонимн: абстрактная анонимные анонимных анонимностью анонимности ядро безопасного анонимность анонимно анонимную анонимной анонимными
зашифрова: зашифрованном зашифрованных
ин: совершенно иными
возьм: рассуждений
ит: ит
пользовател: пользователей
увеличив: увеличивая
успешн: успешно
выгод: выгод выгоды
наз: назов
публичн: хранят
сервис: сервиса сервисам сервисом сервисе сервисов сервис обращающегося сервисами сервисы сервисах
эмулир: необходимым
информац: информацию информация информации
первоначальн: сравнить
схож: имеются
обрета: обретать
ключев: схеме упоминал
выгляд: выглядит моей
трат: тратить
скрыт: скрытыми строения скрытые
ровн: ровно
мессенджер: мессенджеры анонимный
вста: вста
монополистическ: монополистическую
закрыт: незашифрованном
адаптер: участием начн последующей
например: например
отправля: заданный факту открытую получаемых
самостоятельн: самостоятельную
запуст: перейти перейд запустить запускаем
нагрузк: количестве
нативн: реклама
польз: пользуются
рассмотрет: лабораторным
обнаружива: обнаруживаем
отлич: отличие
уровн: прикладном высокого
мо: гким
сист: скрытых
специфичн: специфичный
углублен: углубленно
накоплен: накопленный
исходн: посредством знать
качеств: узел
выживан: рациональным
прямолинейн: нарушается
прослушива: номер прослушиваемые
вычислительн: использующими
государств: государств
пиш: пишем
проблем: проблемы проблемой проблема
исключ: избавиться
сервер: сервера
блокирова: начал
раздел: регистрация
автоматическ: автоматически
доказуем: доказуемая доказуемой
нек: некий перераспределения некую некой отправляет
лучш: публикации
механизм: ключевым основной
формат: конвертируем
относ: относятся
операц: операция операцию обратные
облегч: образуется
формац: формацию
ом: ому
крайн: крайней
возможн: возможным возможность возможно
интересн: интересна
детерминирова: первых
открыт: открытость хранящей терминологий
буквальн: буквальном существующих
хочет: хочет
анб: анб
все: всей
непосредствен: получателе
страниц: начальная
взгляд: взгляд
рассужден: последующих
коваленк: рейтинг
анонимизир: сохранении архитектурой
поведен: эмулирует
изначальн: изначальной изначально
архитектур: композицию схемы первоначальной
воспользова: ключей функционирует
ник: содержания
коммуниицир: неспособны
откр: открыть
криптографическ: уровне монолитный
наход: находятся таковой
никак: имеющее общую выда положенного
видоизменя: видоизменять
curl: curl
baa: baa
hl: hls
readal: readall
bad: bad
bin: bin
channel: channel
fad: fad
dfae: dfae
echo: echo
messeng: messenger
eedf: eedf
dcce: dcce
nil: nil
number: number
path: path
newparam: newparams
password: password
dcda: dcda
twitter: twitter
portservic: portservice
incrementcountindb: incrementcountindb
hex: hex
api: api
putmessag: putmessage
aa: aa
applic: application
ab: ab
ac: ac
github: github
ad: ad
method: method
ae: ae
af: af
io: io
ip: ip
loadmessag: loadmessage
push: push
accept: accept
str: str
fail: failed
re: res
size: size
sender: sender
strconv: strconv
habr: habr
cmd: cmd
ba: ba
bb: bb
parseuint: parseuint
rsa: rsa
bc: bc
bd: bd
cmessages: cmessagesize
bf: bf
ead: ead
fce: fce
secret: secret
sihdvcmxkiq: sihdvcmxkiq
bbad: bbad
local: local
youtub: youtube
sleep: sleep
result: result
sh: sh
dcfb: dcfb
tor: tor
peer: peer
pgp: pgp
afbbc: afbbc
xor: xor
seq: seq
cb: cb
bdc: bdc
cc: cc
abb: abb
cfd: cfd
cd: cd
ce: ce
set: settings
cf: cf
abc: abc
incorrect: incorrect
err: err
facebook: facebook
aeaa: aeaa
cacf: cacf
eddc: eddc
exampl: examples
da: da
return: return
db: db
dc: dc
msg: msg
agvsbg: agvsbg
dd: dd
bed: bed
acb: acb
receiv: receiver receive
data: data
fef: fef
dac: dac
sign: sign
hltclient: hltclient
fmt: fmt
cworksiz: cworksize
sprintf: sprintf
pubkei: pubkey
second: seconds
decec: decec
post: post
payload: payload
countofdataindb: countofdataindb
host: host
retroshar: retroshare
eb: eb
gpg: gpg
traffic: traffic
ed: eded
ada: ada
localhost: localhost
bfe: bfe
ee: ee
abcbe: abcbee
read: read
hostservic: hostservice
format: format
trafficpag: trafficpage
chr: chr
servic: service
freenet: freenet
cafb: cafb
vk: vk
consum: consumer
success: success
mixminion: mixminion
http: http
fa: fa
produc: producer
bodi: body
fb: fb
lake: lake
fc: fc
fd: fd
aee: aee
eea: eea
request: request
hidden: hidden
string: string
methodget: methodget
continu: continue
caf: caf
bitmessag: bitmessage
respons: response
network: network
printf: printf
head: head
println: println
fcdc: fcdc
load: load
common: common
strcount: strcount
countservic: countservice
json: json
countdb: countdb
messag: message
afa: afa
responsewrit: responsewriter
afc: afc
tcp: tcp
anon: anon
cbb: cbb
fifo: fifo
dde: dde
hlm: hlm
telegram: telegram
int: int
aeec: aeec
hlt: hlt
func: func
methodpost: methodpost
edeac: edeac
bash: bash
time: time
user: user
acafb: acafbe
