обрат: обратить
термина: терминал терминала
готов: готовит
говор: говорят
стат: стать статьях статьи статей статья
сравн: сравнить
смеша: смешанной
стар: вернуться старое старых
обычн: обычных
говн: говна
обобща: обобщает
рабоч: рабочих рабочим
одноплатн: одноплатном одноплатный
служ: служить
стал: стала стали стало
дорог: дорогие
аспект: аспектах
окажут: окажутся
предлага: предлагаю возможности
обзор: обзор обзору
электроник: электроники электронику
призва: призвана
случа: случае
полноразмерн: полноразмерной
рэйнбовсофт: рэйнбовсофт
работ: работа работая работы
завис: зависит
частичн: частично
показыва: показывать
удар: удар
доступ: доступ
вернут: техническая
грех: грехи
сетев: сетевое сетевые
предел: пределы
прошлогодн: прошлогодний
терминал: терминалов
сокраща: сокращается сокращать
инфраструктур: инфраструктуре инфраструктура
учебн: учебной
сто: стоят стоит
тб: тб
мил: мили
тв: бесполезную
вообщ: вообще
ти: ти
менеджмент: менеджмент
единствен: единственное
вольт: вольтам вольт
экра: экрана
шнурк: шнурки
стремлен: стремление
потреблен: потребление
преврат: хлама
н: н
мобильн: большинства
п: п
привлек: привлекая
снижен: снижение
публикац: разделы
скопирова: скопировать
дава: давайте
ненужн: дано
ч: ч
показа: показать
поэт: поэтому
жестк: жестких жесткие
назван: название
благодар: скоро
котор: которую которым
владелец: мобильных
откат: отката
времен: временно
мин: мин мини
вариант: вариантов варианты вариант
сбыва: сбывается
осен: осенью
писа: писали
одноплатник: одноплатника
исследован: исследования
прав: право
диск: дисков диски
скор: коллекции скором
проект: проекта нативные
аппаратур: серверной
феврал: февраля феврале
относительн: относительно
выраз: выразиться
профил: профиль
заварива: заваривайте
пауэрбанк: пауэрбанк
аналог: аналогом
кризисн: кризисного
получ: получила лэптоп получить
модн: модное
произведен: произведения
верн: верн
перевод: перевод
располож: расположены
фронт: фронтам
верс: старую
важн: важна
дистрибутив: востребованной
исключен: исключением
нна: посвящ
маркетинг: маркетинг
увеличива: увеличивают
книг: кикстартеру
разобра: разобраться
рук: руки руками
избавля: предупреждаю
час: час часов
прост: простой
внутр: внутри
врем: времена
нно: нно
альтернатив: альтернатива
измеря: измеряем измерять
индустр: индустрии
здравств: капотом
лиц: лиц
совместим: совместимы
повышен: повышением
побыстр: побыстрее
уровен: уровень
нов: новый нового новой новые новых новое
софт: софт
медийн: корпоративный
част: часть частая
иде: идеей
цифров: цифровое
порядок: порядок
слов: словам слову
длительн: длительных
офис: офиса
направлен: направления
наворот: наворотов
полезн: полезными
одновремен: одновременным
постоя: постоянно
миниатюрн: миниатюрные миниатюрность
нны: нный
системн: системное
сдела: сделать приставку
развернут: развернутым
сложн: сложный датчиков
капот: знает
нпо: нпо
примен: применить
пут: пути
сетап: сетапа
активн: активно
русск: русскую
раскладк: раскладку
кит: наладонник
операцион: операционные сложных
мцст: мцст
подключа: подключаться
приставк: тв ненужная
систем: системах системы
отклик: отклик
смож: сможем
частн: частных клавиатур
персональн: персональных
лишн: лишняя
развива: продолжает
нема: немало
дистанцион: дистанционно
вышл: вышло вышли
южнокорейск: южнокорейской
провайдер: провайдер провайдера
текущ: текущая
инвертор: инвертору
ресурс: ресурсе
машин: машину
простеньк: простенькие
выпуска: стараются
решен: решения
постепен: постепенно
предпочит: предпочитая
нным: нным
актуальн: актуально
средн: средний среднее
продолжа: интересно продолжают кое
личн: личные личных
домашн: домашним домашних
удачн: удачных
букв: буквы букв
случайн: случайным
подряд: подряд
носител: носителей
хаб: публикации
рынк: рынка
нрав: нравятся
вых: вых
прекращ: прекращена
востребова: ос
приложен: приложение приложениями
результат: результаты
разработчик: разработчики
вызыва: вызывают
банковск: банковскими
опыт: опыте
склад: склады
рынок: рынок
настройк: настройка
вклад: сюда
явлен: явлениях
дал: далее
слога: слоган
накопител: накопителей накопители
документ: сайта
прочтен: прочтение
робототехник: робототехнике
будущ: будущее
объезд: объездили
командировк: командировках
ссылк: ссылку
наоборот: наоборот
серверн: серверное платформы сегменте
наладонник: портативный
ключ: ключей
задержк: задержки
сравнен: сравнение
дан: данных сделай данном данный данная данного
программист: программисту
установ: установили установить
весьм: весьма
протестирова: протестировать
указа: указать
вкус: вкус
детальн: детально
ладн: ладно
найдет: найдется
регистрац: войти
дефицит: дефицита
снабжа: снабжают
имеет: клавиатурам
поисков: поисковая
причин: причин
мся: мся
цел: целях
отремонтирова: отремонтировать
цен: цены
муз: музее
сисадмин: сисадмином
повышайк: повышайками повышайкам
звук: звук
руководител: лепихин
возника: возникают
просветл: просветл
дзен: яндекс
эр: эры
перебо: перебоях
сохран: сохранность
подключ: подключить
вмест: вместе
отличн: отлично
позабот: позаботиться
ошибк: ошибки
покупа: покупают
чип: чипов
спор: спор
достич: достичь
обнов: обновить
сегмент: обогнать
завершен: завершение
разработк: разработке разработка
закладк: закладки
паден: падение падения
разработа: разработан
использова: использоваться использовал
перифер: периферия
игрушк: стартап
желез: железо
стара: стран
поколен: поколение поколения
достаточн: достаточно
примерн: примерно
добавля: добавляет
отечествен: отечественная
сюд: аппаратуры
настоя: настоящие
список: список
энерг: энергия
ремонт: ремонт
коллекц: частной
обеспеч: обеспечить
след: следующий
прошедш: прошедшей
дел: дело
вопрос: вопросов вопросы вопрос
дизайн: дизайн дизайну
бесполезн: превратить
производительн: производительные производительность
добротн: добротным
помим: помимо
устройств: устройствах устройство устройств устройства
триллиард: триллиарды
недоч: недоч
лепихин: игорь
оптическ: оптическом
клиент: клиентами
ваш: ваших вашего
так: таких
ответ: ответить ответом
публикова: публиковали
полност: полностью
несмотр: несмотря
сталкива: сталкиваются
измер: измерить
техническ: языка
станц: станции док станцию
мощн: мощный
дешевеют: дешевеют
стойк: стойки
уда: удал удалось
фев: фев
экономичн: экономичным
назва: названо
заметк: заметки
деш: деш
слыша: слышали
собира: собирается
мегапроект: стартапам
хабр: хабре хабр
видюх: видюха
аналитик: применении
некотор: некоторыми некоторых некоторые
рассмотр: рассмотрим
куп: купить купил
игор: зовут
обогна: способен
аккумулятор: аккумуляторами
механическ: механические
клавиатур: клавиатуры интересных нная клавиатурой клавиатуре
количеств: количество
палок: палок
соглашен: документы
шнур: шнура
добав: ним добавить
посмотрет: посмотреть
просмотр: просмотров
специальн: фото
последн: последний последней последних последние
бач: бачило
услов: условиях
конфигурац: конфигурация конфигурации
сам: самых самые
объем: объемы
маршрутизатор: маршрутизатором
гибридн: гибридный
диагонал: диагональю
виртуальн: виртуальных
стартап: английский программы
туториа: туториал
дик: дико
кабел: кабеля кабеле
выпендр: выпендриться
роутер: роутера роутер роутером
подключен: подключения
задава: задаваемых
потребител: потребитель
тотальн: тотального
аппаратн: руководитель
запущ: запущено
компан: компаний компанией компании
длин: длина
программ: программе образовательные
допуска: допускаемых
обеспечива: обеспечивающего
привел: привело
низк: потребность
недорог: недорогие
элемент: элементы
стандарт: стандарта
расстоян: расстояний
бесперебойн: бесперебойного бесперебойное
западн: западная
вс: вс
прогноз: прогнозы прогноз
дайджест: дайджесте дайджест
использ: используется использующих
блюпуп: блюпуп
воткнут: воткнуть
цвет: цвет
ран: ранних
сво: своими сво свой
помн: помните
веб: веб
стол: столом
отдельн: отдельное
порог: порог
гик: гиков
станов: становиться становится
перспектив: одно
попробу: попробуем
интернет: интернета интернет интернетах интернету
предоставля: предоставляет
необычн: необычные
тест: тестов
реализац: реализации
вступ: вступить
явля: является
появлен: появлении
вещ: вещей
оптимизац: оптимизация
дорогостоя: дорогостоящую
применя: применяется
официальн: официальное
теря: теряют
администрирован: администрирование
пользовательск: пользовательские
питан: питание питания
сайт: песочница
обеспечен: аппаратного обеспечение
оборудован: оборудование
научпоп: научпоп
технолог: технологий технология технологии
комментар: комментарии комментарий
происход: происходит
задач: задачах
бет: беты
авт: авто
различн: различными различных различные
физик: физика
приступ: приступим
компьютер: компьютером компьютеров компьютере компьютеру компьютеры компьютер
сильн: сильного
работа: работают работать работаем работает
песочниц: хабы
долж: должен
останавлива: останавливались
блок: блоки
пар: поговорим пару
перейт: перейти
посвящ: посвящена книга
услуг: конфиденциальность
пекарн: пекарни
уменьш: уменьшили
искусств: искусства
нном: нном
оптик: оптика
заслужива: новинок заслуживает
блог: блог
необходим: необходимостью
истор: истории история
зовут: здравствуй
интерфейс: интерфейсы
несколбьк: несколбько
модел: модели моделей
сложност: сложности
ещ: ещ
вниман: внимание внимания
параметр: параметров
девайс: девайс девайса гораздо девайсы
автор: авторы автором вклад автора
снижа: снижаются
сер: серии
чита: читать
представител: представители
новинк: новинках новинками новинки новинка
сет: сеть
конфиденциальн: соглашение
остр: приставка
инсайдерск: инсайдерская
дюйм: дюймов
разрешен: разрешением
корпорац: корпорации
ищут: ищут
тестирован: коллегами тестирования
долгожда: долгожданные
нескольк: нескольких
быстр: быстрой быстрее
реальност: реальности
эксперт: экспертов
спрос: спроса спрос
неэффективн: неэффективно
типичн: типичных
хот: хотим
инновац: инноваций
памя: память
позволя: позволяют позволяет
пережива: переживает
выручк: выручка
эпох: эпоху
хоч: хочу
рейтинг: рейтинг рейтинга
скорост: скорость
портативн: разных
док: китая
реч: речь
дом: дома
реш: решил
известн: известно
покупател: покупателей
общ: общем
объ: объем
горяч: горячего
сторон: стороне стороны
обойт: операционной
поток: потоки
кратк: предлагаем
поддержк: поддержкой поддержка
остальн: остальные
недел: неделю недель неделе
поддержива: поддерживает
электроэнерг: электроэнергией
включ: включая
шуток: шуток
емкост: емкости
родственник: родственников
модульн: модульным модульный
стоимост: стоимости
предназнач: предназначен
хорош: получил
трансляц: трансляции
мким: мкими
сред: корпоративной среди
им: имею
наш: нашей нашими наших
яблочн: яблочного
лайфхак: лайфхаки
ватт: ватт
пользовател: пользователя пользователей
мног: многое многим многих
люб: любых любят любой
зарядн: зарядную
зарядк: зарядкой
компонент: сборки компонентов
над: надеюсь
язык: дзен
большинств: основой
останов: остановиться
погна: погнали
умн: компонентом
доллар: долларов
фот: продолжаю
оперативн: оперативная
фактор: фактор
чердак: чердаке
энергопотреблен: низким
информац: информация информации
хлам: избавляемся
поставля: поставлять
разн: разные хороших
анализ: анализу
удален: удаленно
эникейств: эникейство
производител: производителями производители производителей
английск: аналитика
потребля: потребляющий
сборк: игрушкой
неизбежн: неизбежно
упа: упала упало
ко: станция
применен: серверном применения
поговор: выпускать
встроен: встроенным
квартал: квартале
собра: собрано
идет: идет
производств: производство
подп: подпись
например: например
знает: смартфона
одн: одном одна энергопотреблением
продаж: продаж
нубук: нубук
широк: широкий
мар: мар
настольн: настольные
согласн: согласны
коллег: обеспечения
мат: мать
увеличен: увеличением
реклам: медийная
настольк: настолько
выставля: выставляется
корпоративн: дистрибутивы корпоративные корпоративных услуги
тов: тов
потребн: острая
нативн: реклама
попрос: попросил
подборк: подборку
чест: честь
выда: выданных
надежн: надежности
репк: репка
итак: итак
команд: команда
сообществ: сообществах
плюс: плюс
предупрежда: специально
врод: вроде
электрон: электронных электронные
стран: девайсов страну
вол: воли
использован: использованию использовании
свет: света
импортозамещен: импортозамещения
мо: мо
платформ: перспективы
стекл: стекле
сист: систем
горазд: среде
автоматик: автоматики
войт: аккаунт
ноутбук: ноутбуки ноутбука ноутбуков ноутбук ноутбуком
нечт: нечто
процессор: процессором процессорами процессоры процессоре процессоров
конечн: конечный конечного
аккаунт: лучших
состав: составило
выбор: выбору
сраз: сразу
кикстартер: благодаря
производ: производит
смартфон: смартфоны владелец
порядк: порядке
молл: молл
пиш: пишем
проблем: проблемы проблемами
новинок: паре
подробн: подробности подробно
поспрашива: поспрашивала
дешевет: дешеветь
печата: печатать
датчик: умных
сервер: сервер серверов серверах сервером
поставщик: поставщиков
раздел: регистрация
похож: похоже
параноик: параноиков
нетривиальн: нетривиальных
выигрыва: выигрывают
яндекс: мегапроекты
новост: новостям новости
лучш: авторов лучшие лучший
перв: первые
бог: бога
оз: озу
небольш: добавился
мгц: мгц
добр: доброй
крайн: крайне
поиск: поиск
возможн: имеет возможных
побежда: побеждают
интересн: заслуживают краткий интересного
ос: развиваться
биржев: биржевой
твердотельн: твердотельных
основ: обойтись
санитар: санитаров
планшет: планшетом
открыт: открытом открытый
выбра: выбрать
увелич: увеличить
преобразовател: преобразователи
выйдет: выйдет
образовательн: проекты
участник: участника
как: какими каким
определ: определ
комментатор: комментатором
голос: голосов
крут: крутыми
дмитр: дмитрия
оптимизирова: оптимизировал
пк: пк
кат: катом
освобод: освободить
растет: растет
прошл: прошли прошло
отрицательн: отрицательном
род: родившийся
гаджет: гаджеты
архитектур: архитектуре тестирование
выпуст: выпустили
фрешк: фрешку
пада: падают
апгрейд: апгрейдом
стандартн: стандартную
откр: открыть
гарнитур: гарнитура
способ: способ архитектуры
завоевыва: завоевывает
избав: избавиться
компьютерн: компьютерное
продукт: продукта
лэптоп: небольшой
бюджетн: бюджетные
источник: источниками
msi: msi
tv: tv
sourc: source
ruvd: ruvds
usb: usb
ssd: ssd
dii: diy
seleditor: seleditor
droman: droman
aaplpro: aaplpro
blade: blade
ultra: ultra
usbchardwar: usbchardware
atd: atd
cloud: cloud
technolog: technology
twitter: twitter
qc: qc
dram: dram
oracl: oracle
lepikhin: lepikhin
mastodon: mastodon
embed: embedded
nix: nix
andrei: andrey
ml: mls
app: app
new: news
wifi: wifi
selectel: selectel
io: ios
vnc: vnc
pro: pro
iv: iv
courag: courage
intel: intel
translat: translate
poweredg: poweredge
reform: reform
igor: igor
netra: netra
mordatyj: mordatyj
librem: librem
mikeveng: mikeveng
kingston: kingston
vk: vk
hft: hft
ryabova: ryabova
gpon: gpon
amd: amd
habr: habr
barseadar: barseadar
iphon: iphone
weekli: weekly
entityfx: entityfx
pine: pine
iie: iie
repka: repka
appl: apple
vigor: vigor
android: android
bright: bright
sun: sun
zakhar: zakhars
tylerskald: tylerskald
alexeynadezhin: alexeynadezhin
youtub: youtube
saul: saul
raspberri: raspberry
samsung: samsung
rss: rss
linux: linux
ipado: ipados
limow: limows
sparc: sparc
arm: arm
connect: connected
gk: gk
alizar: alizar
greiv: greiv
facebook: facebook
hdd: hdd
lemo: lemos
telegram: telegram
store: store
dell: dell
iiii: iiii
mnt: mnt
pi: pi
window: windows
open: open
mark: marks
dc: dc
pocket: pocket
po: pos
