случ: подвинул
недоумев: обрюзгших
банк: модуль докладываю
понима: события
расскаж: актуальность
фактическ: моложе
рассказ: рассказа
стат: стать публикации хотели статьи прошлой производительного
сравн: теме
обычн: заполняться
стар: вернуться
инвестор: венчурных
юзер: обычными
рабоч: участков
многоугольник: многоугольников
стал: система числе
се: айтишников
мнен: продажами
указан: ввода
местонахожден: определить
издательств: знаете российского
реализова: реализовать
заход: заходите
работ: научных автоматизации понять
центр: дырой
завис: предвзятость
показыва: заметка показывать
ст: накачай
дополнительн: написан
нка: нка
получен: рассказывал сравнить
сто: редакции
менеджмент: менеджмент
заполня: начинают
благодарен: прошлый
тк: пришел
каса: подумать
поисковик: становится
мобильн: обзор
должн: упаковке
публикац: количества понимания
структур: оптимальную
скопирова: скопировать
макс: мнение
всемирн: всемирной
подел: хочу
косичк: косичку
благодар: кстати
котор: друг дистанцированием
изобраз: изобразить
благ: пользуйтесь
прав: хранения сомнения
кухн: странность
проверя: ожидание
статистик: оптимизация
уч: ним
либ: ещ
проект: разработкой нативные
уш: меньшими
порисова: порисовать
прямоугольник: прямоугольник
вьющ: носом
профил: профиль
дела: никто
бекграунд: сервиса
приветств: десантника
читальн: читальный
верс: старую
маркетинг: маркетинг
разобра: попробуем
прагматичн: иностранном
прост: простой предпочитают простые
врем: переживает
позвол: воображение
зал: зал
рубл: млн
настолок: семейных
здравств: визуальное астрономия
занима: компания
криминалистическ: приложенной
встреч: вызвать
дыр: рной
разумеет: общем
уровен: уровень
нов: новые новом привлечение
сверх: выполняется
медийн: корпоративный
отбор: условие
част: обороты ответить выходили
тоск: тоску
слож: мама
субъект: осознания
слов: точные упала
выжимк: предоставить
одновремен: попытаюсь
системн: память содержимого
сдела: самое
сложн: помогают сложно выдачи сложный
дают: заключается
возбудител: возбудитель
совет: гранта
примен: применить
пут: почкина ищут
символическ: символическую
нос: длинным
морщин: покрытых
систем: баз продуктом системе информационных
выход: ресурсе
переписыва: приложение
государствен: являлся
накача: приложений
трудн: отношения
привлечен: потоке
южнокорейск: идет
текущ: исполнится
ресурс: ресурсов ранее
метод: некоторые
процесс: взаимодействие условию описывается
одномоментн: тк
свойств: обязательных работе
постепен: работали
хотел: авторов настолок
культур: культуре
доказыва: доказывать
актуальн: теряют
продолжа: продолжаем
подряд: подряд
помоч: вдохновить
помога: свой
бесплатн: заявки
рынк: представители
продвижен: тренды
материа: прочтением
помощ: ситуации
отвернул: клиентов
выш: считают
приложен: приложения дадут непосредственная односложных
здоров: мозг
комикс: тематические
склад: освободить
произнос: утолщить
желан: желание
схватыва: интуитивно
наоборот: скорее
серверн: заканчивая
подвинул: вытеснит
неподготовлен: брался
интерес: советую
сравнен: языков
программист: программистах
странност: учитывая
рост: уменьшается
росс: видел
регистрац: войти
толк: сбивающий
ситуац: систему веков
выдач: поисковой
поисков: прогнозы топ
каза: уровне
счита: например какими
эффект: толку
отладк: механизмах
отсутств: ртка
причин: различным дешеветь
окружн: окружности
цел: экспертиз
цен: времена
троп: культурные
сериал: тропы
кажд: разный сложнее
асинхрон: приходит хотел
пройд: кинуть итак
российск: личным
дзен: мегапроекты
канал: своем
конвертер: конвертера
взаимодейств: реализации продолжение
спор: радиоактивные
иностра: установки ответ очередной
всяк: которому
семафор: сокеты
желез: компьютерное
синхрон: называется
десантник: голосом
примерн: сотрудников
установк: отладки
закономерн: известная
отечествен: млечного
сюд: выполнения
уходя: новостям
настоя: россии
список: список
знаком: синтаксису
меньш: людях
типов: правило
след: сверху звучит задача
напомн: внедрению
дизайн: дизайн
производительн: сторону
концепц: асинхронное
попыта: тянул
светов: измерить
статус: удачным
клиент: управляют
коротк: вещи
телеграмм: канале
так: накопителей таким
вячесла: здравствуйте
событ: фотографии
редакц: недели
техническ: проведение настройка технический
баз: свойствами свойств
оптимальн: спроектировать
уменьша: использование которое
просторобот: игр
заметк: короткая
символ: символом
листок: листок
собира: проблем участника
описыва: туториал
лабиринт: лабиринт
обсуд: обсудим можете
некотор: умнеют некоторым
предпочита: большинство
застав: проблемы
авторизац: друга
рассмотр: линейкой
подума: странно
количеств: количество количеством увеличение большом
соглашен: документы
пересечен: пересечения пересечениях
добав: добавить
просмотр: просмотров
сферическ: сравнении
сетова: иностранных
зна: асинхронность
услов: случае среде хватает
стро: строить
стереотип: стереотипов
вдохновен: поделиться
друг: изолированные местонахождение
фотофиксац: исследования пк
ознакомлен: продолжу
приход: сотрудникам помощь прид
правильн: правильных
отдохнут: любим
смежн: агентом
поня: помочь
воображен: щекочет
компан: компании кульгин сайта
рассказыва: подробно
степен: высшей
программ: сложные
вчер: вчера
получа: частые
действ: действует требуется
главн: каким
разбира: пришлось
соответствен: приходить
салфетк: одну
венчурн: настоящих
обеспечива: проприоцепция
привел: склады
млечн: центре
взросл: земных
ных: уч
привет: привет
рубеж: примерно
отдел: экспертом
дайджест: дайджест
сбавля: планирует
визуальн: веб
имеют: зачастую
пропаст: понимаете
имеющ: объекта
ран: бизнеса
объясня: видимому
помн: приходится
кейс: кейс
стол: накрывали
взаимоотношен: образа
мбайт: лишним
интернет: меняться интернет
реализац: опыте
волос: вьющимися
осознан: людьми
радиоактивн: задал
оптимизац: поисковая
тел: находится схему
тем: работ материале популярную
физиолог: пространстве
пришл: банке сетовал
астроном: неделю отдохнуть
администрирован: администрирование
фотограф: видите
дистанцирован: эмоциональным
зерка: смотрит
знак: начать
комментар: комментарии какое
рамк: экспертизы
физик: физике
сотрудник: технарей вследствие
оповест: сервера
проч: комиксы декомпозиции
работа: работает методы работать
сильн: настолько
песочниц: данных сообщения разделы
исключительн: исключительно
блок: системного
вызва: эффект
услуг: конфиденциальность
подписчик: получаю
дадут: команды
блог: сюда блог
необходим: сборке
числ: гранту
автоматизац: инструмент
проприоцепц: называют кратко
сетк: сетки
сложност: сложности
исправля: заявку
оглядыва: выпускников
автор: авторы хороших автором
чита: читать
подход: лоскутный выбранного
разрешен: изучение
намет: продвижении
заключен: отображения
эксперт: заключении словам государственным
совр: получил
спрос: падение благодарения
выруча: моделировать
бизнес: благо
недовол: столько
декомпозиц: инструменты
бумаг: выручают
выручк: квартале
внедрен: подход
процедурн: процедурно
реч: увеличить
реш: непонятным реш
общ: наоборот
недостатк: преимуществах
зада: заданной отбора информации вопросов
недел: разобраться уходящей
включ: причин
культурн: гэги
обо: недостатках
сред: взаимодействия хабре
социальн: социальные
может: знак
мног: многое
нулев: концу
люб: происходит получилось программы
зависим: ответы
снят: следователь
директ: яндекс
язык: языка подобными грех каком владения обоих
нарисова: нарисовать
обязательн: вместе
тку: тку
формулир: языке
транш: двумя
разн: разные носители творческий
содержим: внутреннего
люд: сорок думаем
выявлен: является
производител: выручка
год: каждым световых нулевых
отталкива: поиске
целев: несоблюдение
владен: уровня
экспертиз: технической радиотехнических
конкретн: зависит
ожидан: соответственно операции проблема
критер: заданным
зачаст: информационные
квадратн: квадратную
аудитор: аудиторией
фси: рублей
вскрыт: упаковки
самозанят: бесплатная
квадрат: квадрат квадраты
запис: учетными
производств: схемотехника
знает: просторобот волосами
одн: согласны напомню одних думаете сложила
продаж: самозанятых
мам: спросила стол
мар: ощущаете
согласн: пути подхода
реклам: контекстной медийная
настольк: экспертов
грант: благодаря получить получения
прид: следующие
корпоративн: услуги
выпускник: встречи
помощник: помощника
инструмент: вопроса крутые необходимых
итак: типовые
команд: специалисты
сообществ: сообщества
ознаком: интересующимся
подня: смутилась
таков: ошибка
субъективн: понятие
находя: обобщу
врод: вроде
использован: родном
платформ: доступа
запрос: ожиданием неуспешности
вследств: авторизации
горазд: материала
войт: аккаунт
фонд: получили нашей западные
аккаунт: ланит
топ: попасть
сомнен: конце пройдемся
генерируем: генерируемое
сраз: людей
сколков: резидентом
подробн: часть осветить
григор: григорий
бот: бот бота
яндекс: рекламы
новост: подписчиков пройдусь новости
взыв: взывая
существ: существуют существует сей выявление
перв: оборудованием
проведен: истории
достоинств: прочие
написа: написать серверов процессов
добр: системное
поиск: поиск записями
неудобн: большой
кодирован: кодирования
посвяща: айтишникам
основ: схема
планир: седьмую
мед: медиа
голов: подняла
боя: тему
образовательн: проекты
обрюзгш: морщинами
как: умолчу какие каких закидываем пропасть зависимости языком
определ: трудно
участник: чипов
голос: голосов произносить
почкин: ст
покрыт: одноклассников лоскуток
кат: кат
рассматрива: здравствуй
освобод: побыстрее
рису: рисуем
прошл: неудобной перевод
точн: таковы
рно: ч
мем: бесчисленные
способ: способов
бесчислен: посвящаются
мер: крайней
компьютерн: сокращается отдела
продукт: проектами
заявк: разбором нашу
информацион: смежных следующим
занят: занятий
образ: образом основа образ
ввод: действий
щекочет: государства
конц: соцсетей ссылка
линейк: криминалистической
геро: героем
обзор: краткий
электроник: производство электроники
случа: данном
практическ: сво
удар: мар
доступ: контроля
мозг: нашим популярное
вернут: поддержка
грех: разбираться
схемотехник: задачи
сокраща: одном падают
вершин: вершины
приглаша: приглашаю
буб: бубен
обновлен: обновление
схем: обеспечивает детей
вообщ: вообще
дядиченк: дядиченко
стремлен: спроса
резидент: стали
дава: корпорации
умнеют: поисковики
смут: представлении
ч: звезду
показа: просьбой
поэт: разными
звезд: молодую
зафиксирова: должны
мин: мин
вариант: соответствующих
мир: разработке
писа: статье железо
исследован: объектом
совершен: казался
внешност: недоволен
скор: мешает выпустило
конец: конец
сообщен: личных личные
тренд: расскажем главных
кризисн: падения
получ: августе позитивом статей подробнее
перевод: перевода здоровье
радиотехническ: компьютерных
списк: простых
забира: понемногу
млн: грант
задачк: задачки
площад: площадью
индустр: кризисного
могл: недоумевая
яростн: могли
побыстр: поставщиков
кстат: отвернулся
больш: умной мере нашли
контекстн: скликивания
начин: накопитель
счет: деньги
токсичн: сомнениям
несоблюден: мбайт
аналогичн: привести
игр: издательства
попаст: статистика
существен: вычислительных
телегр: телеграм
пуга: внешностью
представлен: маму
видел: разумеется
кружк: кружка
раскладк: раскладки
кинут: песочницу
сотн: совру
гэг: мемы
момент: момента
лишн: размер
основн: основной
упаковк: целостности фотофиксации
математик: математика математики
формулирова: формулировать
привест: позволяющую
своеобразн: своеобразным
решен: путь принятии
проходя: проходящие
скликиван: защитой
одмин: одминах
средн: средний старше
личн: обсудить полученные сотню
васил: песочницы
нужн: варианты
удачн: сеть
вакуум: коней
носител: зафиксировать
ощуща: фактического
хаб: хабы
меня: начинает
бенчмарк: небольшое
выполня: код синхронное одномоментно
красив: красивое
опыт: фонда практическом
настройк: дзен
дал: далее
накопител: начиная имеющего блока
пониман: гораздо
документ: компаний
прочтен: ознакомиться прочтение
ссылк: ссылку телеграмм
вдохнов: карандаш
агент: рабочих
дилемм: моральных
дан: восстановление критериям предназначению
дат: дату
следовател: задает
разделя: семафоры
хват: либо
код: статья знаем
детальн: опыт
утолщ: начинающих
модул: счет
кон: сферических
кот: кот
функц: функции
деньг: токсичные
брат: моего
продюсер: продюсер
тетрадк: тетрадке
новичк: ознакомление
брал: причинам
изолирова: имеют
звуч: собирались
старш: взрослые
доступн: дополнительно
возраст: субъективный касается капитулировать
маниакальн: маниакальное
енот: енота
вмест: вместо достоинства
разбор: детальным
форматирова: форматированную
ошибк: произошла
чип: сокращать
синтаксис: подобному
понемног: годов
обнов: обновить
навева: навевает
объект: первое любого
разработк: системы новичков разработка
закладк: закладки
паден: включая сильного
постановк: формате
продолжен: миром
занимательн: занимательные
накрыва: брата
перемест: переместить
высш: схватывают
преимуществ: переходе
произошл: пугается
вписа: вписать
стольк: зеркало
дел: выше дела
вопрос: вопросы банк повторить постановка
рассказа: дня
внутрен: находящихся
устройств: работу информация
пришел: проверять
размер: написал
переход: коде
ваш: запуск
докладыва: месяцев
ответ: дают позволю дождаться формулируется
изучен: решений
никт: фонд
пространств: тело
запакова: фотофиксация
семейн: части
творческ: приветствую
измер: считаем
август: директ
дет: тела
людьм: взаимоотношений
материал: исправляюсь
слыша: переписывал
мегапроект: стартапам
целостн: эксперта
хабр: поток хабр
заканчив: накопителя
седьм: выпустит
восстановлен: уголовного
карандаш: бумага
абстрактн: степени
отношен: субъекта
депрессивн: депрессивную
продл: продл
посмотрет: заставили
односложн: списков
технар: ных
клеток: клеток
месяц: траншами
сам: поговорим устройства бекграунд
примкнувш: примкнувших
куплен: купленная
стартап: ит образовательные
туториа: систем
школьн: школьной
подобн: знакомому неподготовленному
называ: физиологи текущей
выполнен: блокируя
длин: ушами
управлен: управление
неожида: самые
предназначен: аналогичные
принят: иностранного
нашл: астрономы
заключа: дилемм
век: рубежа
начина: интернеты электроника ситуация
очередн: комментариях
западн: инвесторов
вс: забираются
прогноз: трендов
популярн: статью научно
соцсет: появлением
научн: одно выжимку
одноклассник: оглядываетесь
вытесн: возможно
учетн: помнить
сво: новостей рассказать каждого
веб: платформы
программирован: программирование концепция
нача: боялись
реша: решать
жалк: делал
специалист: наметились
голован: вячеслав
порог: порог
станов: сайтов
гк: блоги
лежа: лежали
попробу: давайте
тест: бенчмарк
хранен: структуру
явля: целью василий
появлен: появления юзерами
вещ: неожиданные
неудивительн: неудивительно
освет: стоило
спроектирова: предстояло
теря: постепенно
уголовн: рамках
сайт: годом устройство
контрол: велосипедостроении
оборудован: серверным
научпоп: научпоп
продолж: случилось
происход: снятие
задач: интересной выполняться моих
пользова: пользоваться
различн: порицали
хвата: существенно
закидыва: программирования
лоскутн: рассматривали
сегодняшн: сегодняшнего
базов: языками
треб: базе
зовут: зовут
истор: история прочее
двум: дается
пробл: одна
ещ: слышал
сер: серию
сет: сети запрос
вид: запакованном возрастом
представител: индустрии
конфиденциальн: соглашение
защит: занимается
корпорац: южнокорейской
ищут: рынка
естествен: вопрос
курир: голованов
нескольк: нескольких
повтор: попросила
сокет: процессами
памя: разделяемая
позволя: правах
пережива: озу
сумм: сумму
эволюц: эволюция
хоч: показываю
рейтинг: рейтинга
известн: указания
исполн: операция
сторон: посмотреть
поток: публикаций потоки курирую
кратк: проприоцепцией вакууме
смотр: всякий
предостав: одновременно
поддержк: техническая
эмоциональн: объясняется
дня: доброго
родн: прагматичным
хорош: новых
оборот: сбавлять
наш: нашего кордицепса показать опытом
ин: иных
моделирова: любит
ит: вашего
пользовател: оповестить
просьб: сообщений
успешн: пользователя
большинств: закономерность
умн: стала
сервис: сервисы какого
оперативн: писали
информац: удаленной песочница
земн: количестве
ключев: ключевых
видим: конкретного
удален: существующей
посещен: посещения
математическ: математическая математического
лоскуток: согласно
велосипедостроен: отечественном
умолч: фонды
понят: абстрактное
сборк: пойдет
равнодушн: равнодушных
упа: производителей
поговор: запуска
худ: худой
ртка: нужного
клеточн: клеточные
квартал: привело
клеточк: клеточку клеточкам
сорок: салфетку
дожда: статус
идет: речь
например: возраста
предстоя: системах
моральн: разрешении
кордицепс: гриба
коллег: коллеги
увеличен: задач
запуск: фси процесс
соответств: доступность
нативн: реклама
попрос: головы
интуитивн: сразу
польз: жалко
заметок: заметок
стран: возраст
уровн: базовом ростом
мо: среди кухне
портрет: портреты
сист: данные блокируем
неб: небо
сбива: слова
качеств: рассмотрим
вычислительн: условиях
участк: покрытием
лан: гк
позитив: вдохновением
государств: тема
проблем: запроса целевого
айтишник: айтишника айтишники айтишниках существу вс
дешевет: оперативная
сервер: теста ответа
поставщик: стремление
раздел: регистрация
бород: борода
порица: хватили
лучш: лучшие
механизм: инструментах
управля: мозгом
предвзят: уменьшает
небольш: решил
оз: удар
формат: таком
дума: отсутствует деле
операц: следующая выполнять
крайн: годах
пойдет: сделать
интересн: интересное решения
оп: стартапа
возможн: мобильных
молод: большую
блокиру: ожидания самым
валя: валяется
выбра: отталкивались
увелич: собирается
учитыв: естественно
отображен: виде
дает: пришли
кульгин: максим
непосредствен: вскрытия
капитулирова: яростно
молож: среднем
крут: писал
пк: качестве
неуспешн: успешности
обобщ: поэтому
меша: никак
гриб: споров
тематическ: сериалы
выпуск: выпуске
изначальн: изначально
выпуст: издательство скоро
тянул: язык
пада: цены
откр: открыть
наход: знает
никак: сколково
непонятн: совершенно
magic: magic
ruvd: ruvds
zaka: zaka
bin: bin
dmt: dmt
compos: compose
theori: theory
evklidtop: evklidtop
cloud: cloud
twitter: twitter
samsergei: samsergey
java: java
dram: dram
gtd: gtd
xml: xml
hex: hex
block: blocks
api: api
decis: decision
hyper: hyper
ik: ik
python: python
kivi: kivy
selectel: selectel
io: ios
geniu: genius
xcode: xcode
iv: iv
cern: cern
makasin: makasin
otu: otus
flutter: flutter
rostbutaev: rostbutaev
ctype: ctypes
kopchenii: kopcheniy
vk: vk
dyadichenkoga: dyadichenkoga
http: http
habr: habr
firstvd: firstvds
job: job
bodi: body
unix: unix
rp: rps
jame: james
uniti: unity
sly: sly
game: games
code: code
offlinecrm: offlinecrm
jwt: jwt
android: android
timeweb: timeweb
webtron: webtronics
akaz: akaz
clickfraud: clickfraud
youtub: youtube
valid: validator
rust: rust
raspberri: raspberry
sd: sd
dart: dart
notion: notion
samsung: samsung
rss: rss
ftc: ftc
prettifi: prettifier
linux: linux
southbridg: southbridge
json: json
keigisdead: keigisdead
adminvp: adminvps
seo: seo
timestamp: timestamp
crm: crm
dannyk: dannyk
tokio: tokio
mind: mind
erp: erp
ov: ovs
greiv: greiv
facebook: facebook
kotlin: kotlin
telegram: telegram
erwinm: erwinmal
jessi: jessy
layout: layout layouts
sentimentaltroop: sentimentaltrooper
micro: micro
pi: pi
php: php
sashageo: sashageo
bia: bias
viktorz: viktorz
base: base
