обрат: обратить
найт: найти
говор: говорите
банк: банк
информацион: информационная
быстрот: быстроты
рассказ: рассказ
независим: независимо
стат: статью статей статья стать статье статьях статьи
стар: старую
рабоч: рабочем
дорог: дорогой
аспект: аспектах
составлен: составление
мнен: мнение мнению
предлага: предлагаю
объясн: объясню объяснить
обзор: обзора обзор
появ: появилась
случа: случаях
един: едином
гуля: гуляющих
работ: работа работе работы работу
общепринят: общепринятый
показыва: показывать
дополнительн: дополнительные
арт: артем арт
вернут: вернуться
терминал: терминалы
принос: приносит
вершин: вершине
сто: стоит
человек: человеко
критическ: критически
прийт: прийти
д: д
менеджмент: менеджмент
пробег: пробегусь
и: ии
каса: касается
мобильн: мобильных мобильного мобильная
должн: должны
ошибок: ошибок
структур: структура
публикац: публикации
скопирова: скопировать
дава: давай
подел: поделиться поделюсь
показа: показать показаться
пальц: пальцах
проиллюстрирова: проиллюстрировать
поэт: поэтому
отправ: отправить
человеческ: человеческом
котор: которое которому
времен: временному
мин: мин
осозна: осознали
вариант: варианты
мир: мир мире
примечан: примечание
писа: писал
предприят: предприятий
исследован: исследование
связа: связано связанных
прав: правило
безопасн: безопасность безопасности
проверя: проверяется
проект: проектах проекты проект
связ: связи
резк: резкий
недовольн: недовольных
феврал: февраля февраль
профил: профиль
заварива: завариваем
дела: делаем делать
тренд: трендах
сообщен: сообщений
получ: получил
оправда: оправдались
тестер: тестер
документац: документации
верн: верно
перевод: перевод
верс: версию
важн: важную важно важным
маркетинг: маркетинг
тестировщик: тестировщик тестировщикам тестировщика тестировщику тестировщиком тестировщиков тестировщики
ищет: ищет
анализиру: анализируя
час: часа часов
чат: чатов
прост: простой
трафик: трафика
прием: приемам
раскр: раскрою
собес: собес
индустр: индустрии
проверк: проверки проверке
здравств: здравствуйте
занима: занимается занимаются
позиц: позиция позицию
ворчун: ворчуна
следова: следовать
совместим: совместимости совместимость
тенденц: тенденции
повышен: повышения
уровен: уровень
нов: новые новый новое
придума: придумал
больш: больших большого большая большое
миллиард: миллиарда
почувствова: почувствовать
медийн: медийная
мест: место
приемочн: приемочное
тинькофф: тинькофф
иде: идея
карьер: карьера карьеру
инженер: инженер инженера инженеров
завод: заводим
игр: игр
пристальн: пристальное
наибольш: наибольшей
полезн: полезный полезных
модифицирова: модифицировать
постоя: постоянно постоянной
фикс: фиксов
системн: системный
определен: определение
сдела: сделать
эффективн: эффективными
сложн: сложный сложных
пробова: пробовал
автотест: автотестов
ча: чая
исправлен: исправлений
представлен: представление
совет: советы совет советами советов
примен: применить
жизн: жизни
пример: примеров примеры примеру
наташ: наташа
методолог: методологии
приоритет: приоритетом
систем: системам
выход: выхода выходит
пыта: пытается
мож: можем
сотн: сотни
момент: момент
смож: сможем
смог: смог
развива: развивается
основн: основным основные
геометрическ: геометрической
сможет: сможет
читател: читатель
ресурс: ресурсов ресурс ресурсы
сша: сша
метод: методы методов
машин: машинное
процесс: процесса процессе
аппарат: аппараты
групп: групп
кликбейт: кликбейт
техник: техники технику
привест: привести
выпуска: выпускаемого
приведет: приведет
решен: решений
написан: написание написанием
хотел: хотели хотел
доскональн: досконально
создател: создателем
продуктивн: продуктивного
провод: проводить проводит
средн: средний
фикстур: фикстуры
подряд: подряд
секрет: секрет секретов
помоч: помочь
помога: помогают
бесплатн: бесплатные
хаб: хабы
рынк: рынка
завал: завалил
материа: материал
повыс: повысить
помощ: помощи
современ: современном современные
изобил: изобилует
приложен: приложений приложения
выполня: выполняется
разработчик: разработчиков разработчик разработчики
банковск: банковских банковскими
опыт: опытом опыта опыте
продвинут: продвинутый
рынок: рынок
ваканс: вакансии
настройк: настройка настройки
вклад: вклад
дал: далее
альф: альфа альфы
дикт: диктует
документ: документы
прочтен: прочтение
будущ: будущем
ссылк: ссылке ссылку
прочита: прочитав прочитать
прокс: прокси
дан: данных данной данный данная
фильтрац: фильтрации
борьб: борьбе
картинк: картинке
код: кода код коды
вставля: вставляем
найдет: найдет
регистрац: регистрация
объяснен: объяснением
вредн: вредных
ситуац: ситуаций
фирм: фирма
поисков: поисковые
счита: считается считаю
функц: функций функциям
чашк: чашку
загрузк: загрузки
используем: используемой
цел: целью цель целей
цен: ценный
изъя: изъяны
понадоб: понадобятся
изуча: изучаю
старш: старшим
тестируем: тестируемого
возника: возникает
систематизац: систематизации
российск: российский российских российском
дзен: дзен
сохран: сохранить
подключ: подключить
вмест: вместо вместе
минимум: минимуму
тезис: тезисы
искусствен: искусственный
довол: доволен
ошибк: ошибками
тупик: тупик
банкомат: банкоматы
обнов: обновить
сегмент: сегменте
разработк: разработкой разработке разработка разработки
закладк: закладки
использова: использовать
разработа: разработано разработать
уверен: уверенности уверенность
начал: начале началом
стратег: стратегия стратегии стратегию
программн: программных программным программного программное
второстепен: второстепенную
руководств: руководство
взаимопомощ: взаимопомощи
сюд: сюда
релиз: релизу релизов
професс: профессии
гарантир: гарантирующих гарантирует
список: список
важност: важность
кадр: кадрах
пост: посте
закутыва: закутываемся
обеспеч: обеспечить
след: следует
лидерств: лидерство
дел: деле
вопрос: вопросы вопрос
штык: штыки
ближайш: ближайшем
дизайн: дизайна дизайн
резюм: резюме
невозможн: невозможно
производительн: производительность
концепц: концепцию
игра: играет играли
устройств: устройство
пришел: пришел
размер: размеров
клиент: клиентом клиентов
проигра: проиграли
неудачн: неудачным
суперлайфхак: суперлайфхаков
ваш: вашей вашем
перетестирова: перетестировать
так: таких таким
ответ: ответа
общен: общения
генерир: генерирую
нагрузочн: нагрузочного нагрузочному
баг: багами
сталкива: сталкивался
событ: событиями
течен: течение
ручн: ручного
редакц: редакцией
техническ: техническое техническая
ручк: ручками
алгоритм: алгоритмов
фев: фев
материал: материалов материале
заметк: заметка заметки
мегапроект: мегапроекты
описыва: описывает
хабр: хабр
порта: портала
обучен: обучения обучение
некотор: некоторые некоторых
отношен: отношения
застав: заставит
рассмотр: рассмотрены
потенциальн: потенциально
количеств: количество количества
введен: введение
соглашен: соглашение
услыша: услышать
добав: добавить
просмотр: просмотров
практик: практик
последн: последние
месяц: месяца месяц
сам: самый самое самым самыми
тво: твою
интеллект: интеллект
стереотип: стереотип
стро: строить
настраива: настраиваем
друг: другим
стартап: стартапов стартапам
туториа: туториал
приход: приходишь
правильн: правильно
задава: задавайте
поня: понял понять
вероятн: вероятность вероятно
компан: компаний компании компаниях
ограничен: ограничений
программ: программы
управлен: управление
вчер: вчера
получа: получается
работоспособн: работоспособность
ежедневн: ежедневно
разбира: разбирают
главн: главной
принят: принято
россельхозбанк: россельхозбанк
сбо: сбою
обеспечива: обеспечивает
пят: пяти
низк: низкая низким
созд: созда
неправильн: неправильно
подтверд: подтвердить
век: век
ассистент: ассистента
начина: начинаем начинающему начинающим начинающих
привет: привет
игрок: игроков
вс: вс
популярн: популярность
дайджест: дайджест
област: области
созда: создается создаем
сво: своими своим
веб: веб
кейс: кейсов кейс
действен: действенными
нача: начать
реша: решающую
отобража: отображались
специалист: специалистам
порог: порог
гк: гк
выполн: выполнить
интернет: интернета интернете
тест: тестов тест тесты теста
явля: является являюсь
появлен: появлению
узк: узкое
тем: тему
применя: применять
полн: полной
уделя: уделяется
администрирован: администрирование
развит: развитием
знат: знать
представ: представим
нестабильн: нестабильно
плед: плед
приглашен: приглашение
периодическ: периодически
сайт: сайта сайтов
обеспечен: обеспечения обеспечение
научпоп: научпоп
технолог: технологий технологии
продолж: продолжить
комментар: комментарии комментариях
задач: задача
происход: происходят
рамк: рамках
различн: различных
сотрудник: сотрудников
нейросет: нейросетей
проч: прочих прочего
работа: работаю работает работать
песочниц: песочницы песочница
долг: долгого
долж: должен
эконом: экономить
услуг: услуг услуги
задума: задумано
проанализирова: проанализировать
высококачествен: высококачественного
блог: блог
необходим: необходимое необходимостью необходимость
фреймворк: фреймворки
зовут: зовут
истор: историями историей истории
подходя: подходящего
числ: числе
модификац: модификации
автоматизац: автоматизации
зрен: зрения
ход: ходить
довер: доверие
модел: модели
исследова: исследовали
пробл: проблем
сложност: сложности
ещ: ещ
вниман: внимание
гибк: гибкого гибких
девайс: девайс
привед: приведем
автор: авторы авторов автором
сер: серии
очеред: очередь
чита: читать
вид: видишь
конфиденциальн: конфиденциальность
остр: остро
виде: видео
собеседован: собеседовании собеседование
заставля: заставляющим
подход: подходов подходы подход
затык: затыки
чуж: чужой
ноябр: ноября
тестирован: тестировании тестирования тестированию тестирование
историческ: исторически
нынешн: нынешнее
нескольк: нескольких
быстр: быстро
одобрен: одобрении
эмулятор: эмулятор
бизнес: бизнесе
стрем: стремятся
влия: влияет
прогресс: прогрессии
принима: принимаемых
выраст: вырасти
тип: типов типе
воспринима: воспринимать
характеристик: характеристикам
хоч: хочу
рейтинг: рейтинг рейтинга
скорост: скорость скоростей
удобств: удобство
реш: решил
общ: общих
залож: заложит
послуж: послужить
геймд: геймдев
постав: поставили
поток: потоки
кратк: краткое
поддержк: поддержка
недел: недель
модульн: модульный
принцип: принципов
предназнач: предназначена
хорош: хорошего хорошие хорошее хороший
иб: ибо
библиотек: библиотеки
удобн: удобно
предыдущ: предыдущей предыдущую предыдущего предыдущих
наш: нашему нашей нашем
ин: иных
перенаправлен: перенаправления перенаправлению
может: можете
пользовател: пользователей
посвящен: посвященных
андроид: андроид
люб: любого любой любое
успешн: успешность
над: надеюсь
язык: языка
большинств: большинство
сил: силы
захочет: захочется
доллар: долларов
сервис: сервисов
таблиц: таблица
критикова: критиковать
информац: информация информации
взят: взято
описа: описаны
основыва: основывается
гот: готов
разн: разного
автоматизатор: автоматизатор
анализ: анализа
телеграм: телеграма
всевозможн: всевозможные
маг: магии
выдума: выдуманных
герма: герман
спуст: спустя
ровн: ровно
год: годов
использу: используем
целев: целевой
конкретн: конкретную
ожидан: ожидания
зачаст: зачастую
площадок: площадок
мессенджер: мессенджерам
применен: применение применению применения
особ: особых особо
потеря: потерять
собра: собрать
содержательн: содержательными
привож: привожу
напл: наплыв
например: например
постара: постараюсь
мал: мала
одн: одна
подготовл: подготовлен
кассов: кассовые
отправля: отправляемых отправляется
подм: подмены
мар: мар
коллег: коллегам
реклам: реклама
корпоративн: корпоративный
потребн: потребности
соответств: соответствует
нативн: нативные
подборк: подборка
шаблон: шаблоны
помощник: помощник
инструмент: инструмент инструменты инструментов
огромн: огромные огромное
надежн: надежного надежность надежно
ток: токен
команд: команде командой
маск: маской
сообществ: сообществом сообществ сообщество
таков: таковых
врод: вроде
рассмотрет: рассмотреть
десятк: десятки
уровн: уровня
использован: использования использовании
мо: моих моей
запрос: запросу запросы запрос
кача: качаем
потрат: потратим
четк: четко
сист: систем
войт: войти
качеств: качества качеством качество
пригод: пригодиться
аккаунт: аккаунт
лан: ланит
выбор: выбора выбору
разочарова: разочарованных
смартфон: смартфоне
проблем: проблемой
подробн: подробно подробнее
сервер: сервер сервера сервером
раздел: разделы
радова: радоваться
оствановк: оствановке
яндекс: яндекс
островок: островок
новост: новости
лучш: лучшие лучший лучших
существ: существуют существует
перв: первую первое
механизм: механизмов
детектирован: детектирования
небольш: небольшой
дума: думаю
относ: относится
операц: операциями
облегч: облегчить
примечательн: примечательных
написа: написать
крайн: крайне
поиск: поиск
оп: опыт
возможн: возможности возможно
автоматизирова: автоматизированное
заказчик: заказчиков
основ: основе основу
высокотехнологичн: высокотехнологичной
дает: дает
образовательн: образовательные
хочет: хочет
как: каком каких
определ: определить
функциональн: функционального
крупн: крупных крупном
голос: голосов
оптимизирова: оптимизировать
страниц: страниц
тся: тся
прошл: прошлом
растет: растет
прежд: прежде
высок: высокая высокое высоких
наверн: наверное
реальн: реальных
обход: обхода
критик: критику
барчик: барчик
втор: вторая
дисклеймер: дисклеймер
рол: роль
контент: контента контент
изображен: изображение
точк: точки
откр: открыл открыть
способ: способов способ
форм: форм
напрям: напрямую
продукт: продуктов продукт продукту продукта
признак: признаки
источник: источнике
термин: термин
непонятн: непонятным непонятно
german: german
paaladin: paaladin
obojealexand: obojealexander
lfreak: lfreak
burpsuit: burpsuite
blog: blog
ssl: ssl
jarsign: jarsigner
hel: hel
dr: dr
qa: qa
robot: robotic
mode: mode
niio: niio
twitter: twitter
autom: automation
java: java
pin: pinning
postman: postman
west: west
vchetkov: vchetkov
lanit: lanit
api: api
cha: cha
phillennium: phillennium
adb: adb
ab: ab
qr: qr
python: python
maxim: maxim
usetech: usetech
ai: ai
gpt: gpt
molechka: molechka
junior: junior
otu: otus
openai: openai
unit: unit
malckaterina: malckaterina
vk: vk
sergeishaikin: sergeishaikin
nizkop: nizkopal
direviu: direvius
rusau: rusau
http: http https
habr: habr
suit: suite
autorespond: autoresponder
engin: engineer
apktool: apktool
kirilov: kirilov
groovi: groovy
milfgard: milfgard
android: android
artsiom: artsiom
kenya: kenya
youtub: youtube
tadvis: tadviser
proqualitycommun: proqualitycommunity
egoregor: egoregor
rss: rss
root: root
mitmproxi: mitmproxy
recoveri: recovery
chatgpt: chatgpt
profit: profit
rpa: rpa
process: process
art: art
bdd: bdd
agil: agile
pytest: pytest
facebook: facebook
kotlin: kotlin
telegram: telegram
team: team
tg: tg
charl: charles
leono: leono
gorodnya: gorodnya
tockieteacut: tockieteacute
tl: tl
php: php
olegchir: olegchir
manikosto: manikosto
burp: burp
