обыча: последующем
максимальн: функций
оценк: распространением
гипертекстов: обстоятельств
впоследств: соответствовать
влиян: оказывает
информацион: автоматизированных электронный
вступа: обязательных
понима: принимая законодательство
охра: знаков
образ: документов специальным
стат: обстоятельствах
ввод: представительства
взрывчат: аналогов
указан: счет
предлага: вопросам
соглас: осознает
стад: находятся
случа: необходимых доступный п составляют
удал: заблокировать
един: характера
последств: повлечь
повторя: воспроизводить
работ: работа нормальную профилактическими
расов: людей
рекламн: образом
ст: положениями
дополнительн: регулируется принимаемых изложенными случаях доводиться
показыва: публично
домен: следующих
доступ: распространении предоставления получить открытом
мероприят: участия
сетев: многоуровневого контенту интернет
предел: форме
иллюстрац: графические
получен: услуги
единоличн: определяемых
размеща: распространение другим
основан: неверную заключенный
обновлен: дополнения
человек: другого
послед: кабинету федерации
д: символы
схем: почты
некоммерческ: прямо
вообщ: пользователям
авторств: уведомлений
идентифицирова: позволяют
мобильн: соглашения планшет одноименного
изменя: определяется
личност: удостоверяющие
п: указанные
ошибок: надежно
регулир: сервисов указанного
структур: дочерние
суд: арбитражном
означа: уполномочившей
неисключительн: простую простая
сообщ: иным
котор: содержащую языка раздел действию
времен: собственному
осозна: доступен
изготовлен: совершать разъясняет
присоедин: старше
благ: нематериальные
усмотрен: единоличному
продава: копировать
назначен: возможностей функциональному
совершен: используемому считаются сообщений
связа: запись риски связанных порядок никак
прав: документы имеете смежных имеет
безопасн: подлинности
дееспособн: пользователь
обратн: блог
проверя: третьи
либ: интересе
порнограф: элементы
связ: обратная использованием
феврал: номер
относительн: заблуждение
пирамид: схемы
профил: создания
сообщен: поступления информация
аналог: веществ
получ: случаев результаты пользователю
договорн: каким
воспроизвод: запрещены
режим: интерактивном
подтвержда: воспользовавшись запросить ключ
полага: основания
объявлен: пределах
перевод: перерабатывать
верс: русскоязычной
важн: нотификаторы
исключен: объекта деятельности
маркетинг: сетевого
списк: поисковый
декабр: февраля
неопределен: раскрывать
воспроизведен: копирования электронного предоставлять
видеоматериал: аудио
прост: указанная удостоверенные безвозмездно
непредоставлен: личность
подлин: содержания
детск: порнографии
прям: разрешение
ауд: текстовые
заработк: системы
приравн: непредоставление
рубл: тысячами
проверк: осуществляет
вред: потерю
сдач: проката
зап: учетная
лиц: физическое юридического кругу третьим размещаемого
недостоверн: предоставлению неполна
подписа: непосредственно носителях
нов: добавление уведомления предусмотрено заменить факте
действительн: влияния
неимуществен: личные личных
нарушен: сходных допущенными грубом направленным обнаружения
мест: зависимости
част: определенной переуступить
предоставл: некоторых
порядок: регулирующих
счет: силами
опубликова: дополнительный действующая
субъект: характеристик
направлен: действиям путем
убытк: виды возместить
перерабатыва: переделывать
допущен: взыскания
полезн: полноты
модифицирова: выбору
одновремен: лицензия
постоя: стадии
отказ: позднее
определен: запретить термины особенности полностью толкованием
реквизит: ином
выдава: причинять
особен: регулировать
устанавлива: логинов
демонстрир: нравственность
представительств: незаконного
примен: вправе
пут: хабру
толкован: случае руководствоваться однозначного
сексуальн: рекламу
русск: составлено
переуступ: переработку
приоритет: дополнительном
доктрин: научной
систем: иных единая маркетинга
процедур: завершении
индивидуальн: сохранность
пропаганд: демонстрирует
несовершеннолетн: нарушать
лиценз: вышеуказанной неисключительную неисключительная
копирова: повторять
неизмен: правообладателя
приним: пользовании
момент: силу оставляет
персональн: хранения устройство включать
исполня: показывать
основн: определяются
привлечен: паспортных
обрабатыва: хранится
заблокирова: своему
категор: отдельных
имуществен: претензий
ресурс: ссылки
лиша: соглашений
процесс: исков
основа: большинства поскольку соответствие
произошедш: убытков
свойств: относительно
информирован: нотификаторов
почт: ключа электронной
требован: нарушении гарантирует неимущественных устанавливать
передава: посылать
актуальн: поддерживать
личн: определяет записи пароль связанная третьих имущественных усмотрению
многоуровнев: пирамид
номер: регистрационный
поздн: защиту
нравствен: оскорбляет
носител: бумажных
меня: характер
выбира: самостоятельно
помощ: доступные заказа
поддомен: отношении
приложен: прохождения информирования предоставляемых авторизации пользования требований мобильное условия
полов: этническому
результат: ошибок
введ: введено
заключ: заключить
одноимен: сайта
оскорбля: клеветнической
заключительн: нового
дал: далее
текст: дизайна толкования соответствии условий
товарн: авторского
документ: предоставленных документе документ подписании обязательными тексте обязательные равнозначными
предложен: предложение
собственноручн: подписанным
входя: воспроизведения
идентификатор: приложениях
ссылк: работу гипертекстовой таких
прекрат: соблюдать
обяз: каком
нематериальн: принадлежащие
ключ: адреса конфиденциальность
интерес: нарушения законные имени собственном
агент: руководство
средств: программных
изъят: противоречить каких
сходн: подобных
дан: новый предусмотренные соответствуют базы
потребова: момент
веществ: наркотических
имен: выступающее
идентификац: официальную
указа: явно данным иные страницах изменениями редакция необходимом сублицензирование своем
раскрыт: утраты
коммуникатор: телефон
осуществля: пользователями обязан пароля
закон: нарушает достоверности
арбитражн: подведомственности
изложен: отдельности подробным изложенных
зарегистрирова: д какое зарегистрироваться
росс: статьей
регистрац: система назначения
толк: настоящее
регулируем: отношений
несанкционирова: мероприятиях способ
пропагандир: собственности
имеет: недостоверна согласны
эротик: детской
поисков: спам
декомпиляц: баз
нотариальн: предоставив
счита: совершенные
отсутств: текстом наличие объектов
формирован: факт
функц: отсутствие
причин: понимается ущерб
предусмотрен: последствия
отказа: учетную
используем: соответствует
цел: использоваться основанного устройства
сообща: исполнение
старш: лицо
доступн: размещенной иными сайтах систем размещенный коммерческих
звук: музыка
возраст: достигли
российск: нормам законодательством
незакон: распространять способы
сохран: почте
политик: связанного обрабатывается
доведен: сайте показ
окончательн: временно
финансов: разбирательств
нотификатор: электронные прочего
коммерческ: продавать услугу
интеллектуальн: жестокость авторов
спор: разрешению
неверн: предоставляет
объект: прочие являются субъектов сохранении
завершен: изменяться
несет: которым
частност: подтверждающие
налич: предоставляется законодательства возлагается
довод: ограничениях
удостоверен: взаимоотношениях
использова: позволяющее соглашении надежными
графическ: текст
загружа: параметры такового материалы
логин: требования персональные выбирает определенных
программн: осуществляется
руководств: структуры инструкции
достаточн: сообщества
пройт: требованию
установк: предназначенная
заблужден: вводить
регулирова: сайтов
настоя: присоединившееся настоящем создает настоящий заключительные кодекса
гарантир: целям
лтд: паблишинг
импорт: взаймы
кабинет: личному личным личный личном личного
строг: всеобщего
след: адресам лицензию применяются образующих
наложен: привлечения
вправ: идентифицировать
вопрос: информацию вопросы
организац: адрес представителя
дизайн: помощи
помим: происходящих
устройств: доступа целях использования
текстов: изображения
ваш: ограничений
ненадлежа: интересов
ответ: ответы
так: сообщать толкование доступность
письмен: направления
москв: суде
публикова: лиц
нормальн: хранить
полност: использовании
срок: максимальный
событ: важных
собствен: необходимости рекламы свой претензии интеллектуальной соглашению
копирован: способами
редакц: новая новой
баз: программ программы
хран: кабинете собирать
измен: относящиеся
территор: добавлением
этническ: расовому
обязует: стороны
посыла: загружать
материал: ожиданиям размещенных
символ: допустимые
двадцат: ограничена
собира: несанкционированно
уведомлен: специального товарных
хабр: сообщить присваиваемого хабр хабра
вредоносн: незаконной
басма: москвы
некотор: языке
отношен: ним поддомены вытекающие договорным
авторизац: регистрацию регистрации
соглаша: блага
соглашен: настоящим бездействие соглашение настоящему условиями отдельные
жесток: насилие
оформлен: совершенными
подведомствен: рассмотрению
просмотр: авторизацию профиля
взыскан: наложения
район: басманном
специальн: срок изменено разрешенную
содержан: проверку лицами
услов: соответствующими условиях основные обязательным некоммерческого пользователем
объем: необходимого полном
дискриминац: ненависть
представля: интересах представляет
друг: передавать выдавать ознакомления
ознакомлен: предоставлено
возлага: рублей
смежн: авторских
оказыва: силы
символьн: уникальное
подобн: отказ
компан: означает компании
программ: элементов связи устройстве
ограничен: изъятий разделе установленных
длин: паролю
гонорар: издержек
предприня: лишает
управлен: просмотра
получа: которому
наименован: автора
поддом: включая
составл: процессуальным
действ: совершения отсутствии действие противоречит содействовать наличии руководства соответствия своими незамедлительно установленном
предназначен: приложение числе
характер: форма любого
делов: обычаями
принят: безоговорочное предварительной
допуска: применение
иск: судебных
перечен: правилами
юридическ: представляемого имеющими
достигл: подтверждаете
наруша: содержание оружия которыми
заключа: поддоменов
элемент: состав организаций
октябр: июня
заверен: нотариально
состоян: актуальном
интерактивн: таким
обязан: посредством
лимит: признаете
показ: публичный
имеют: приоритет
использ: отдельного
научн: оборота
созда: контента процедуры
учетн: содержащаяся удалить уникальная
вышеуказа: распоряжение
профилактическ: приложению
имеющ: недействительными
сво: использует раскрытия изъятиями право
отдельн: вообще пользователей дополнительными заключаются основанных какого
возникш: урегулировать
взаимоотношен: подписи
специалист: специалистов
сохранен: условии виде
интернет: сети
предоставля: услуг использование экземпляры впоследствии состоянии котором риск
оруж: взрывчатых
хранен: предназначен
урегулирова: обязательство толкуется
явля: равно условием размещенные
незамедлительн: договора
применя: сторон достаточных
официальн: пройти
сведен: доведения
полн: является достоверную ознакомились
относя: опубликованы закрепленные относящемся
развит: развитие
пользовательск: пользовательское
груб: многократном
предусмотр: удобной
сайт: размещения правил лица относящихся любую сайт
определя: системах соглашением дополнительных зарегистрированный
руководствова: следует
знак: сохранения
рамк: окончательно
запрещ: строго
сотрудник: агентов
адрес: доступной чужих сетевым подпись оскорбления
проч: помимо видеоматериалы
трет: компьютеру содержать интересы
компьютер: персональный причинить
запрет: средств нарушение
причиня: несовершеннолетних
долж: согласен
правообладател: наименования исключительных
исключительн: объектами
услуг: комплекс продукта продукт
норм: действующим налагаемых
оставля: части
телефон: мобильный
треб: доступе
необходим: предварительного лицензии принятия наличия кабинетом
вин: действиях
блог: октября
числ: данных
модификац: декомпиляция
разъясня: видом
факт: данном подтверждает установления
параметр: специальные
посредств: распространяемого
автор: неимущественные псевдонима
очеред: первую
сет: доступных
конфиденциальн: политики соответствующих
вид: сексуального предварительную неизменном отдельному
представител: человека
виде: иллюстрации
процессуальн: районном
распоряжен: стран
положен: настоящего одно положения
разрешен: отношениям получил подлежат
защит: предпринять
чуж: списки
явн: российского
оценива: должен
кодекс: гражданского
заключен: права документами
быстр: предоставляться
ущерб: финансовой возможные
одобрен: размещенная
договор: договор заключение
бизнес: заработка
принима: дополнительно объеме предоставляются
позволя: указанным эвм иное
памя: материальной
характеристик: свойств
предоставлен: данные предназначенные полагать приравнено контентом адресу
поврежден: ущерба
распространен: объема размещении функционала размещением
международн: нормы
общ: функционального общие
гражданск: ст
закреплен: соответствующего
сторон: вашей отношениях
прокат: продажи
подтвержден: потребовать
указыва: исключением
защища: компания
предостав: обязуется идентификацию
остальн: применимость
призна: подписью положений понимаете подписанные
поддержива: предлагаемым
тысяч: двадцатью
ненавист: пропагандирует
включ: доменах
претенз: соответствующие возникшие
профессиональн: профессиональное
предназнач: приложении
паспортн: указанием
налага: запретов
материальн: экземпляров
удобн: иной
соста: входящих
переделыва: модифицировать
оборот: делового
разбирательств: процессов
социальн: религиозному
ин: применения хабром сведения ненадлежащего управления версии использованы смартфон
недействительн: признаны
пользовател: лимиты основании позволяющая меры рамках персональных принятие транслируемым
религиозн: половому
люб: сервиса законности приложений способом любые сайты вследствие сообщения
зависим: категорий
авторск: охраны объекты
компонент: безопасности
язык: русском пребывания
большинств: необходима
сил: вступает собственными юридической
заказ: оформление
обяза: соглашается
сублицензирован: часть
обязательн: указанными новых тексту требует указанных
содержа: страницу случаи пользователе
публичн: модификация импорт исполнять
сервис: доступ публиковать использовать основе сервисы предоставление приложениям
происходя: событиях
соответствова: требованиям
информац: полную таковыми недостоверной
насил: пропагандой
составля: исключение
выбир: индивидуальное
письм: загружаемое
удален: удаленная
адвокат: гонораров
возмест: нарушениями
присваива: идентификатора
люд: дискриминацию
замен: указан
дополнен: определения постоянного
предварительн: перечень меняться осуществлять
подписан: свидетельствует
дочерн: защищать
добавлен: одновременно любое
ожидан: полученных
парол: изменение символьное логину
законодательств: очередь действующего согласно термином
бездейств: остальных
физическ: дееспособное
применен: изготовления обязательной
эвм: программа
поступлен: использованию
создан: пользователя
размещен: коммерческого связанные сервисам просмотр конфиденциальности приложением момента материалов предоставленным обязанность звуки
принадлежа: посягает
разреша: регулируемых
блокчейн: реквизиты
запис: учетной
содействова: действующему
подп: электронная
например: качестве
спам: рекламную
вна: сдачи
одн: причинам
продаж: сетевыми
правил: установленными
самостоятельн: политикой
согласн: прекратить действия
регистрацион: лтд
реклам: эротики распространения
псевдоним: авторстве
издержек: повреждения
рекомендац: одобрением
бумажн: документам
наркотическ: иного
функциона: изменении
равнозначн: признаются
соответств: производится возможностями намерение имеют компонентов документах нарушаются ответственности собственноручной
свидетельств: помощью
распространя: размещать вида
надежн: оценку точными быстро
достоверн: проверяются предоставить
обстоятельств: изложением любых
сообществ: сообщество организации
ознаком: возраста
уполномоч: зарегистрировалось
огранич: россии
музык: видео
экземпляр: изготовление воспроизведение
ответствен: несет никакой
таков: являющиеся полезности
федерац: российской
рассмотрен: нарушений
уникальн: создается логин
соблюда: обязуетесь
электрон: адресов признается указанный память информационные
участ: счастья
стран: территории
инструкц: какие
использован: доктриной отказать действий установки сервису
запрос: подтверждения
поскольк: вред
включа: сервисе
вследств: произошедшие
сист: информационных
войт: войти
качеств: целей фактов
многократн: убытки
комплекс: назначению
подпис: простой продукции
прохожден: получает
счаст: бизнесов
деятельн: продуктов
выбор: режиме
расхожден: другом
безоговорочн: полное
производ: термина
подлежат: урегулированные
смартфон: коммуникатор
утрат: несанкционированного
порядк: разрешаются
обнаружен: международного
подробн: письменного
соверша: следующими
удостоверя: частности
намерен: документа
раздел: кабинет логина
пользован: ограничения странице
полнот: надежности
транслируем: размещенным
вытека: вытекающих споры
перв: определенным
повлеч: информации
изменен: дополнениями последующее работами
автоматизирова: любая
возможн: функциональных ответственность функциональными
посяга: интеллектуальные
допустим: длина
равн: прав
переработк: перевод
основ: предоставляемого
планшет: компьютер
открыт: размещенного
отображен: размещение
исполнен: публичное
пребыван: места
всеобщ: доведение
противореч: ресурсы определенного кабинета
как: противоречия принимаете отдельной вины законодательству письма
функциональн: доступными сервис правообладателей объявленных
безвозмездн: указывается
непосредствен: формирования
неполн: предоставленная
страниц: мобильного опубликована ссылкой
судебн: сотрудников
содерж: признакам
раскрыва: действиями
паблишинг: блокчейн
применим: действительность
круг: неопределенному
обязательств: заверенное
точн: получены
выступа: либо
контент: отображение приложения воспроизведенному связан
изображен: контент
воспользова: редакцией
риск: собственный оценивать
установлен: допускается например загружаемой порядке
однозначн: отсутствия
способ: выбирая общих любым формы
июл: декабря
форм: применять обновления любой
мер: применить
взайм: внаем
продукц: собственных
июн: июля
наход: основанные
русскоязычн: расхождения
продукт: рекомендацией ссылка качество
признак: социальному
оскорблен: содержит
клеветническ: вредоносной
никак: адвокатов принимает
потер: лицам
термин: следующие такого указано
agreement: agreement
mail: mail
qna: qna
org: org
offic: office
nicosia: nicosia
habrastorag: habrastorage
mlm: mlm
confidenti: confidential
blockchain: blockchain
build: building
kermia: kermia
flat: flat
cypru: cyprus
publish: publishing
diagor: diagorou
english: english
habr: habr
http: https
floor: floor
support: support
account: account
info: info
