разговарива: разговаривают
максимальн: максимальной
найт: найти
оценк: оценку оценки
движ: движемся
понима: понимает понимают понимать
информацион: информационными информационных информационной
быстрот: быстрота
образ: образом
значен: значение
стат: стать статье статья
обоснова: обосновать
стар: старую
приверженц: приверженцы
предлага: предлагает предлагают
гибкост: гибкость
соглас: согласуйте
случа: случае
успех: успех
един: единых единого
последств: последствиям последствия
реализова: реализовать
работ: работа работе работы работу
дополнительн: дополнительных
доступ: доступами
вернут: вернуться
затрагива: затрагивает
сетев: сетевой
принос: приносить
инфраструктур: инфраструктуры
александр: александр
обновлен: обновления обновление
критическ: критически
д: д
менеджмент: менеджмент менеджмента
должн: должны должна
снижен: снижения
структур: структура структуры структуру
регулир: регулирует
публикац: публикации
дава: давать
означа: означает
карт: карты
подел: поделиться
поэт: поэтому
наилучш: наилучшим
взаимосвяза: взаимосвязанные
благодар: благодаря
котор: которую котором
карм: карма
мин: мин
осозна: осознанное осознанно
законодательн: законодательным
шаг: шаги
хакерск: хакерских
прав: правило правила
безопасн: безопасности
обратн: обратная
этап: этап этапах этапе
соблюден: соблюдение
либ: либо
скор: скорее
проект: проектов проекты проект проектами проекта
связ: связь
упроща: упрощается
профил: профиль
проектн: проектного проектном
получ: получить
модн: модным
верн: верным верный верные
перевод: переводить
отчетн: отчетность отчетности
верс: версию версия
важн: важной важными важно
член: членам член
маркетинг: маркетинг маркетинга
книг: книг
подготовьт: подготовьте
рассматрив: рассматривая
нност: нность
сосредоточ: сосредоточены
внутр: внутри
актив: активов
укрепля: укреплять
ауд: аудит
занима: заниматься занимаюсь
позиц: позиции
сертифицир: сертифицирует
эксплуатац: эксплуатации
повышен: повышение
уровен: уровень
больш: большей большим большую
медийн: медийная
част: частью
счет: счет
партнерств: партнерство
несоблюден: несоблюдение
вход: входят
направлен: направлениям направленности направления
шифрован: шифрование
полезн: полезные полезными полезна
постоя: постоянное постоянного
ясн: ясно
нны: нные
определен: определения определений определенные
сдела: сделать
эффективн: эффективность эффективности эффективно эффективных
устанавлива: устанавливать
минимизирова: минимизировать
ориентац: ориентация
исправлен: исправлению
пут: путем
примен: применим
операцион: операционной
систем: системы
влечет: влечет
рефакторинг: рефакторинга
узна: узнать
момент: момент
основн: основные
текущ: текущее
ресурс: ресурсами ресурсы
процесс: процессами процесс процессы процессов процессам
выявл: выявлены
помогут: помогут
привест: привести
требован: требованиям требованиях требования требований
решен: решениях решений решения
доказательств: доказательства
постепен: постепенного
хотел: хотел
прозрачн: прозрачность
сопровожд: сопровожден
актуальн: актуальная
комментирова: комментировать
провод: проводить
средн: средний
помога: помогают помогает
хаб: хабы
рынк: рынке
повыс: повысить
помощ: помощью
современ: современного
бенчмарк: бенчмарки
слайд: слайдов
выш: выше
составьт: составьте
разработчик: разработчик разработчики
результат: результатов
подразумева: подразумевает
дорожн: дорожные
ваканс: вакансии
настройк: настройка
организацион: организационная организационной
контекст: контекст
показател: показатель
документ: документы документ
прочтен: прочтение
стейкхолдер: стейкхолдеров
отнима: отнимает
грамотн: грамотное
профильн: профильное
фокус: фокус
интерес: интересы
инвестиц: инвестиций
подойдут: подойдут
средств: средств
штраф: штрафы
масштабируем: масштабируемость
михайл: михайлов
дан: данных данными данный данном
коррелирова: коррелировать
дат: дать
закон: законы
рост: рост
регистрац: регистрация
тестирова: тестировать
технологическ: технологических
допуст: допустить
привязк: привязке
имеет: имеет
гипотез: гипотезы
цикл: цикл
вовлеч: вовлеч
отсутств: отсутствует
различ: различия
функц: функции
цел: цель целей целями целом целям целью цели
манипуляц: манипуляции
переложен: переложении
отлича: отличаются
проанализир: проанализируйте
заран: заранее
кажд: каждой каждому
руководител: руководитель руководителя руководители руководителям руководителей руководителю
оцен: оцените
дзен: дзен
политик: политики политику
взаимодейств: взаимодействие взаимодействия
максимизирова: максимизировать
вмест: вместо вместе
финансов: финансовых
зарабатыва: зарабатываете
директор: директор директора
достич: достичь
обнов: обновить
разработк: разработкой разработке разработку разработка разработки
ведет: ведется
серьезн: серьезным
закладк: закладки
использова: использовать использованы
разработа: разработайте разработать
точечн: точечного
стратег: стратегией стратегия стратегии стратегию стратегий
программн: программного
руководств: руководства руководство руководством
установк: установка
учитыва: учитывать
метрик: метриками метрики метрик
релиз: релизы
справочн: справочных
преимуществ: преимущества преимуществах
список: список
ориентирова: ориентированы
повыша: повышать повышает повышается
укладыва: укладываться
обеспеч: обеспечить
минут: минут
след: следует следующее следующие следующими
организац: организацию организации организация
вопрос: вопроса вопрос вопросы
ближайш: ближайшие
дизайн: дизайн
рассказа: рассказать
бюджет: бюджеты
производительн: производительности производительность
концепц: концепции
пошагов: пошаговое
регламентир: регламентирует
устройств: устройство
клиент: клиентов
ваш: вашей
намечен: намеченные
ответ: ответить
так: таких таким
уязвим: уязвимостей
срок: сроки
разрабатыв: разрабатывая
техническ: технический технического техническая технических технические техническому
баз: баз
оптимальн: оптимальны
подспор: подспорьем
удовлетворен: удовлетворенности
разниц: разницу
материал: материалов
мегапроект: мегапроекты
хабр: хабр
обучен: обучение
аргументирова: аргументировать
отношен: отношении отношение
инхаус: инхаус
рассмотр: рассмотрим
потенциальн: потенциальные
утечек: утечек
введен: введение
количеств: количество количеством
соглашен: соглашение
добав: добавить
просмотр: просмотров
практик: практика практики практикам
методик: методики
сам: самый самым
представля: представляет
сутк: сутки
стартап: стартапам
семенюк: семенюк
зон: зоны
сбор: сбор
менеджер: менеджеров менеджерам менеджера менеджер менеджеры
компан: компанией компания компаний компании
степен: степени
программ: программу программы
управлен: управлению управление управлением управлении управления
коммуникац: коммуникации
получа: получает получают
принят: принятые принято принятия принятии принятие
главн: главное главных
действ: действия действий
руковод: руководил
обеспечива: обеспечивает обеспечивается обеспечивать
иск: иски
элемент: элемент
заключа: заключается
начина: начинал
привет: привет
стратегическ: стратегическое стратегическим
внедр: внедрить внедрены внедряя
стандарт: стандарт стандарты стандартом стандарту стандарта стандартам
состоян: состояние
обязан: обязанности
популярн: популярные
отдел: отделов
ускор: ускорить
област: области область
использ: используйте
изуч: изучите
созда: создать
достига: достигать
веб: веб
стол: столь
реша: решающее
специалист: специалистов
слаб: слабых
станов: становится
оглавлен: оглавление
атак: атак
хранен: хранение
реализац: реализацию
тег: теги
явля: является являются
приоритизирова: приоритизировать
оптимизац: оптимизации
свод: сводом
привычн: привычным
применя: применяются применять
уделя: уделяет
администрирован: администрирование
развит: развитием развития развитие
консультант: консультант
знат: знать
тимлид: тимлидов тимлида тимлидам
определя: определяет
сайт: сайта сайт
обеспечен: обеспечения
контрол: контроль контроля
руководствова: руководствоваться
выстро: выстроена
научпоп: научпоп
технолог: технологиями технологий
задач: задачами задачи
поставк: поставки
комментар: комментарии
прощ: проще
сотрудник: сотрудники сотрудниками
различн: различным
проч: прочие
аутстаффинг: аутстаффинг
работа: работаю
трем: тремя
сертификац: сертификация сертификации
песочниц: песочница
подразделен: подразделения
долж: должен
норм: нормам
услуг: услугами услуг услуги
аутсорсинг: аутсорсинг
необходим: необходимо
блог: блог
фреймворк: фреймворк фреймворки фреймворка фреймворками
зовут: зовут
истор: истории
зрен: зрения
довер: доверие
инициат: инициатив
модел: модель
сложност: сложности
параметр: параметрам
вниман: внимание
автор: авторы автор автором авторов
снижа: снижает снижается
очеред: очередь
опор: опора
легк: легкому
сет: сетей
конфиденциальн: конфиденциальности конфиденциальность
вид: виде
отдач: отдачу отдачи
подход: подходам подхода
регулятор: регуляторов
защит: защиты
тестирован: тестирование тестирования
сесс: сессий
оценива: оцениваете оценивать
заключен: заключение
нескольк: нескольких
быстр: быстро
эквивалент: эквиваленты
неэффективн: неэффективно
бизнес: бизнесом бизнеса бизнес
принима: принимает принимать
долговремен: долговременный
инновац: инновации инновациям
позволя: позволяет
спектр: спектр
инцидент: инцидентами
внедрен: внедрению внедрения
распространен: распространению
рейтинг: рейтинг
реч: речь
отрасл: отрасли
реш: решите
генеральн: генерального
общ: общую общей общие
сторон: сторон стороны
поток: потоки
защища: защищать
первопроходц: первопроходцы
поддержк: поддержка поддержку
зада: задают
поддержива: поддерживающих
включ: включая
доб: добиться
модульн: модульную
принцип: принципами принципы
сред: среде
опира: опираться
ин: иного
возьм: возьмем
улучш: улучшить
устойчив: устойчивость
ит: ит
люб: любым
успешн: успешной
компонент: компонентов компоненты
способствова: способствовать
язык: язык языка
потреб: потребуются
планирован: планированию
согласова: согласовать
заказ: заказами
затрат: затрат
план: план
обязательн: обязательная
несомнен: несомненным
сервис: сервисы
измерен: измерение
регулярн: регулярные регулярная
мониторинг: мониторинга
информац: информация информации
составля: составляющая
облачн: облачные
разн: разные
ключев: ключевые ключевой
анализ: анализа
последовател: последователи
способств: способствует
отвеча: отвечал отвечать
использу: используя
целев: целевое
конкретн: конкретные
требова: требовать
парол: паролями
понят: понятия понятие
законодательств: законодательству законодательства
применен: применения
создан: создание созданию
администратор: администраторы
особ: особое
идет: идет
привод: приводит приводить приводил
например: например
одн: одним
правил: правилам
широк: широкий широкое
увеличен: увеличение
реклам: реклама
задокументирова: задокументирована
разбер: разберем
презентац: презентации
прид: придем
корпоративн: корпоративной корпоративный
приб: прибыли
понятн: понятные
рекомендац: рекомендации рекомендаций
соответств: соответствия соответствующие соответствии соответствие
нативн: нативные
инструмент: инструментам инструменты инструментах
команд: команды команде командой командами команд
польз: пользу польза
синонимичн: синонимичные
ответствен: ответственности
деминг: деминга
соблюда: соблюдать
нормативн: нормативных
использован: использование использованию
уровн: уровня
поскольк: поскольку
четк: четко
включа: включают включающее
сист: систему систем
матриц: матрицу
войт: войти
качеств: качества качестве качество
своевремен: своевременная
распредел: распределите
обосновыва: обосновывать
аккаунт: аккаунт
деятельн: деятельность
подробн: подробное
репутацион: репутационных репутационные
раздел: разделы
похож: похожие
угроз: угрозы угроз
яндекс: яндекс
тактическ: тактической
новост: новости
владимир: владимир
существ: существуют существует существующие существующим
киберзащищ: киберзащищ
лучш: лучшие
перв: первую первых
добавьт: добавьте
управля: управлять
достижен: достижению
относ: относится относиться относятся
операц: операций
приня: принять
поиск: поиск
возможн: возможность возможных возможные
изменен: изменение изменения изменениями
основ: основе основу
выбра: выбранные
образовательн: образовательные
как: какие каких
определ: определите определить
непосредствен: непосредственно
персона: персонала
судебн: судебные
ориентир: ориентир ориентиров
рассматрива: рассматривает рассматриваю
взгляд: взгляд
прибега: прибегают
охватыва: охватывающую
высок: высокий
втор: вторых
рол: роли роль
риск: рисками риски риск
точк: точки
улучша: улучшать
сфер: сфере
откр: открыть
отраслев: отраслевым отраслевые
способ: способ способы
мер: меры мер
долгосрочн: долгосрочных долгосрочный
сперв: сперва
русскоязычн: русскоязычные
продукт: продуктов продукта
улучшен: улучшение
потер: потерь потери
термин: термина
vladimir: vladimir
iso: iso
govern: governance
waterfal: waterfall
devop: devops
cobit: cobit
cio: cio
error: error
youtub: youtube
twitter: twitter
rate: rate
faq: faq
okr: okr
cto: cto
raci: raci
product: production
agil: agile
brainstorm: brainstorm
facebook: facebook
telegram: telegram
manag: management
market: market
firewal: firewalls
semenyuk: semenyuk
vk: vk
uptim: uptime
habr: habr
time: time
itil: itil
swot: swot
object: objectives
