говор: говорите говорят
расскаж: расскажем
значен: значение
стат: стать статье статьи статья
сравн: сравни
имитир: имитирующих
стар: старую
рабоч: рабочем рабочие
стал: стала стали
составлен: составлением
мнен: мнению
объясн: объясню
гибкост: гибкости
реализова: реализовать
гуля: гуляющих
работ: работа работе работы работу
общепринят: общепринятый
показыва: показывать
дополнительн: дополнительные
проблематик: проблематика
арт: артем
сценар: сценарии
получен: полученном
пандем: пандемия
учебн: учебный
человек: человека
критическ: критически
слома: сломались сломать
менеджмент: менеджмент
заполня: заполнять
интеграц: интеграции
каса: касается
мобильн: мобильных
должн: должны должна
структур: структура
публикац: публикации
скопирова: скопировать
попрост: попросту
подел: поделиться поделимся поделюсь
пальц: пальцев
жестк: жесткие
предсказуем: предсказуемом предсказуемым
котор: которым которое котором которому которыми
примечан: примечание
эксперимент: экспериментов
шаг: шаги
связа: связано
прав: правят
проверя: проверяется проверяли
небесн: небесного
либ: либо
проект: проектов проекте проектом проекты проект
синимекс: синимекс
связ: связи
недовольн: недовольных
появля: появляются
профил: профиль
дела: делает делать
кэширован: кэширование
ребят: ребята
проектн: проектные
верн: верна верно
верс: версию
маркетинг: маркетинг
разобра: разобраться
анализиру: анализируя
прост: простой
позвол: позволив
проверк: проверки проверке
занима: занимал занимается занимаюсь занимаются занимались
следова: следовать
совместим: совместимости совместимость
уровен: уровень
очевидн: очевидным
нов: новые новым новой
придума: придумал
почувствова: почувствовать
медийн: медийная
част: частью
устро: устроилась
отказ: отказов
постоя: постоянно постоянной
нны: нные
фикс: фиксов
системн: системный
определен: определение
сдела: сделать сделали
сложн: сложный сложных сложно
прорабатыва: прорабатывать
дают: дают
совет: совет
примен: применить
пут: путь пути путем
пример: примеры примеру примере
тестир: тестируют
персонал: персоналом
систем: системы системам
выход: выходить
должност: должность
трудн: труднее
сожален: сожалению
курс: курс курсов
облада: обладать
ресурс: ресурсов ресурсы
метод: методом
машин: машинах машине
процесс: процессе процесс процессы процессу процесса
групп: групп
помогут: помогут
приступа: приступать
окружа: окружающий
приведет: приведет
комфортн: комфортнее
подряд: подряд
помоч: помочь
помога: помогают помогает
бесплатн: бесплатные
рынк: рынке
онбординг: онбординга
современ: современном
приложен: приложений
разработчик: разработчиков разработчикам разработчик разработчики
вклад: вклад
интерва: интервал
будущ: будущем
мигрирова: мигрировать
мышк: мышки
лоб: лоб
навык: навыкам навыками навыках навыки навыка
профильн: профильного
автоназначен: автоназначения
прогон: прогона
дисциплин: дисциплина
сравнен: сравнение
придумыва: придумывайте
рост: роста
регистрац: регистрация регистрации
ситуац: ситуации
гипотез: гипотезы
фирм: фирма
цикл: цикла
счита: считаем считается считаю
некорректн: некорректно
эффект: эффекте
отсутств: отсутствует
цел: целом цель целей целью цели
тополог: топология
окон: окон
миграц: миграции
дзен: дзен
множеств: множество
взаимодейств: взаимодействие взаимодействия
золот: золотые
довол: доволен
налич: наличие
использова: использовать использовали
логик: логики
стратег: стратегия стратегии стратегию
пройт: пройти
достаточн: достаточного
примерн: примерно
взаимопомощ: взаимопомощи
пельмен: пельменей
сюд: сюда
професс: профессии
карьерн: карьерного
настоя: настоящая
список: список
знаком: знакомых
воропаев: воропаева
след: следить следует
штык: штыки
дизайн: дизайн
резюм: резюме
невозможн: невозможно
производительн: производительность
концепц: концепцию
заряд: зарядили
попробова: попробовать
клиент: клиентом клиентов
перетестирова: перетестировать
так: таких таким
общен: общения
поменя: поменялась
отсылк: отсылки
пятниц: пятницам
событ: событиями
оптимальн: оптимальными
баз: баз база базы базу базой
техническ: техническая технических технического
фев: фев
доходчив: доходчивые
приспособ: приспособиться
контролируем: контролируемых
внесл: внесла
подошл: подошли
формул: формула
аналитик: аналитики
обсуд: обсудим
некотор: некоторое некоторыми
застав: заставит
рассмотр: рассмотрим
потенциальн: потенциальные потенциально
эпидемиологическ: эпидемиологической
верениц: вереницами
подума: подумают
количеств: количество
введен: введение
соглашен: соглашение
полез: полезен
добав: добавить
просмотр: просмотров
специальн: специальностей
услов: условиям условиях условия
объем: объемы
тво: твою
синтез: синтеза
стереотип: стереотип
стро: строить
друг: другими
приход: приходили
выглядет: выглядеть
поня: понял понять
компан: компаний компании компанию
программ: программы
вчер: вчера
ежедневн: ежедневной ежедневно
главн: главной
фундаментальн: фундаментальной
обеспечива: обеспечивает
перечен: перечень
низк: низкая низким
созд: созда
подтверд: подтвердить
привет: привет
отдел: отделов отделы отдела
дайджест: дайджест
созда: создается
избег: избегая
кейс: кейс
выполн: выполнить
интернет: интернета
носим: носимого
пришл: пришли
уделя: уделяют
администрирован: администрирование
начальн: начальные
знат: знать
определя: определяющие
выстраива: выстраивать
выстро: выстроили
комментар: комментарии
штат: штата
рамк: рамках
сотрудник: сотрудников
проч: прочее
работа: работает работаю работать
сильн: сильно
коснул: коснулись
песочниц: песочницы песочница
долж: должен
услуг: услуги
кандидат: кандидатов
высококачествен: высококачественного
блог: блог
необходим: необходимых необходимостью необходимо необходимости необходимое необходимы
подходя: подходящего
автоматизац: автоматизацию автоматизации
проб: проб
модификац: модификации
период: периода
исследова: исследовали
сложност: сложности сложность
кризис: кризиса
вниман: внимания
привед: приведем
автор: авторы авторов автором
выйт: выйти
очеред: очередь
чита: читать
собеседован: собеседование собеседования
превраща: превращали
локальн: локальных
подход: подходы подхода подход
попада: попадались
обстановк: обстановки
тестирован: тестировании тестирования тестированию тестирование тестированием
историческ: исторически
нынешн: нынешнее
быстр: быстро
вчерашн: вчерашних
принима: принимаемых
тип: типов типе
воспринима: воспринимать
характеристик: характеристикам
внедрен: внедрения
удобств: удобство
реш: решил решилась решили решила
отрасл: отрасли
общ: общую общих общие
залож: заложит
курьер: курьеру
честн: честно
недел: недели недель
набор: наборе
реж: режим
поддержива: поддерживать
расскажут: расскажут
логист: логиста
серг: сергей
профессиональн: профессиональных профессионального профессиональное
удобн: удобно
редактор: редактор
может: можете
мног: многие многих
посвящен: посвященного
уста: устать
люб: любого любых любую любой любое
потреб: потребуется
язык: языка
критикова: критиковать
гор: горы
правд: правда
гот: готов
разн: разных разного
освоен: освоению
комбиниру: комбинируя
люд: людях
целев: целевой
поел: поел
конкретн: конкретную
ожидан: ожидания
площадок: площадок
применен: применение
особ: особых
потеря: потерять
вывод: выводами
привож: привожу
производств: производства
волн: волне
постара: постараюсь
одн: одна одно
подм: подмены
мар: мар
реклам: реклама
разбер: разбер
корпоративн: корпоративный
выпускник: выпускников
одинаков: одинаковыми
подборк: подборка
помощник: помощник
инструмент: инструменты инструментами
команд: командах команды команде командой
опиш: опишем
сообществ: сообществом сообществ
объединя: объединялись
врод: вроде
участ: участием
устран: устранить
микроконтроллер: микроконтроллеров микроконтроллеры микроконтроллерами
использован: использования использованием использовании
запрос: запрос
потрат: потратим
горазд: гораздо
март: марте
войт: войти
усложня: усложняется
завидн: завидной
процессор: процессорах
аккаунт: аккаунт
топ: топ
распараллеливан: распараллеливание
прохожден: прохождению
производ: производим
щелчк: щелчку
порядк: порядку
подробн: подробно
зависет: зависеть
яндекс: яндекс
островок: островок
новост: новости
существ: существуют существует
перв: первому первую первых первые
непрост: непросто непростом
проведен: проведения
написа: написать
поиск: поиски поиск поиске
изменен: изменений изменения
возраста: возрастающее
основ: основе основу
образовательн: образовательные
определ: определить
как: какими каком каких какого
голос: голосов
тся: тся
прошл: прошлого прошлом
высок: высокая высокое
реальн: реальные реальных
критик: критиков критику
барчик: барчик
лома: ломать
рол: роль
точк: точки
сфер: сфере
научат: научат
способ: способы
форм: форм
мер: мере
напрям: напрямую
продукт: продуктом продуктов продукт продукту
признак: признаки
найт: найти
информацион: информационного
коронавирус: коронавируса
успел: успели успела
независим: независимо
найм: найме найма
рос: рос
аспект: аспектах
гарант: гарантом
появ: появилось появившись появилась появились
случа: случаях
успех: успеха
проработа: проработать
запуска: запускают запускать
вернут: вернуться
выяв: выявить
принос: приносит
схем: схеме схема
д: д
галочк: галочки
п: п
ошибок: ошибок
дава: давайте давали
х: х
ч: ч
показа: показать
проиллюстрирова: проиллюстрировать
отправ: отправить
мин: мин
мир: мире мир
писа: писали
предприят: предприятий
идеальн: идеальная
совершен: совершенно
этап: этапе
скор: скорее скорых
негатив: негатива
феврал: февраля февраль
приобрел: приобрела
подева: подевалась
перевод: перевод
важн: важна важных важным
тестировщик: тестировщик тестировщику тестировщикам тестировщиков тестировщика тестировщики
ищет: ищет
час: часа часов
чат: чатов
столкнул: столкнулись
внутр: внутри
раскр: раскрою
традиц: традиция
индустр: индустрии
ворчун: ворчуна
могл: могли
повышен: повышение
приготов: приготовиться
продуктов: продуктовые
больш: большие больших большая большое
мест: место местах
приемочн: приемочное
тинькофф: тинькофф
иде: идея
кодов: кодовая
счет: счет
карьер: карьера карьеру
вход: вход
инженер: инженер инженера инженеров
направлен: направленная
игр: игр
полезн: полезный полезна
модифицирова: модифицировать
существен: существенно
эффективн: эффективно
отказоустойчив: отказоустойчивость отказоустойчивости
пробова: пробовал
исправлен: исправлений
представлен: представление
жизн: жизни
идт: идти
методолог: методологии
корректив: коррективы
мож: можем
сотн: сотни
момент: момент
смож: сможем
развива: развивался развиваю
смог: смог
основн: основным основном основная
журналистик: журналистике журналистики
сторонник: сторонников
психологическ: психологических
подготов: подготовить подготовят
привест: привести
решен: решений решения
создател: создателем
провод: проводить
средн: средний
гуманитар: гуманитарием
васил: василий
меня: менялись
хаб: хабы
повыс: повысить
изобил: изобилует
выполня: выполняется
результат: результатов результаты результатом
опыт: опытом опыта опыте
рынок: рынок
подразумева: подразумевается
ваканс: вакансии вакансий
настройк: настройка
дал: далее
дикт: диктует
пониман: понимания
документ: документы
прочтен: прочтением прочтение
вспомогательн: вспомогательного
ссылк: ссылку
перцентил: перцентиль
фокус: фокусе
дан: данные данных данными данную данный
код: кода код
сократ: сократить сократило
инкремент: инкрементов
используем: используемой
встраива: встраиваемые
изъя: изъяны
предлож: предложила
доступн: доступных доступность
тестируем: тестируемого
прилагательн: прилагательных
возника: возникающие
сохран: сохранить
вмест: вместе
уход: уходили
ошибк: ошибками ошибки
достич: достичь
обнов: обновить
разработк: разработкой разработке разработка разработки
закладк: закладки
релизн: релизной
разработа: разработано разработать
уверен: уверенности уверенность
программн: программного программным программное
релиз: релизу
гарантир: гарантирующих гарантирует
преимуществ: преимущества
пост: пост посте
укладыва: укладывается
реляцион: реляционных
обеспеч: обеспечить
минут: минуту минут
лидерств: лидерство
дел: дело деле
ближайш: ближайшем
рассказа: рассказать
стремительн: стремительного
внедря: внедрялись
внутрен: внутреннюю
устройств: устройство устройства
размер: размеров
переход: перехода
неудачн: неудачным
ваш: вашей
проход: проходить
ответ: ответа
генерир: генерирую генерируйте
проектирован: проектирование
сталкива: сталкивался
ручк: ручками
измен: изменила
раст: раст
оговор: оговоримся
людьм: людьми
материал: материалов
мегапроект: мегапроекты
хабр: хабр
обучен: обучения
отношен: отношения
наста: настало
услыша: услышать
район: районе
практик: практики практике
мысл: мысль
последн: последние
заявлен: заявленными
сам: самое самых
качествен: качественных
стартап: стартапов стартапам
туториа: туториал
инач: иначе
тестиру: тестируем
задава: задавайте
школ: школ
тотальн: тотальным
образован: образование образования
подобн: подобная
управлен: управление
принят: принято
характер: характера
уважа: уважающий
сбо: сбоям
руковож: руковожу
заключа: заключается
век: века
предполага: предполагающие
начина: начинают начинающим
вс: вс
популярн: популярная
приоритетн: приоритетных
област: областях области
сво: сво своем своим
веб: веб
программирован: программирование
распределен: распределенных
первостепен: первостепенное
нача: начали
реша: решать решающую
специалист: специалист специалиста специалистам
порог: порог
просто: простоя
станов: становится
попробу: попробуем
значительн: значительными значительным
тест: тестов тест тесты теста
плеч: плечами
явля: является являюсь являются
появлен: появлению
узк: узкое
вещ: вещей вещи
развит: развитию
нестабильн: нестабильно
сайт: сайта
сгенерирова: сгенерированными
обеспечен: обеспечения обеспечению обеспечение
оборудован: оборудования
научпоп: научпоп
технолог: технологию технологии
разносторон: разносторонним
продолж: продолжить
задач: задач задача
ускорен: ускорение
достигнут: достигнуто
пиццер: пиццериях пиццерии
посвящ: посвящена
задума: задумано
зовут: зовут
истор: истории история
ход: ходить ходят
зрен: зрения
довер: доверие
цифр: цифр
пробл: проблем
ещ: ещ
гибк: гибкого гибким гибкими гибких гибкие
конфиденциальн: конфиденциальность
заставля: заставляющим
сбермаркет: сбермаркет сбермаркета
кошк: кошки
чуж: чужой
нескольк: нескольких
реальност: реальность
одобрен: одобрении
обеща: обещающих
влия: влияет
позволя: позволяет
хоч: хочу
эволюц: эволюция
рейтинг: рейтинг рейтинга
скорост: скорость
упоминан: упоминание
дом: дома
забыв: забывая
способн: способность
известн: известные известных
исполн: исполнится
сторон: стороны
поток: потоки
интеграцион: интеграционных интеграционные
кратк: краткое
указыва: указываемых
поддержк: поддержка
тысяч: тысячи
модульн: модульный
хорош: хорош хорошего хорошие хорошее
библиотек: библиотека библиотек
предыдущ: предыдущей предыдущего
поест: поесть
наш: нашей нашему нашем
темп: темпами
пользовател: пользователях
успешн: успешный успешность
плат: платой платами
над: надеюсь
рекрутинг: рекрутинга
большинств: большинства
заказ: заказов
сил: силы
разрабатыва: разрабатывать разрабатываем
сервис: сервисов
регулярн: регулярностью
евген: евгения
гуманитарн: гуманитарное
информац: информация
основыва: основывается
выгоран: выгорание
поставля: поставлять
выгляд: выглядят выглядит
анализ: анализ
способств: способствующих
скилл: скиллами
герма: герман
сборк: сборки
ко: кое
собра: собрать
например: например
отправля: отправляемых отправляется
коллег: коллега
запуск: запуск запуском запуска
соответств: соответствует
нативн: нативные
надежн: надежность надежного надежно
огромн: огромное
месячн: месячный
уровн: уровня
мо: моей
сист: систему систем
исходн: исходной
качеств: качества качеством качество
распредел: распредел
участв: участвует
смс: смс
разочарова: разочарованных
проблем: проблемы проблема
айтишник: айтишники
сервер: сервера сервером
джун: джун
раздел: разделы разделе
об: обо
лучш: лучшие лучших
механизм: механизма
дума: думаю
относ: относится
переключен: переключения
оп: опыт
погружа: погружающихся
интересн: интересном
возможн: возможность
высокотехнологичн: высокотехнологичной
хочет: хочет
функциональн: функционального
крупн: крупному крупных
неполн: неполной
чье: чьей
растет: растет
прежд: прежде
наверн: наверное
портфол: портфолио
бывш: бывшая
поведенческ: поведенческих
становлен: становления
контент: контента контент
откр: открыть
термин: термин
видоизменя: видоизменялись
nkhanna: nkhanna
german: german
esp: esp
tinygo: tinygo
hel: hel
adalan: adalan
qa: qa
bazel: bazel
robot: robotic
religiosa: religiosa
urmazova: urmazova
twitter: twitter
java: java
autom: automation
postman: postman
pim: pims
testcontain: testcontainers
vasili: vasily
vchetkov: vchetkov
gevoro: gevoro
phillennium: phillennium
soft: soft
python: python
molechka: molechka
sinelschikov: sinelschikov
stm: stm
micropython: micropython
pyboard: pyboard
curiousgeorg: curiousgeorge
otu: otus
flutter: flutter
vk: vk
rusau: rusau
http: http
habr: habr
suit: suite
qualiti: quality
engin: engineer engineering
vicktorovich: vicktorovich
lilia: lilia
artem: artem
artsiom: artsiom
youtub: youtube
dart: dart
rust: rust
proqualitycommun: proqualitycommunity
joom: joom
assur: assurance
rss: rss
peter: peter
dmitriizolotov: dmitriizolotov
jnechaeva: jnechaeva
skill: skills
natalyarukol: natalyarukol
rko: rko
mitmproxi: mitmproxy
ivanponomarev: ivanponomarev
hard: hard
enginn: enginner
hroft: hroft
qiwi: qiwi
dimitryabramov: dimitryabramov
bozaro: bozaro
manti: mantis
rpa: rpa
process: process
agil: agile
alizar: alizar
ci: ci
facebook: facebook
xxi: xxi
telegram: telegram
commerc: commerce
build: build
charl: charles
dodo: dodo
php: php
olegchir: olegchir
chao: chaos
zhizhin: zhizhin
burp: burp
