обрат: обратить
максимальн: максимальной максимально
оценк: оценка
говор: говорят
барахолк: барахолку барахолке
отформатирова: отформатировать
влиян: влияния
информацион: информационная
расскаж: расскажу
стат: стать статье статьи
обычн: обычных
стар: старое старую
конц: конце
стал: стали стало
аспект: аспект аспекты
мнен: мнение
предлага: предлагаю предлагает
обзор: обзор
электроник: электроники электронику
успех: успехи
появ: появилась появился
полноразмерн: полноразмерной
работ: работы работе
показыва: показывать
удар: удар
практическ: практические
дополнительн: дополнительного
вернут: вернуть поддержка
винтажн: винтажная
сетев: сетевое сетевые сетевых
лидир: лидирующие
прошлогодн: прошлогодний
терминал: сборки
сокраща: сокращается сокращать
инфраструктур: инфраструктура
сто: стоят стоит
тб: тб
основан: марта
человек: человека
обновлен: обновленное
усып: усыпил
санкц: санкции
инвестирова: инвестировать
склонност: склонность
вообщ: вообще
менеджмент: менеджмент
пункт: перечисленных
доминир: доминирующие
каса: касаются
интеграц: интеграцией
экра: экрана
субд: субд
стремлен: стремление
потреблен: потребления
местоположен: численность
мобильн: большинства
п: п
снижен: снижение снижения
небезопасн: небезопасная
публикац: разделы
скопирова: скопировать
дава: давайте
нест: нести
балл: баллы
поэт: поэтому
отправ: отправился
жестк: жестких жесткие
назван: название
котор: которую котором которым
владелец: мобильных
профилактик: профилактики
мин: мин мини
вариант: вариантов варианты вариант
сбыва: сбывается
памят: памяти
писа: писали
моделирован: моделировании
видеокарт: видеокарты
исследован: исследования
обсужда: обсуждали
связа: связав связана
прав: право
безопасн: безопасной безопасности безопасность
диск: дисков диски
скор: скором
девушк: девушку
проект: проектами нативные
аппаратур: серверной
феврал: февраля феврале
при: прием
аудиотехник: аудиотехника
относительн: относительно
выраз: выразиться
отмеч: отмечу
профил: профиль
дела: делает
кризисн: кризисного
получ: получив лэптоп
произведен: произведения
верс: вернуться версий
важн: важна
дистрибутив: востребованной
исключен: исключением
мигрир: рекомендаций
маркетинг: маркетинг
увеличива: увеличивают
книг: книг книги
разобра: разобраться
рук: руки
час: часов
прост: простой проста
душещипательн: душещипательная
врем: времена
млн: снизился
воскресн: воскресной
прям: прямо
позвол: пунктов
индустр: индустрии
здравств: знает
позиц: позиции
лиц: лиц
совместим: совместимы
подруг: подругу
повышен: повышением
побыстр: побыстрее
уровен: уровень
нов: новые новых новое
придума: придумать
обошл: обошла
софт: софт
больш: большая
медийн: корпоративный
мест: место ограничений
част: часть
файлов: файловые
иде: идеей
цифров: цифровое
счет: счет
слож: сложа
карьер: карьере карьера
слов: слов словам слову
литератур: литература
офис: офиса
вход: порог
направлен: направления
полезн: полезны
одновремен: одновременным
геймифицирова: геймифицировать
постоя: постоянно
миниатюрн: миниатюрные миниатюрность
системн: системное
внимательн: внимательных
сдела: сделать
мерч: мерч
эффективн: эффективным
особен: особенностями
сложн: сложных сложнее сложно
капот: капотом
оперир: оперирует
исправлен: исправлений
совет: советов
видел: видел
генерац: генерации
примен: применить
пут: пути
исправ: исправить
посеща: посещаю
активн: активно
штук: штуку штуки
подсистем: подсистемы
кит: наладонник
операцион: датчиков
погружен: погружения
систем: системы
выход: выходе
лиценз: лицензией
генерирова: генерировать
торгов: торговой
частн: частных
персональн: персональных
развива: продолжает развивать
нема: немало
микросервис: приложения
южнокорейск: южнокорейской
сша: сша
гомеопат: гомеопатия
психологическ: психологического
бонус: бонусы
техник: технику
выпуска: стараются
решен: решения
постепен: постепенно
написан: написания
тыс: тыс
предпочит: предпочитая
передава: передаваемых
актуальн: актуальные
средн: средний среднее
продолжа: смартфоны продолжают
нужн: нужны
носител: носителей
меня: менялся
хаб: публикации
рынк: глобальном рынка рынки
продвижен: продвижения
нрав: нравятся нравится
ментальн: ментальный
помощ: помощи помощью
востребова: ос
приложен: переносе приложений
разработчик: разработчиков разработчики
вычислен: вычисления
склад: склады
выигра: выиграть
бонусн: бонусные
ваканс: вакансии
настройк: настройка
промышлен: промышленность
слога: слоган
накопител: накопителей накопители
последовательн: последовательность
документ: авторов
прочтен: прочтение
будущ: будущее
ссылк: ссылку
наоборот: наоборот
серверн: серверных применении платформы сегменте
регулирован: регулирования
наладонник: портативный
навык: навыков
выросл: выросло
мемн: мемный
торвальдс: торвальдс
малышев: ульяна
дам: дам
дан: данных согласно данного
весьм: весьма
дат: информация
испанск: испанской
вкус: вкус
код: кода
росс: россии местоположение
найдет: найдется
регистрац: дата войти
дефицит: дефицита
числен: сентября
михаил: отдела
причин: причин
поднебесн: поднебесная
отремонтирова: отремонтированной
шедевр: шедевр
цен: цены
кова: ковал
старт: старте старта
человечеств: человечество
руководител: лепихин
границ: границах
систематизац: систематизации
дзен: яндекс
эр: эры
сохран: сохранность
личностн: личностный
глобальн: поставок
множеств: множество
взаимодейств: взаимодействие взаимодействии
вмест: высоким
создава: проблем
отличн: отлично
искусствен: искусственный
покупа: покупают
чип: чипов
утилит: утилита
обнов: обновить
сегмент: обогнать
объект: объектами
завершен: завершение
разработк: разработкой стандартом разработка
паден: падение падения
закладк: закладки
серьезн: аналитиков
разработа: разработан разработать
музыкальн: музыкальные музыкальных
игрушк: стартап
желез: железо
начал: началом
продолжен: продолжения
стара: стран
возвращен: возвращение
примерн: примерно
закономерн: закономерную
сюд: рекомендациями
релиз: релиза
настоя: настоящие
преимуществ: месте
список: список
воскресен: воскресенье
пост: посте
ремонт: ремонт
полгод: полгода
реляцион: реляционная
лидерств: лидерство
прошедш: прошедших
минут: минут
строк: строк
нашел: нашел
дизайн: дизайн дизайну
производительн: производительные производительность
перечислен: знание
внутрен: внутренней
устройств: устройствах устройство устройств устройства
лепихин: игорь
записыва: записывающую
неудачн: выдался
улья: представитель
так: такую таких
общен: общения
публикова: публиковали
полност: полностью
несмотр: несмотря
событ: события
покупк: покупки
сниз: рынке
собствен: собственной собственных собственно
баз: баз
техническ: технической дзен
станц: док
оплат: оплатить
дешевеют: дешевеют
драйвер: драйверами
фев: фев
заметн: заметные
назва: назвали названо
людьм: людьми
символ: символы
конкурс: конкурс
собира: собирается
мегапроект: стартапам
хабр: хабр
подбира: подбирать
аналитик: аналитика данным
обсуд: обсудим
некотор: некоторые
рассмотр: рассмотрим
потенциальн: потенциального избежать
куп: купил
игор: здравствуй
обогна: способен
механическ: механические
клавиатур: клавиатуры клавиатурой
саш: саша
количеств: количество
соглашен: документы
попа: попалось
валенс: валенсией
кита: китаю китаем
добав: ним добавить
просмотр: просмотров
практик: практике
специальн: специальные
последн: последний
оставл: оставлено
зна: знаю
услов: условиях
сам: самых самые
объем: объемы
представля: представляет
интеллект: интеллект
гибридн: гибридный
диагонал: диагональю
виртуальн: виртуальную
куплен: купленной
стартап: английский программы
туториа: туториал
приход: приходится
аппаратн: руководитель аппаратными
поня: понять
образован: образования
менеджер: менеджер менеджера
компан: компаний компанией компании
давлен: давлением
рассказыва: рассказываем
выполнен: выполнения
ограничен: создавать
программ: образовательные
управлен: управление
вчер: вчера
принят: принято
главн: главное
неожида: неожиданно
привел: привело
недорог: недорогие
век: века
привет: привет
стандарт: микросервисы
гришин: гришин
очередн: очередной
прогноз: прогнозы прогноз
отдел: архитектором
голландск: голландского
запомина: запоминающийся
использ: использующая используют использую
цвет: цвет
созда: создаем создал
сво: пополните свой
ран: ранее
кейс: кейс
программирован: программирование программирования
пород: породив
порог: разработки
передач: передачи
забыва: вещей
станов: становится
перспектив: заслуживают
попробу: попробуем
интернет: интернет интернете
необычн: необычные
атак: атак
тест: теста тест
появлен: появлении
вещ: вещи млн
официальн: официальное
теря: теряют
администрирован: администрирования администрирование
развит: развития развитие
пользовательск: пользовательские
фотограф: фотографиях
сайт: сайт песочница
знан: оркестратор
обеспечен: аппаратного
оборудован: оборудования оборудование
научпоп: научпоп
технолог: технологию технологии
комментар: комментарии комментариях
происход: происходит
штат: штатов штаты
задач: задачу
файл: файлов
поставк: упали
находк: находки
рамк: рамках
сотрудник: сотрудники
хвата: хватает
приступ: приступим
нейросет: нейросетей
проч: плат
компьютер: компьютеры
сильн: сильного прочих сильным
работа: работающего работают работает
коснул: поставки
песочниц: авторы
пар: выпускать пару
десятилет: десятилетий
услуг: конфиденциальность
подписчик: подписчики
уменьш: уменьшили
искусств: искусства
треб: требует
заслужива: новинок заслуживает
блог: блог
необходим: необходимые
истор: история
зовут: зовут
подходя: подходящие
несколбьк: несколбько
модел: модели моделей модель
пробл: потенциальных
ещ: ещ
сложност: сложности
вниман: внимание внимания
параметр: параметрами
пенат: пенаты
девайс: девайс девайсов девайса девайсы
автор: хабы сайта автором
снижа: снижаются
чита: читать
представител: представители россия
новинк: новинках новинки новинка
конфиденциальн: соглашение
дюйм: дюймов
разрешен: разрешением
защит: защиты
корпорац: корпорации
придет: придется
ищут: ищут
тестирован: коллегами
минувш: минувшее
оста: входа
нескольк: нескольких
быстр: быстро
эксперт: экспертов
спрос: спроса
повтор: повторить
бизнес: бизнеса
тип: типа тип типов
памя: память
позволя: позволяет
разреш: разрешен
пережива: переживает
выручк: выручка
эволюц: эволюцию
рейтинг: рейтинг
портативн: разных
док: китая
реч: речь
дом: дома
отрасл: отрасли отрасль
известн: известно
покупател: покупателей покупателя
общ: общем крупных
объ: объем
сторон: стороне стороны
обойт: обойтись
поток: потоки потока
сид: сидят
поддержк: техническая
состо: состоит
недел: неделю недель
поддержива: поддерживает
побыва: побывал
включ: включая
емкост: емкости
модульн: модульным модульный
серг: сергей
родн: родные
стоимост: стоимости
профессиональн: профессиональная
хорош: хорошая получил
предназнач: предназначен
сред: корпоративной среди
наш: нашей
ин: иными
пользовател: пользователь пользователей
мног: многим
ядр: ядра ядро ядре
попыток: попыток
вишняков: михаилом
люб: любой
хостинг: хостинг
восстанавлива: восстанавливают
плат: материнских
компонент: терминалов компонентов
ищ: ищу
язык: язык языка
избежа: позволит
большинств: основой
умн: компонентом
робот: робот
содержа: содержать
сервис: сервисов
оперативн: оперативная
фактор: фактор
обзорчик: обзорчика
мониторинг: мониторинга
информац: сюда информации
зеркалк: зеркалка
взят: взять
облачн: облачные облачных
распозна: распознать
поставля: поставлять
разн: разные хороших
замет: заметите
продакт: продакт
люд: людей
пылесос: пылесос
производител: производители производителей
находок: находок
английск: процессоры
погод: погода
дополнен: дополнений дополнение
имитац: имитация
добавлен: добавлением
парол: пароль пароли паролей
объедин: объединить
сборк: игрушкой
упа: упала серьезно
погруз: погрузиться
ко: кое
мессенджер: мессенджере
применен: применение серверном
поговор: поговорим
создан: создания
квартал: квартале
потеря: потеряла
пополн: субъективный
собра: вишняковым
дожда: дождаться
идет: идет
черт: черты
диагностирова: диагностировать
запис: записи
производств: производство производстве
знает: смартфона
одн: одном одну одно
моральн: моральный
продаж: продаж аппаратуры
мар: мар
настольн: настольные
согласн: согласны неудачным
коллег: обеспечения
увеличен: увеличением
реклам: медийная
запуст: запустили
разбер: разберу
настольк: настолько
корпоративн: дистрибутивы корпоративные корпоративных услуги
понятн: понятными
рекомендац: собрали своими
нативн: реклама
подборк: подборку подборке
инструмент: инструменты инструментом инструмент инструментов
поставок: общий
чест: честь
выда: прошлый
надежн: надежный надежности
склон: склонно
команд: команда команд
кружочк: кружочки
плюс: плюс
архитектор: вместе
субъективн: преимуществ
материнск: продажи
электрон: электронной электронную электронных электронные
аренд: аренду
стран: страна странные среде
платформ: перспективы
поскольк: поскольку
сист: систем
покупок: покупок
войн: войны
горазд: гораздо
сентябр: основания
март: регистрации
войт: аккаунт
ноутбук: ноутбуки ноутбук ноутбуком
нечт: нечто
процессор: серверное
аккаунт: малышева
прошел: прошел
глаз: глаза глазах
аукцион: аукциона аукционом
протокол: протокол протокола
государств: государства
сраз: сразу
производ: производит
отложен: отложенной
смартфон: владелец станция
декларативн: декларативный
пиш: пишите
проблем: проблемы
новинок: паре
подробн: подробности
дешевет: дешеветь
датчик: умных
сервер: сервер серверов
бот: бота
поставщик: поставщиков
упомина: упоминаю
раздел: регистрация
похож: похоже
параноик: параноиков
жела: желанный
угроз: угрозы
вполн: вполне
выигрыва: выигрывают
категорийн: категорийный
нек: некие
яндекс: мегапроекты
об: обо
новост: новостями новости новость
лучш: лучшие
механизм: механизм
перв: первая первые
оз: озу
небольш: добавился
формат: формату
написа: написать
крайн: крайне
поиск: поиск
побежда: побеждают
интересн: интересные интересных интересный интересного
возможн: возможности возможность возможно
автоматизирова: автоматизировать
оп: опыт
изменен: изменений изменения
ос: развиваться
упуст: упустить
твердотельн: твердотельных
планир: планирует
основ: операционной
планшет: планшетом
открыт: открытый
увелич: увеличить
внес: внесены
образовательн: проекты
перенос: забывают
участник: участника
как: какие
определ: определить
крупн: коснулось
голос: голосов
напомина: напоминающую
пк: пк
кат: катом
санкцион: санкционным
освобод: освободить
сюжет: сюжет
растет: растет
прошл: сильно
высок: остается
поведен: поведения
оркестратор: мигрируют
гаджет: гаджеты
стабильн: стабильного
скидк: скидке скидкой скидки
изначальн: изначальной
архитектур: тестирование архитектурами
добавл: добавлена добавлены
выпуст: выпустили
поведенческ: поведенческих поведенческий
пада: падают
откр: открыть
способ: архитектуры
мер: меры
наход: находится
сперв: сперва
компьютерн: компьютерное
продукт: продуктом
лэптоп: небольшой
бюджетн: бюджетные
панел: панелью
рекоменд: рекомендуйте
xx: xx
runtim: runtime
msi: msi
sourc: source
asu: asus
ssd: ssd
droman: droman
irobot: irobot
devop: devops
asrock: asrock
snmp: snmp
twitter: twitter
dram: dram
erbanovanastasia: erbanovanastasia
lepikhin: lepikhin
sega: sega
annu: annus
mysql: mysql
embed: embedded
nix: nix
copyleft: copyleft
ii: ii
python: python
skovalev: skovalev
selectel: selectel
hackdaddi: hackdaddy
io: ios
iv: iv
intel: intel
verif: verification
reform: reform
igor: igor
openai: openai
horribili: horribilis
librem: librem
vk: vk
amd: amd
habr: habr
disc: disc
gear: gear
game: game
ru: ru
pine: pine
rv: rv
firemoon: firemoon
vigor: vigor
android: android
kubernet: kubernetes
sql: sql
youtub: youtube
rust: rust
samsung: samsung
rss: rss
linux: linux
grishinalex: grishinalex
arm: arm
connect: connected
polaroid: polaroid
gk: gk
gigabyt: gigabyte
greiv: greiv
facebook: facebook
hdd: hdd
telegram: telegram
lodz: lodz
master: master
doctor: doctor
mnt: mnt
window: windows
open: open
pocket: pocket
po: pos
