смешн: смешное
монитор: мониторе монитор монитора
говор: говорите
провер: проверить
механическ: механически
фактическ: фактически
однопроводн: однопроводного
клавиатур: клавиатура
количеств: количество
полев: полевой
проектирова: проектировал
соглашен: соглашение
стат: стать
куч: кучу
стар: старую
изобретут: изобретут
добав: добавить
просмотр: просмотров
разновидн: разновидностью
ждек: ждека
зна: знаю
электроник: электроники
случа: случае случаев
сам: самая самое
стро: строя
сс: сс
дополнительн: дополнительный
вернут: вернуться
грех: грехи
друг: друг другую другу
стартап: стартапам
кабел: кабеля кабеле кабелю кабелях кабель
подключен: подключенный
бп: бп
подобн: подобное
компан: компаний компании
д: д
программ: программы
вообщ: вообще
менеджмент: менеджмент
единствен: единственный
получа: получает
то: той
ноут: ноуту ноут ноута
доперл: доперли
микр: микро
допуска: допускает
складыва: складывается
пят: пятом
публикац: публикации
скопирова: скопировать
низк: низкой
ц: ц
показа: показать
стандарт: стандарту стандарт стандартам
привет: привет
ы: ы
котор: котором
вс: вс
мин: мин мини
вариант: варианта вариант
дич: дичью
использ: использует используется
реша: решается
диск: дисков
уш: уши
проект: проекты
передач: передача
оторва: оторвать
профил: профиль
нажа: нажать
включен: включение
подтяжк: подтяжки
перевод: перевод
осатв: осатвить
резистор: резисторами резистор резистора резисторах
верс: версию
полн: полной полно
транзистор: транзистор
администрирован: администрирование
маркетинг: маркетинг
зарядник: зарядник
питан: питания
сайт: сайта
час: часов
научпоп: научпоп
просыпа: просыпает
технолог: технология
комментар: комментарии комментарий
лин: линии
различн: различных
здравств: здравствуй
занима: занимается
совместим: совместимость
песочниц: песочница
прор: прорыв
разумеет: разумеется
исключительн: исключительно
блок: блоков
переспрос: переспросим
эконом: экономия
уровен: уровень
норм: нормы
услуг: услуги
нов: новой новое
оставля: оставлять
умеет: умеет
внешн: внешних
больш: большую большая
треб: требуется
медийн: медийная
блог: блог
мест: месте
расшатыва: расшатывался
цифров: цифровой
интерфейс: интерфейсы интерфейса интерфейс
сложност: сложности
ещ: ещ
несовместим: несовместимых
полноправн: полноправные
девайс: девайсе девайсов
автор: авторы авторов автором
постоя: постоянные
ргат: ргать
сдела: сделал
легк: легко
сет: сети
конфиденциальн: конфиденциальность
виде: видео
умен: умения
подход: подходили
попада: попадали попадаем
тестирован: тестирования
оценива: оценивали
быстр: быстрых
пример: примера пример
подключа: подключаются
тип: типа тип
природ: природе
наплод: наплодили
док: док
выход: выходу выхода
скорост: скорости
деливер: деливери
сторон: стороной
постав: поставить
электромобил: электромобилях
мом: мом
поток: потоки
видеосигна: видеосигнал
поддержк: поддержка
офиген: офигенное
остальн: остальном остальное
угодн: угодно
мышин: мышиный
сможет: сможет
принцип: принципе
предназнач: предназначен
иб: ибо
обм: обмена
вариац: вариаций
догада: догадались
удобн: удобно
еслиб: еслиб
привест: привести
предыдущ: предыдущий
стабилизац: стабилизации
ин: иных
постепен: постепенно
пользовател: пользователи пользователю
люб: любого любой
средн: средний
зарядк: зарядку зарядки зарядка
нужн: нужны
канальн: канальный
язык: языка
большинств: большинстве
хаб: хабы хаб
помога: помогает
делител: делителя
стик: стик
разъ: разъ разъему
информац: информация
хлам: хлам
напряжен: напряжения
результат: результате
сход: сходу
продвинут: продвинутое
ноутубук: ноутубук
разн: разных разные
обозначен: обозначения
настройк: настройка
маг: магии
спуст: спустя
документ: документы
производител: производителям производителей
прочтен: прочтение
увер: уверен
ссылк: ссылку
конкретн: конкретный конкретном
открыва: открывать
максимум: максимум
поверх: поверх
хуж: хуже
чертовск: чертовски
дан: данными
имел: имелся
производств: производство
например: например
одн: одном одно
разъем: разъемы
заряжа: заряжаются заряжается
реклам: реклама
регистрац: регистрация
корпоративн: корпоративный
понятн: понятно понятного
тестирова: тестировать
нативн: нативные
одинаков: одинаковый
кругл: круглый
огромн: огромный
ток: ток током
ситуац: ситуация
втыка: втыкать
выдач: выдачи
ма: ма
камер: камера
таков: таковых
вож: вожу
мониитор: монииторе
хлипковат: хлипковат
мо: моему
усб: усб
войт: войти
ноутбук: ноутбуков ноутбука ноутбук
нечт: нечто
аккаунт: аккаунт
дзен: дзен
подключ: подключено подключить
пин: пин
вмест: вместо
минимум: минимум
протокол: протоколом протоколов
идущ: идущий
смартфон: смартфон
ошибк: ошибки
войд: войдите
проблем: проблема
обнов: обновить
име: имеем
донгл: донгл
дежав: дежавю
колонк: колонки
разработк: разработка
закладк: закладки
налич: наличие
раздел: разделы
использова: использовать использовали
похож: похожая
пишет: пишете
желез: железо
накрыва: накрывает
яндекс: яндекс
примерн: примерно
новост: новости
существ: существует
небольш: небольшой
преимуществ: преимущество
список: список
поиск: поиск
возможн: возможно
интересн: интересная
повыша: повышать
полгод: полгода
вспомина: вспоминаются
вопрос: вопрос
дизайн: дизайн
повер: повер
чехорд: чехорда
инф: инфы
имх: имхо
образовательн: образовательные
устройств: устройство устройств устройства
как: какое
голос: голосов
ответ: ответить
меша: мешало мешала мешает
порт: порты порту порт
касательн: касательно
накр: накрылась
покупк: покупку
командировок: командировок
техническ: техническая
гаджет: гаджеты
станц: станцией
тяжел: тяжелое
совмещен: совмещенный
измен: изменен
точн: точно
откр: открыть
двунаправлен: двунаправленного
собира: собираюсь
мегапроект: мегапроекты
хабр: хабр
компьютерн: компьютерное
кнопк: кнопку
смен: смена
никак: никакого
ruvd: ruvds
usb: usb
aux: aux
bright: bright
vbu: vbus
pumpexpress: pumpexpress
detect: detect
usego: usego
type: type
youtub: youtube
bt: bt
twitter: twitter
rss: rss
quickcharg: quickcharge
pavel: pavel
gan: gan
redmi: redmi
mikevc: mikevc
antra: antra
onewir: onewire
cc: cc
alandrak: alandrakes
facebook: facebook
telegram: telegram
pro: pro
translat: translate
tc: tc
edo: edo
astroscop: astroscope
eugenlusz: eugenlusz
micro: micro
vk: vk
raskin: raskin
habr: habr
