банк: банке
понима: понимаю
криптограф: криптография
фактическ: фактическим
расскаж: расскажу
стат: стать статье статьи статей статья
экспорт: экспорта
оказа: оказалось
стар: старую
рабоч: рабочее
составлен: составлением составление
мнен: мнение
таргетирова: таргетированной
работ: работа работая работе работы работу
правок: правок
показыва: показывают показывает показывать
дополнительн: дополнительные дополнительный
проблематик: проблематики проблематику
сценар: сценарий
арт: артем
получен: полученный
пол: поле
инфраструктур: инфраструктуры инфраструктуру инфраструктуре
сто: стоит
менеджмент: менеджмент
вкратц: вкратце
мобильн: мобильных
знакомств: знакомства
публикац: публикации
скопирова: скопировать
карт: карты
подел: поделиться поделюсь
готофоб: готофобия готофобией
котор: котором которым которыми
времен: временах
адресн: адресное
свят: святым
связа: связанные связанное
манифест: манифестам манифестов манифесты манифестами манифеста
вовс: вовсе
либ: либо
проект: проектов проекты проект проектами
связ: связи
появля: появляются
строков: строковых
зад: зада
относительн: относительно
профил: профиль
приветств: приветствую
документац: документации
проблемн: проблемных
верс: версии версиями версию
маркетинг: маркетинг
разобра: разобрали
прост: простой простых
предобучен: предобученной
рубл: рублем рублей
занима: занимающегося занимаюсь
типографск: типографской
вред: вреде
свободн: свободное
профессионал: профессионалы
эксплуатац: эксплуатации
уровен: уровень
очевидн: очевидно
нов: новые новый
клавиш: клавиш
внешн: внешней
медийн: медийная
част: часть части частей
цифров: цифровых цифровом
слож: сложилось сложилась
постоя: постоянно
системн: системного
сдела: сделать сделано
сложн: сложный
автотест: автотестов
капот: капот
примен: применить
пут: пути пут
дающ: дающий
пример: примерами примеров примеры примера
расположен: расположенном
персонал: персоналом
хранилищ: хранилищ хранилища
систем: системы
узна: узнать узнаем
нема: немало
курс: курс курсов
текущ: текущие текущим текущая
перехватчик: перехватчиков
читател: читатель
ресурс: ресурсов ресурса ресурсы
машин: машинное
лидер: лидерами
метод: методы методов
процесс: процесса
групп: групп
помогут: помогут
свойств: свойства
требован: требования
достойн: достойным
хотел: хотел
написан: написание написанием
подготовлен: подготовленным
подряд: подряд
помога: помогают
бесплатн: бесплатными бесплатные
рынк: рынку рынке
нрав: нравится
продвижен: продвижением
помощ: помощью помощи
современ: современный современном
ассемблерн: ассемблерный
приложен: приложениях приложений приложение
разработчик: разработчик разработчики
командн: командной
вычислен: вычисления
заключ: заключен
довольн: довольного
промышлен: промышленных
текст: текстом текст текста
показател: показателям показатели
желан: желаний
мышк: мышки
профильн: профильного
прочита: прочитав прочитал
нул: нулю
интерес: интересов
конкуренц: конкуренция
средств: средства
потребова: потребовалось
охват: охват
борьб: борьбе
битн: битное битного
фаз: фазу
наслуша: наслушавшись
плох: плохого
помогл: помогло
регистрац: регистрация регистрации
толк: толком
ситуац: ситуациях ситуаций
поисков: поисковые
счита: считает
причин: причин причине
упрост: упростить
цел: целом целая цель цели
граал: граалем
кажд: каждого каждой
настро: настроить
миграц: миграции миграция
дзен: дзен
канал: каналы
множеств: множество
взаимодейств: взаимодействия
золот: золотые
коммерческ: коммерческом коммерческие
искусствен: искусственный
кажущ: кажущейся
донастройк: донастройка
серьезн: серьезность
загрузчик: загрузчика
использова: использовать использоваться
логик: логику
желез: железо
пройт: пройти
примерн: примерно
взаимопомощ: взаимопомощи
коммьюнит: коммьюнити
сюд: сюда
професс: профессии
список: список
импорт: импорта
затронул: затронули
паразитическ: паразитическим
знаком: знакомится
наглядн: наглядно
терминолог: терминология
строк: строки
дизайн: дизайн
резюм: резюме
производительн: производительность
концепц: концепции
помим: помимо
попыта: попытаюсь
попробова: попробовал
клиент: клиентов
так: такую такого таких
общен: общения
перевест: перевести
уязвим: уязвимых
баг: багами
баз: базе базами
техническ: техническая
заметк: заметка заметке
некотор: некоторые
предпочита: предпочитают
рассмотр: рассмотрим рассмотрен рассмотрена
оберега: оберегаем
потенциальн: потенциальный
подума: подумал
удивительн: удивительно
количеств: количество
введен: введением
соглашен: соглашение
добав: добавить
просмотр: просмотров
специальн: специальное
содержан: содержание
методик: методика
дополня: дополняем
конфигурац: конфигурация конфигураций
услов: условии
сканирован: сканирования
представля: представляет
синтез: синтез
интеллект: интеллект
друг: друг друга другим
нынч: нынче
правильн: правильно
тайн: тайные
сбор: сбора сбор сбору
поня: понять
дракон: дракона
кластер: кластере
компан: компаний компании
программ: программы
коммуникац: коммуникаций
получа: получается
вчер: вчера
предъяв: предъявить
страда: страдающие
пят: пятая
привет: привет
состоян: состоянием состояние
поможет: поможет
дайджест: дайджест
использ: использующие используются
имеют: имеются
магазин: магазин
созда: создана создать
колдовск: колдовской
кейс: кейс кейсов
нын: ныне
отдельн: отдельное
сохранен: сохранением
нелегк: нелегко
интернет: интернете
реализац: реализацию реализации
тем: тему теме
применя: применяются применяется
пришл: пришлось
полн: полной
администрирован: администрирование
легковесн: легковесного
определя: определяет
дэйв: дэйва
комментар: комментарии комментариев
рамк: рамках
сотрудник: сотрудники
адрес: адресов
работа: работают работать работающее работает
песочниц: песочницы песочница
долг: долгих
услуг: услугам услуги
кандидат: кандидатов
блог: блог
числ: числе
автоматизац: автоматизации
интерфейс: интерфейсы интерфейс
модел: модели модель
сложност: сложности
вниман: внимание
исправля: исправлять
автор: авторы автором авторов автора
футпринтинг: футпринтингом
чита: читать
собеседован: собеседование собеседования
локальн: локальную локальной
подход: подходах подходов подход
положен: положения
попада: попадают попадалась
тестирован: тестирование тестирования
расписа: расписаться
быстр: быстрого быстро
вчерашн: вчерашних
пользу: пользуемся
типичн: типичный
тип: типов
бумаг: бумаги
выручк: выручки
портативн: портативный
статическ: статически
печа: печать
реш: решила решить
общ: общем
фоб: фобии
набор: набор
недел: недель
поддержива: поддерживают поддерживаются поддерживать
расскажут: расскажут
удобн: удобные
бенефициар: бенефициаром
социальн: социальные
редактор: редактор редакторе
мног: многие
посвящен: посвященное
люб: любой
язык: языке языку языка
согласова: согласованных
заглянут: заглянуть
содержа: содержащие
таблиц: таблиц
целесообразн: целесообразным
злоумышленник: злоумышленник
гор: горы
правд: правда
продакш: продакшен
разн: разного
незапамятн: незапамятных
документооборот: документообороте документооборота
отсканирова: отсканировать
разб: разбил
разв: разв
производител: производителями производителя производителей
год: годы
площадок: площадок
применен: применению применения применением
вывод: вывод
храня: хранящихся
прич: причем прич
фолд: фолды фолдами
привод: приводятся
подп: подпись
производств: производство производстве
знает: знаете знает
одн: одно
широк: широкий широко
знаеш: знаешь
реклам: реклама рекламы
попадет: попадете
прид: прид
корпоративн: корпоративный
бумажн: бумажная
тов: тов
функциона: функционал
выпускник: выпускников
одинаков: одинаковыми
шаблон: шаблонов
подборк: подборкой подборка
инструмент: инструменты инструментами инструментов инструмент
доклад: докладов доклады
команд: команды команда
сообществ: сообществом сообществ сообществах
врод: вроде
электрон: электронного электронная
инструкц: инструкции
смотрет: смотреть
использован: использования использованием использовании
войт: войти
аккаунт: аккаунт
состав: составе
подпис: подписью
генерируем: генерируемого
глаз: глаза
прохожден: прохождению
отложен: отложенного
репозитор: репозитории
подробн: подробно
излага: излагается
поспрашива: поспрашивала
именуем: именуемую
яндекс: яндекс
новост: новостей новости
существ: существует
перв: первого первую первые
перешагнул: перешагнул
проведен: проведения
перехват: перехвату
написа: написал
добр: доброе
поиск: поиска поиск поисков
изменен: изменений
основ: основе основы
образовательн: образовательные
как: каком каких какие каким какого
эдак: эдаким
голос: голосов
шлюз: шлюз
тся: тся
прибега: прибегать
прошл: прошлых
высок: высокое высокой
гаджет: гаджеты
сфер: сфера
установлен: установленного установленных
однозначн: однозначно
научат: научат
разведк: разведки
способ: способ
браузер: браузеры
компьютерн: компьютерное
клик: клик
обрат: обратить
нейрон: нейронная нейронной
готов: готовы готовых
информацион: информационная
занят: занятости
образ: образом
окн: окнами окно
дорог: дорогой
аспект: аспектах
обзор: обзор обзору
электроник: электроники
появ: появилось появился появилась появиться
запуска: запускать
доступ: доступа
вернут: вернуться
парадигм: парадигме
грех: грехи
гкост: гкость
децентрализова: децентрализованные
вообщ: вообще
л: л
загружен: загруженных
п: п
хакинг: хакинг
централизова: централизованные
х: х
показа: показана показать
отправ: отправить
распечата: распечатать
поэт: поэтому
модификатор: модификаторах
мин: мин
редактирова: редактировать
вариант: варианты
памят: памяти
мир: мире мир миру
писа: писать
приручен: приручение
знают: знают
совершен: совершенно совершенный
безопасн: безопасность
версион: версионная версионной
адресат: адресату
столкнут: столкнуться
получ: получила
синхронизац: синхронизации
вложен: вложения
перевод: перевод
распечатк: распечатку
тестировщик: тестировщикам тестировщика
город: городить
списк: списками списка списки
рук: руки
час: час часа часов
чат: чат чатов
заодн: заодно
индустр: индустрии
повышен: повышения
больш: большие большая большое
софт: софт
заморож: заморожены
мест: место
файлов: файловые
планомерн: планомерно
иде: идея
ждат: ждать
карьер: карьера
вход: вход
направлен: направления направлениями направление
игр: игр
полезн: полезный полезные полезных
существен: существенные
телегр: телеграм
видет: видеть
исправлен: исправлений
генерац: генерации генерация
плавн: плавно
населен: населения
сформирова: сформированный
лиценз: лицензий
пыта: пытаются
сотн: сотни
затрон: затронем
момент: момент
смож: сможем
отклик: отклик
основн: основной
гейт: гейта
вышл: вышло
сможет: сможет
основа: основанные основанных
отб: отбились
скрыва: скрывается
подготов: подготовят
почт: почта
решен: решений
офисн: офисные
загугл: загуглить
создател: создателем
провод: проводить проводит
средн: средний средняя
личн: лично
нужн: нужны
хаб: хабы
описан: описание описания
вызыва: вызывают
опыт: опытом опыте
полож: положил
настройк: настройка
дал: далее
явлен: явлениях
матричн: матричными матричные
контекст: контексте контекста
документ: документы документов
прочтен: прочтение
карма: карман
ссылк: ссылки ссылку
затащ: затащить
жертвова: жертвовать
дан: данных данными данной данный дано данная
имел: имела
установ: установить
указа: указанного
код: кода код
модул: модуль
коп: копия
пайчарм: пайчарма
генератор: генераторах генераторы
формирован: формирования
функц: функций функции
внесен: внесения
построен: построения
новичк: новичкам
возника: возникает
продемонстрирова: продемонстрированы продемонстрировать
редирект: редиректов
вмест: вместе
минимум: минимуму
обознач: обозначить
разбор: разбором разборе
обнов: обновить
объект: объекте
разработк: разработкой разработка
закладк: закладки
увидет: увидеть
начал: начале
программн: программных программного
руководств: руководство
изнутр: изнутри
итог: итоге
минут: минуту минут
дел: делятся дело
вопрос: вопрос
рассказа: рассказано рассказать
бесполезн: бесполезная
жит: жить
сохраня: сохранять
эрик: эрика
цитат: цитаты
устройств: устройство
пришел: пришел
размер: размеры
недоч: недоч
ваш: вашим вашу
суперлайфхак: суперлайфхаков
попрактикова: попрактиковаться
генерир: генерирую
пространств: пространство
полност: полностью
покупк: покупкой
сталкива: сталкиваются
собствен: собственно собственных собственном
ручн: ручным
переписа: переписал
суток: суток
алгоритм: алгоритмы
материал: материалов
мегапроект: мегапроекты
хабр: хабр
передов: передового
обучен: обучения обучение обученную
отношен: отношениям
ртыван: ртывание ртыванием ртывания
эпизодическ: эпизодической
разлага: разлагаться
практик: практика
мысл: мысли
последн: последнее последней последние
заявлен: заявленными
месяц: месяцев месяц
сам: самое самый
манипулирова: манипулировать
стартап: стартап стартапам стартапа
туториа: туториал
возвраща: возвращается
переда: переданы
школ: школ
образован: образования
подобн: подобной
посмотр: посмотрим
вероятн: вероятностью вероятно
управлен: управление управления
наслед: наследием
предназначен: предназначенного
уважа: уважаемое
удобочитаем: удобочитаемостью
допуска: допускаемых
век: века
начина: начинающим
стандарт: стандартом стандарта
вс: вс
ускор: ускорить
начн: начнем
област: области
простот: простотой
плагин: плагинов плагины
сво: своими
веб: веб
программирован: программирование программировании программирования
нача: начал
непониман: непонимания
реша: решать
специалист: специалисты специалистов специалистам
порог: порог
станов: становится
значительн: значительно
тест: тесты тест
атак: атаки
явля: являюсь являются являющая является
редактирован: редактирования
огород: огород
вещ: вещей
свод: сводя
легас: легаси
руперт: руперта
развит: развитие
де: де
первичн: первичный
представ: представить
сайт: сайта сайтов
обеспечен: обеспечения
научпоп: научпоп
технолог: технологию технологии
задач: задачи задач задачах
файл: файлов файлы
различн: различные различных различными
хвата: хватает
нейросет: нейросетей
сегодняшн: сегодняшнего
посвящ: посвящена
треб: требует
инструментар: инструментарий
истор: историй истории история
зовут: зовут
зрен: зрения
пробл: проблем
ещ: ещ
факт: факт факто
сер: серии
легк: легко
сет: сети сеть
конфиденциальн: конфиденциальная конфиденциальность
вид: вид виде
сканер: сканер
науч: научимся
кошк: кошки
чуж: чужого
разумн: разумно
нескольк: нескольких
вышеперечислен: вышеперечисленных
договор: договор
обеща: обещающих
контролирова: контролировать
хот: хотят
позволя: позволяют
платн: платный платную
хоч: хочу
рейтинг: рейтинга рейтинг
способн: способны
визуализац: визуализация
известн: известных
структурирова: структурировать
горяч: горячих
сторон: стороны
постав: поставить
поток: потоки потока
поддержк: поддержки поддержка
платя: платящих
тысяч: тысячи
дня: дня
хорош: хорош
предназнач: предназначена
пуст: пусть
ид: иду
наш: нашего нашем
ин: иной
суммарн: суммарной
пользовател: пользователей
компонент: компонентов
над: надеюсь
погна: погнали
заказ: заказу
робот: роботы
разрабатыва: разрабатывает разрабатывать
сервис: сервисами сервисы сервисов
информац: информация информации
боязн: боязнь
анализ: анализу
мейер: мейера
трат: трата
скилл: скиллами
ровн: ровно
жадн: жадные
пет: пет
сборк: сборки сборку
ко: кое
мессенджер: мессенджеры
обработк: обработкой
черн: черного
собра: собрано собрать
например: например
запута: запутано
самостоятельн: самостоятельно
агрегатор: агрегатор
коллег: коллегам
презентац: презентация презентации
понятн: понятно
соответств: соответствующее соответствующей
нативн: нативные
огромн: огромные огромное
месячн: месячный
польз: пользуются
рассмотрел: рассмотрели
воз: воз
отлич: отличия
уровн: уровня
включа: включает
сист: систем
специфичн: специфичный
углублен: углубленно
упорств: упорством
качеств: качества качестве качество
смс: смс
выбор: выбор
форвард: форварда
проблем: проблемы проблемами
сервер: сервер
раздел: разделы
автоматическ: автоматически
сол: соло
аббревиатур: аббревиатура
нек: некий
унифицирова: унифицированно
лучш: лучшие лучшего
незнан: незнания
дума: думаю
операц: операциями
облегч: облегчить
возможн: возможности возможность возможных
интересн: интересна
этичн: этичный
ленив: ленивый
открыт: открытых
семантик: семантика
функциональн: функционального функциональное
подтвержд: подтвержден
крупн: крупных
сконфигурирова: сконфигурированных
взгляд: взгляд
потряса: потрясающих
отрицательн: отрицательном
портфол: портфолио
контент: контент
изображен: изображения
откр: открыл открыть
насмотревш: насмотревшись
наход: находится
опенсорсн: опенсорсного
термин: терминах
источник: источников
studio: studio
css: css
sourc: source
ruvd: ruvds
obojealexand: obojealexander
devop: devops
argocd: argocd
intellig: intelligence
wysiwyg: wysiwyg
actiontext: actiontext
helm: helm
assembl: assembler
adalan: adalan
qa: qa
number: number
rembo: rembo
twitter: twitter
vova: vova
java: java
statefulset: statefulset
zend: zend
mastodon: mastodon
action: action
vim: vim
api: api
text: text
trix: trix
mastervlado: mastervlados
boumrz: boumrz
python: python
ai: ai
modul: module
normalisht: normalisht
manag: manager
javascript: javascript
habr: habr
rl: rl
kera: keras
feder: federation
globalsign: globalsign
engin: engineer
pod: pod
postscript: postscript
bright: bright
secret: secret
youtub: youtube
tensorflow: tensorflow
rss: rss
goto: goto
jsonnet: jsonnet
kustom: kustomize
packag: package
alexrussianpyth: alexrussianpyth
chatgpt: chatgpt
kali: kali
jetbrain: jetbrains
facebook: facebook
xxi: xxi
tl: tls
php: php
inteleph: intelephence
maycod: maycode
open: open
sivchenko: sivchenko
usb: usb
rostislavdugin: rostislavdugin
reactj: reactjs
deploy: deployment
usbchardwar: usbchardware
mf: mf
html: html
scoff: scoffs
yaml: yaml
group: group
rail: rails
develop: development
rous: rouse
translat: translate
servic: service
vk: vk
pycharm: pycharm
rusau: rusau
numpi: numpy
primetalk: primetalk
game: game
phpstorm: phpstorm
lsp: lsp
admin: admin
artsiom: artsiom
kubernet: kubernetes
git: git
linux: linux
json: json
osint: osint
sam: sam
dto: dto
nvim: nvim
delphi: delphi
custom: customization
apiset: apiset
telegram: telegram
gitop: gitops
pdf: pdf
django: django
footprint: footprinting
neovim: neovim
window: windows
aykuli: aykuli
rubi: ruby
