обрат: обратить
максимальн: максимальной максимально
найт: найти
информацион: информационной
отчекан: отчеканил
расскаж: расскажем расскажу
образ: образом
ивент: ивентов
стат: стать статье статьи статья
экспорт: экспорт
стар: старую
дорог: дорогих
мнен: мнение
объясн: объяснить
обзор: обзор обзоры
появ: появилась
чанг: чанга
ниш: ниш
реализова: реализовали реализовано
работ: работа работе работы работу
недоумева: недоумевали
дент: дент
правок: правок
показыва: показывать
дополнительн: дополнительных
домен: доменов
продавц: продавца
вернут: вернуться
мероприят: мероприятий мероприятия
экономик: экономики
концентрац: концентрация
александр: александр
инфраструктур: инфраструктура
поигра: поиграть
сто: стоит
человек: человеко
тг: тг
схем: схема
туч: тучи
менеджмент: менеджмент
легкомысл: легкомыслия
михайлец: михайлец
галочк: галочки
л: л
поисковик: поисковики
вселен: вселенной
мобильн: мобильных
ожида: ожидают ожидал
п: п
привлек: привлек
снижен: снижения
сув: сув
р: р
публикац: публикации
структур: структуры
скопирова: скопировать
студент: студенты
умнеют: умнеют
график: график
балл: баллы
подел: поделился поделимся
логическ: логические
сезон: сезон сезоне
поэт: поэтому
звезд: звезд
котор: котором
денег: денег
мин: мин
убийц: убийцы
изготовлен: изготовления
креатив: креативы
эксперимент: эксперименты эксперименте
продава: продавать
исследован: исследования
репортаж: репортаж
связа: связав
кухн: кухне
участвова: участвовал
этап: этапе
проверя: проверяем
статистик: статистика статистикой
соблюден: соблюдение
проект: проектов проектом проекты проект проекта
связ: связи
лиг: лига лиги
феврал: февраля феврале
совместн: совместно
лид: лиды
вперв: впервые
классическ: классическая классический
относительн: относительно
профил: профиль
дела: делаем делать
тренд: трендов тренды
аналог: аналог
провед: проведена
получ: получилось
документац: документация
публик: публикую
несут: несут
читальн: читальный
верс: версии версию
важн: важна важно
провел: провели
член: членов
отреза: отрезал
майнер: майнеров
маркетинг: маркетинг
книг: книгу книгой книги
аргумент: аргументы
списк: списка
рук: рукой
час: час часов
столкнул: столкнулся
прост: простой простыми
метр: метр
убедительн: убедительно
десктопн: десктопный
покрас: покрасить
зал: зал
рубл: рублей
заодн: заодно
индустр: индустрии
проверк: проверку
постро: построена
могл: могли
лиц: лицо
ложк: ложки
встрет: встретились
карточк: карточку
уровен: уровень
нов: новом новый нового новой новые новых
копирайтинг: копирайтинга
тимлидск: тимлидского
больш: большая большую
айфон: айфоном
серийн: серийный
медийн: медийная
монетизац: монетизацию монетизация
мест: месте
неприличн: неприличных неприличный
част: часть
цифров: цифровой
счет: счет
тишин: тишину
подделк: подделку
андр: андрей
опубликова: опубликовать
карьер: карьера
длительн: длительная
слов: словами
направлен: направления
нну: нную
игр: играми игру игр игры
кана: канал
попаст: попасть
геймифицирова: геймифицировать
накоп: накопившихся
постоя: постоянно
нны: нный
сдела: сделать сделали сделал
внимательн: внимательных
определен: определение
отзыв: отзывов отзывами
мерч: мерч
отда: отдали
доставл: доставлен
особен: особенный
заядл: заядлым
выкладыва: выкладываю
сложн: сложный сложнее
редк: редкого
озон: озон
капот: капотом
исправлен: исправлению
совет: советов
примен: применить
жизн: жизни
штук: штуку
пример: примере
засижива: засиживался
локомотив: локомотива
систем: системы
мог: могу
генерирова: генерировать
пленк: пленки
решим: решимости
момент: момент
недособра: недособранной
заседан: заседание
основн: основные основными
упаковк: упаковка
синапс: синапсов
привлечен: привлеченных
вышл: вышло
сможет: сможет
метод: методы
машин: машинное
миха: михаил
групп: группы
сознан: сознания
подготов: подготовил
бонус: бонусы
заказыва: заказываю
требован: требований требования
решен: решений
постепен: постепенно
написан: написания
хотел: хотел
прозрачн: прозрачной
актуальн: актуальность
провод: проводим
артур: артур
средн: средний средней
нужн: нужны
номер: номер
подряд: подряд
хаб: хабы
бесплатн: бесплатно
вечер: вечер
продвижен: продвижение продвижения продвижении
скажет: скажете
современ: современного
выбира: выбирать
приложен: приложений приложение приложения
фрилансер: фрилансера
разработчик: разработчиков разработчика
результат: результат результатов
вызыва: вызывает
опыт: опытом опыта
чрезмерн: чрезмерном
выигра: выиграть
бонусн: бонусные
убереч: уберечь
настройк: настройка
витрин: витрину
дал: дали далее
приписк: припиской
документ: документы
прочтен: прочтение
предложен: предложений предложение
дубликат: дубликатов
ссылк: ссылку
чек: чек
прочита: прочитать
прасков: прасковью прасковья
жен: жена женой
анкор: анкоров
дам: дам
лох: лох
векторн: векторный векторных
дизайнер: дизайнером
спецпроект: спецпроектов
приобрест: приобрести
конкурентн: конкурентных
сквоз: сквозь
негодован: негодования
положительн: положительными положительных положительные
привязан: привязанности
живш: жившим
регистрац: регистрация регистрации
ситуац: ситуации ситуаций ситуация
выдач: выдачи
гипотез: гипотезы
притупля: притупляется
поисков: поисковая поисковой
гигант: гиганте
митап: митап
каза: казалось
счита: считать
внесен: внесении
пометк: пометка
загрузк: загрузке
предусмотрет: предусмотреть
новостн: новостную
пошел: пошел
цел: целью
продюсер: продюсер
цен: цены цене
кова: ковал
порассужда: порассуждал
лент: ленту
середин: середину
старш: старший
сдвинул: сдвинул
кажд: каждым
руководител: руководитель
лекарств: лекарство
настро: настроить
выходн: выходного
российск: российский
дзен: дзен
подключ: подключить
канал: каналов каналах каналы
вмест: вместе
филип: филип
боярск: боярского
золот: золотую
искусствен: искусственный
покупа: покупаю покупаются
жив: живых
обнов: обновить
поездк: поездка
объект: объект
бирж: бирже
разработк: разработке разработка разработки
закладк: закладки
графическ: графический
использова: использовать
достаточн: достаточно
руководств: руководство
сюд: сюда
релиз: релизе
карьерн: карьерные
список: список
импорт: импорта
лист: лист
полгод: полгода
стольк: столько
дудет: дудеть
дел: деле делюсь
организац: организации
вопрос: вопрос
краснопресненск: краснопресненская
дизайн: дизайн
рассказа: рассказать
пошагов: пошаговый
игра: играл
тяжк: тяжкое
внутрен: внутренней
устройств: устройство устройства
верстальщик: верстальщика
вымышлен: вымышленной
переход: переходу
так: такую такого таких таким
ответ: ответ
разброс: разброс
никт: никто
москв: москве
геймер: геймером
нормальн: нормального
баг: багов
покупк: покупки
течен: течение
разогна: разогнавшихся
баз: базы
техническ: техническая технического
понрав: понравится
алгоритм: алгоритмов
фев: фев
назва: назвали
заметк: заметке
материал: материале материалами
конкурс: конкурс
товар: товар товара
вентиляц: вентиляции
мегапроект: мегапроект мегапроекты
хабр: хабре хабр хабра
сэконом: сэкономить
аналитик: аналитиков аналитика аналитики
обучен: обучение
аа: ааа
савел: савелием савелия савелий
некотор: некоторые некоторый
рассмотр: рассмотрим
потенциальн: потенциального
иска: искать
куп: купит
подума: подумал
количеств: количество количества количеству количестве
соглашен: соглашение
попа: попали
проектировщик: проектировщиком
добав: добавить
посмотрет: посмотреть
просмотр: просмотров
ряд: ряд
сад: садимся
воцар: воцарилось
последн: последнее последние
друз: друзья
месяц: месяца месяцев
поднадоевш: поднадоевшее
сам: самых самые
интеллект: интеллект
стро: строится
учест: учесть
вдохновен: вдохновения
аутсорс: аутсорсе
стартап: стартапам стартапа
туториа: туториал
жанр: жанрах
зашел: зашел
организова: организовал
тайн: тайное
озвучен: озвученных
оказыва: оказывался
подобн: подобных
менеджер: менеджер менеджера
вероятн: вероятности
компан: компаний компании
рассказыва: рассказываю рассказываем
степен: степень
гост: гост
программ: программа программе программы
управлен: управлению управление
вчер: вчера
главн: главных главный
предназначен: предназначенный
представл: представлена
вед: веду
пят: пяти
изобрета: изобретал
наруша: нарушает
начина: начинайте начинаю
аудит: аудита
привет: привет
состоян: состоянии
поможет: поможет
стоя: стоять
прогноз: прогнозы
вс: вс
популярн: популярном
голландск: голландского
дайджест: дайджестами дайджестом дайджест
дич: дичи
спикер: спикеров
отозва: отозвалась
старух: старуху
магазин: магазина магазин
рам: рами
поэкспериментирова: поэкспериментировал
сво: сво свой своим
ран: ранее
веб: веб
кейс: кейс кейсов
нача: начал
специалист: специалисты специалистов
порог: порог
станов: становится
перспектив: перспективы
интернет: интернет
тест: тест
скинул: скинули
плеч: плечами
стрим: стрим
достигш: достигшую
технопарк: технопарк
игров: игрового игровые
оригинальн: оригинальные
оптимизац: оптимизация
выступлен: выступлений
законч: закончил
да: даю
теря: теряют
брендинг: брендинг
фрик: фриком
пришл: пришло
полн: полное
администрирован: администрирования администрирование
тимлид: тимлид
представ: представим
парирова: парировал
сайт: сайта сайте сайтов сайт
периодическ: периодически
бен: бена
знак: знаком
бер: берите беру
научпоп: научпоп
технолог: технологий
продолж: продолжил продолжить
предсто: предстоит
привлека: привлекать
комментар: комментарии
прощ: проще
нейросет: нейросеть нейросети
проч: прочее
работа: работающего работают работали работает
смогут: смогут
спринт: спринты
песочниц: песочницы песочница
сегодняшн: сегодняшний
пар: пару
услуг: услуги
подписчик: подписчиков
рекламирова: рекламировать
дадут: дадут
ел: ели
блог: блог
необходим: необходимо
нног: нного
поправ: поправят
истор: истории история
зовут: зовут
прод: прод
проб: пробившиеся
логотип: логотипов логотип
интерфейс: интерфейс
чист: чистое чисто
модел: модели
шум: шум
пробл: проблему
франшиз: франшиз
сложност: сложности
ещ: ещ
параметр: параметрам
вниман: внимание
видн: виднее
грузов: грузового
автор: авторы авторов автором
очеред: очереди
чита: читать читайте
сет: сети сеть
новинк: новинки
мошенник: мошенники
конфиденциальн: конфиденциальность
превраща: превращаются
чтен: чтения
намет: наметились
партн: партн
чуж: чужих
аномал: аномалия
подозрен: подозрений
договор: договорились
бизнес: бизнеса бизнес
вышел: вышел
хот: хотим
позволя: позволяет
дне: дней
хоч: хочу
внедрен: внедрению
рейтинг: рейтинга рейтинг рейтингом
дол: долей доля
дом: домены дом
наушник: наушники наушниках
реш: решила решили
исправл: исправлена
поддержа: поддержать
покупател: покупателя
известн: известного
общ: общем
фриланс: фриланс
курьер: курьером
остан: останемся
поток: поток потоки потока
маркетплейс: маркетплейсе
честн: честно
наб: наб
поддержк: поддержка
угодн: угодно
недел: неделю недели
игростр: игрострой
тысяч: тысячи
дня: дня
серг: сергей
хорош: хорошую хорошим хороший
стоимост: стоимостью стоимость
повод: поводу
пуст: пусть пустая
ид: идеи
любим: любимыми
вторник: вторник
социальн: социальные
вдохновл: вдохновл
наш: нашей
редактор: редакторы
слыш: слышит
ис: ис
пользовател: пользователей
посвящен: посвященный
руснак: руснак
хостинг: хостинг
ищ: ищем
язык: языка
заказ: заказами заказ заказов
сил: сил
останов: остановите
план: планы
доллар: долларов
попроб: попробую
воспа: воспал
сервис: сервисов
краулер: краулер
свич: свичи
мониторинг: мониторинг
информац: информацию информация
взят: взять
фронтенд: фронтенду фронтенде
облачн: облачных
распозна: распознаны
правд: правды
безум: безумия безумие
негативн: негативного
взял: взяли
выгляд: выглядят выглядит
анализ: анализа
хакатон: хакатоны
маг: магия
трат: трата
лаврент: лаврентий лаврентия
замен: заменить
год: годом
ковырян: ковыряния
сродн: сродни
предварительн: предварительные
трудност: трудностями
конкретн: конкретно
открыва: открываете
ожидан: ожидание
куратор: кураторы
переговорк: переговорке
законодательств: законодательство
парочк: парочку
квадратн: квадратный
создан: создания
сериа: сериала
аудитор: аудитория
собра: собралось собрал
вывод: выводы выводу
прич: прич
избега: избегают
приш: приш
дожда: дождаться
знает: знаете знает
понедельник: понедельник
постара: постарались
инсайт: инсайтов
одн: одно
продаж: продажу
прин: прин
мар: мар
коллег: коллегами
реклам: рекламе реклама рекламы
запуст: запустили
выставля: выставляю
корпоративн: корпоративный
рекомендац: рекомендации рекомендациям
извращен: извращение
соответств: соответствия
нативн: нативные
масс: масса
масштаб: масштабов
подборк: подборка
инфоповод: инфоповоды инфоповодов
чест: честь
доклад: докладами
смоделирова: смоделировал
команд: команды командой команде командами
сообществ: сообщество сообщества
молчан: молчание
ма: мае
любопытн: любопытных
познаком: познакомилось
врод: вроде
стран: странных
электрон: электронной
аренд: аренду
инструкц: инструкцию инструкция
обнаружива: обнаруживаю
январ: январе
десятк: десятки
использован: использованием
платформ: платформы
выхлоп: выхлоп
громк: громкие
потрат: потратил
консол: консоли
март: марта
войт: войти
качеств: качество
аккаунт: аккаунт
топ: топа топ
эмоц: эмоций
состав: составила
прошел: прошел
глаз: глазах
аукцион: аукционов аукциона аукционом
выбор: выбора
благодарн: благодарностей
порядк: порядку
пиш: пишу
проблем: проблема
подробн: подробно подробную подробный подробнее подробная подробное
опытн: опытный опытными
сервер: сервер серверов
раздел: разделы
жела: желанный
категорийн: категорийный
выража: выражало
яндекс: яндекс
об: обо
хлеб: хлеб
новост: новостей новости
лучш: лучшие
перв: первых первом
механизм: механизм
бог: бог
лошадин: лошадиных
сгуст: сгустились
небольш: небольшого небольшая
формат: формату
бол: боли
гайд: гайд
написа: написал написано
прорух: проруха
поиск: поиск поиске
интересн: интересное интересный интересных
возможн: возможностей возможность возможно
оп: опыт
упуст: упустить
коробк: коробке
ленив: ленивый
выбра: выбранные
трехчасов: трехчасовые
голов: головах
образовательн: образовательные
определ: определ
как: какие какими каким
участник: участник участников
крупн: крупной крупная
все: всей
недостаточн: недостаточного
детств: детстве
неполн: неполной
голос: голосов
адекватн: адекватное
пк: пк
бров: брови
встреча: встречаются
взгляд: взгляд
загруж: загружено
растет: растет
высок: высокой
кивнул: кивнул
наверн: наверное
реальн: реальными
втор: вторая вторых
скидк: скидке скидкой скидки скидка
изначальн: изначальной
добавл: добавлен добавлена
точн: точно
рол: роли
бдительн: бдительность
контент: контент
скорм: скормим
прежн: прежнем
втб: втб
откр: открыть
форк: форк
способ: способен
справля: справляется
кнопк: кнопки
улучшен: улучшений
нахож: нахожу
компьютерн: компьютерные
доказа: доказать
аврамчук: аврамчук
никак: никаких
конференц: конференции
источник: источник
панел: панелью
рекоменд: рекомендуют
пожелан: пожеланий
data: data
scream: screaming
conf: conf
mode: mode
plai: play
twitter: twitter
dev: dev
frog: frog
seooutstaff: seooutstaff
seohiv: seohive
api: api
digit: digital
cto: cto
app: app
ux: ux
skovalev: skovalev
selectel: selectel
kumykov: kumykov
io: ios
gpt: gpt
markati: markaty
pro: pro
ekamelev: ekamelev
javascript: javascript
grpc: grpc
teamlead: teamlead
vk: vk
friendli: friendly
airpod: airpods
habr: habr
mindmap: mindmap
devtalk: devtalks
hidadmin: hidadmin
etxt: etxt
fortun: fortune
appl: apple
android: android
webtron: webtronics
eduard: eduard
peopl: people
factorio: factorio
youtub: youtube
deni: denis
rss: rss
vite: vite
premium: premium
molyanov: molyanov
leagu: league
design: design
civil: civilization
midjournei: midjourney
recoveri: recovery
machin: machine
seo: seo
chatgpt: chatgpt
rvnikita: rvnikita
orev: orever
twitch: twitch
svg: svg
learn: learning
ttd: ttd
facebook: facebook
rustor: rustore
telegram: telegram
store: store
sergeylinkin: sergeylinkin
spectr: spectr
siteanalyz: siteanalyzer
url: url
commerc: commerce
googl: google
nurk: nurked
php: php
fullstack: fullstack
spider: spider
zelenykh: zelenykh
