оценк: оценку оценке оценка оценки
говор: говорится говоришь
понима: понимает понимаю
значен: значения значений
стат: стать статье статьи статья
стар: старую
составлен: составлением составлении
приукрас: приукрасил
объясн: объяснить
реализова: реализовать
работ: работа работе работы работу
проблематик: проблематика проблематику
дополнительн: дополнительных
среднестатистическ: среднестатистическое среднестатистическими
убыван: убывания
впечатлен: впечатление
получен: получение
пол: поле
сто: стоит
учебн: учебных
основан: основании
человек: человеком
финальн: финальное финального финальном
менеджмент: менеджмент
пункт: пункты пункт
обзвон: обзвоне обзвон
каса: касается
то: той
мобильн: мобильных мобильного
присутств: присутствуют присутствует
знакомств: знакомство
должн: должны должна
структур: структурами структуры
публикац: публикации
подел: поделиться
бэкграунд: бэкграундом
прощупыван: прощупывания
предсказуем: предсказуемость
назван: названия
котор: которую которым которое котором которому которыми
учт: учтя
карм: карма
провест: провести
осозна: осознает
адресн: адресную
несб: несбывшихся
перемнож: перемножить
ум: умею
шаг: шаг
прав: правило
связа: связанных связан
либ: либо
проект: проекты проект проектах проектов проекте проектами проекта
связ: связи
появля: появляются появляется
лид: лиду
зад: задам
отмеч: отмечено
анализирова: анализировать
профил: профиль профилю
дела: делаться делает делать
сут: сути
ребят: ребята
документац: документация
дискусс: дискуссией
проблемн: проблемной
верс: версию
шкал: шкале
пересека: пересекается
маркетинг: маркетинг
увеличива: увеличиваю
разобра: разобраться
прост: простой простая простые
прием: приеме
разнос: разнос
проверк: проверка
занима: занимал занимается занимался
заявля: заявляет
тенденц: тенденция
уровен: уровень
нов: новых новую
умеет: умеет
внешн: внешние
медийн: медийная
част: часть части
динамическ: динамическими
должностн: должностных
слов: слова
завод: заводить
предпочел: предпочел
внимательн: внимательно
сдела: сделать сделанных сделал
определен: определения определенный определенные определенных
сложн: сложная сложно
автотест: автотестов
якор: якоря
совет: советы
пут: путь
примен: применить
пример: пример примере примеры примером примера
вперед: вперед
сверк: сверка
персонал: персоналом персоналу
итогов: итоговое итоговая
алгоритмическ: алгоритмическая
класс: классам
узна: узнают
пропуска: пропускает
перебра: перебрать
курс: курс курсов курсы
текущ: текущий
покорен: покорению
облада: обладают обладает
метод: методов
процесс: процесс
помогут: помогут
техник: техник техникам
окружа: окружающем
написан: написания
хотел: хотел
спуска: спускаемся
обраща: обращаем обращаю
подряд: подряд
рынк: рынке
нрав: нравится
неизвестн: неизвестно
современ: современную
выш: выше
приложен: приложений приложениям
разработчик: разработчиков
дорожк: дорожке дорожки
вклад: вкладе
показател: показателей
будущ: будущем
интерва: интервала
корректн: корректности
желан: желание
сподвигнет: сподвигнет
мышк: мышки
серверн: серверных
навык: навыков навыкам навыками навыки
шир: шире
профильн: профильного профильном
нул: нуля
нормирова: нормировать
сравнен: сравнении
резюмиру: резюмируем
минимальн: минимальным
протестирова: протестировать
следствен: следственные
рост: рост росту роста
обширн: обширную
регистрац: регистрация регистрации
убед: убедиться
ситуац: ситуации ситуацию ситуацией
имеет: имеет
промах: промахов
цикл: цикле
отсутств: отсутствует
причин: причины причинно
различ: различия
архитектурн: архитектурно
цел: целью цель цели
цен: ценнее
кажд: каждом
руководител: руководитель руководителей
дзен: дзен
множеств: множество множества
идущ: идущих
золот: золотые
директор: директор
отличн: отлично
мотивац: мотивация
оффер: оффер
ведет: ведется
довод: доводить
использова: использовал
логик: логики
точечн: точечные
уточня: уточняем
кроссбраузерн: кроссбраузерное
безусловн: безусловно
пройт: пройти
достаточн: достаточно
добавля: добавляем
сюд: сюда
настоя: настоять настоящий
список: список
кадр: кадров
наглядн: наглядно
выдел: выделил выделить
терминолог: терминологией
след: следующие следующем следующее
прошедш: прошедшие
типов: типовые
строк: строку
дизайн: дизайна дизайн
резюм: резюме
мобилк: мобилкой
снежн: снежный
помим: помимо
клиент: клиент
так: таком
общен: общения общении общение
пыл: пыли
нагрузочн: нагрузочное
баг: бага баги
выясня: выясняются
зарубеж: зарубеж
событ: событием
техническ: техническое техническим технический технического техническая техническом технических технические техническими
оптимальн: оптимальные
передела: переделал
разниц: разница разницы разницу
назва: назвать
приближен: приближенная
товар: товар товара
подошл: подошли
описыва: описываем
подбира: подбирать
некотор: некоторых
аргументирова: аргументировать
рассмотр: рассмотрим
количеств: количество
соглашен: соглашение
попа: попало
добав: добавило добавить
просмотр: просмотров
содержат: содержат
зна: знаю зная
услов: условиях условия
стро: строю
представля: представляются
характериз: характеризует
друг: другом друг другим
обезлич: обезличены
приход: приходится приходилось
правильн: правильный
теоретическ: теоретических теоретические
поня: понять
сомнева: сомневаюсь
компан: компаниях компания компаний компании
рассказыва: рассказывает рассказывал
программ: программа программе программы
получа: получаешь получаем получаю получается
разбира: разбирается
фундаментальн: фундаментально фундаментальные
соответствен: соответственно
фич: фич
низк: низкой
оперирова: оперировать
элемент: элемента
привет: привет
поможет: поможет
отдел: отдела
использ: используются
созда: создает создало создать
кусок: кусок
объемн: объемное
помн: помним помните
кейс: кейсы кейс
отдельн: отдельно
сигна: сигнал
рывок: рывок
тег: теги
оптимизац: оптимизации
тем: темы
применя: применять
администрирован: администрирование
приглашен: приглашение
знан: знанием знаний знаниями знания
выстраива: выстраивать
знак: знаком
выстро: выстроил
комментар: комментарии
сотрудник: сотрудников сотрудника
прощ: проще
проч: прочего
работа: работают работать работал работает
сильн: сильно сильный
песочниц: песочницы песочница
кнопочк: кнопочки
долж: должен
приукрашиван: приукрашиванию
услуг: услуги
кандидат: кандидатом кандидат кандидату кандидатов кандидате кандидата кандидатах кандидатами кандидаты кандидатам
проанализирова: проанализировать
необходим: необходимо необходимости необходимым
блог: блог
фреймворк: фреймворках фреймворка
подходя: подходящие подходящих
числ: числа
автоматизац: автоматизацию автоматизацией автоматизации автоматизация
сложност: сложностей
вниман: внимание
фло: флоу
автор: авторы авторов автором
очеред: очередь
собеседован: собеседовании собеседований собеседование собеседованию собеседования
превраща: превращается
виде: видео
самообразован: самообразованием
профессиона: профессионала
подход: подходов подходят подхода подходит подходы
положен: положение
явн: явно
тестирован: тестировании тестирования тестирование тестированием
оценива: оцениваю оценивать
оста: остаться оставшееся
вчерашн: вчерашних
эксперт: экспертов
спрос: спросить
цепля: цепляется
принима: принимает принимается
тип: типами типы типов
статическ: статическими
реш: решили решить
международн: международной
общ: общую общие общих
подтвержден: подтверждение
перечисл: перечислены перечислено
зада: задает задали задаются задаю задайте задается
совпада: совпадает
состо: состоит
систематизирова: систематизированная
обе: обеих
расскажут: расскажут
профессиональн: профессиональные профессиональным профессиональной
сред: среди
тестов: тестовая тестовые
чувств: чувство
мног: многих
люб: любого любом
язык: языкам языков языка языки языке языком
планирован: планированием
фот: фото
фактор: фактор факторы
гор: горы
разн: разных разные
отправн: отправные
люд: людей
разв: развит развился
отчет: отчеты
отвеча: отвечает отвечать
год: годам
владен: владению
конкретн: конкретную конкретной
тыка: тыкать
ожидан: ожиданий ожидание
интерв: интервью
критер: критерии критерием
кругозор: кругозор
создан: создания созданием создание
ставл: ставлю
рассужда: рассуждать рассуждает
чеклист: чеклист
вывод: выводы выводах
привод: приводит приводить
знает: знаете знает
настольн: настольных
реклам: реклама
рассылк: рассылку
корпоративн: корпоративный
потребн: потребность
выпускник: выпускников
одинаков: одинаковыми
обвод: обводим
шаблон: шаблонные шаблон шаблонность
расширя: расширяйте
инструмент: инструментами инструментах инструментов инструмента инструменты инструментам инструмент
ведущ: ведущим ведущую
итак: итак
команд: команда команде
достоверн: достоверности
масл: масла
субъективн: субъективная
стек: стек стеком
использован: использования
запрос: запросы запрос
поскольк: поскольку
горазд: гораздо
войт: войти
аккаунт: аккаунт
присутствова: присутствовало
табличк: табличка
глаз: глаза глаз
прохожден: прохождению прохождении
сраз: сразу
порядк: порядке
подробн: подробную
колонк: колонку
упомина: упоминалось
конвейерн: конвейерной
половин: половине половины
похож: похожие
задействова: задействованных
жела: желанный
яндекс: яндекс
новост: новости
перв: первую первые первым первое
достижен: достижения достижений
присла: прислали
проведен: проведении проведения
написа: написанное написать написал написано написанного
добр: доброй
поиск: поиск поиске
изменен: изменение
заказчик: заказчиков
образовательн: образовательные
как: какую какими какому каких какие
эдак: эдакий
фиксир: фиксируется
великолепн: великолепным
нащупыва: нащупывать
высок: высокой высоких
добавл: добавлю
точн: точно
высот: высот
риск: риски риска риск
точк: точки
научат: научат
способ: способен способы
продукт: продуктов
акцентирова: акцентировать
быва: бывают
максимальн: максимально
заявл: заявлена заявлен заявлены заявлено
отсеива: отсеиваются отсеивается
финал: финале
проторен: проторенной
найм: найме найма
образ: образа образ
независим: независимо
ввод: ввода
конц: конце
дефект: дефект дефектов дефектам
вскрыва: вскрываю вскрываем
аспект: аспектами
предлага: предлагает
появ: появилось
случа: случае случаев
успех: успехов
практическ: практической практическую практические практическая практическое
кадров: кадровые кадровый
вернут: вернуться
александр: александр
приглаша: приглашаем
д: д
соискател: соискатели соискателям
неловк: неловкую
ожида: ожидаю
дава: давать
х: х
логическ: логических
показа: показал показали
подмеча: подмечаем
мин: мин
мир: мире
писа: писать
впечатл: впечатлите
обсужда: обсуждается
идеальн: идеальном
знают: знают
этап: этап этапе этапы этапа этапах этапов
интервьюер: интервьюерам интервьюера
нажа: нажали
получ: получив получишь получу получите получить
подтвержда: подтверждаются
важн: важны важнее важна важным важно
кроссплатформен: кроссплатформенное
тестировщик: тестировщик
тупиков: тупиковой
ищет: ищет ищется
час: часов
внутр: внутри
задачк: задачка
индустр: индустрии
позиц: позицию
могл: могли
софт: софт
больш: большие большая большое
потенциа: потенциал
мест: место
спрашива: спрашивать спрашиваю
карьер: карьера карьеры
инженер: инженера инженер инженером инженеров
вход: вход
направлен: направлений
аналогичн: аналогичную
полезн: полезна полезной
попаст: попасть
пуга: пугает
эффективн: эффективного
шапк: шапку
англ: англ
терап: терапию
представлен: представление
видел: видел
исправ: исправить
работодател: работодателей
виден: видение видением
жизн: жизни
идт: идти
формальн: формальный формальность
мог: могу
сотн: сотни
момент: моменту моменты момент
формулировк: формулировку
отс: отсев
смог: смог
развива: развиваться
основн: основном
сможет: сможет
ротац: ротацию
подготов: подготовят подготовили
решен: решений решение решения
провож: провожу
нотификашк: нотификашки
комментирова: комментировать
провод: проводится проводят
личн: личном
нужн: нужный нужны
предметн: предметную
почв: почву
хаб: хабы
повыс: повысить
выбира: выбираю выбираются выбирать
ввел: ввели
результат: результатов
опыт: опыту опытом опыта
жизнен: жизненном
ваканс: вакансия вакансии вакансий
настройк: настройка
пониман: пониманию понимание
документ: документы
прочтен: прочтение
предложен: предложение предложений
сравнива: сравнивать
пускан: пускания
реал: реалиям
выросл: выросло
невербалик: невербалику невербалика
дам: дам
дан: данных данными данные данном данная
дат: даться дать
указа: указанным указано указан указал указаны
состоя: состояло
код: код кода коде
соотнест: соотнести
ладн: ладно
репетитор: репетитором
используем: используемым
загрузк: загрузки
достиг: достигая
возника: возникает
конверс: конверсию конверсии
шаблонизац: шаблонизация
галер: галере
оцен: оценить
тезис: тезисами
минимум: минимум
углубля: углубляться
обознач: обозначить обозначу
разбор: разбор
обнов: обновить
име: имеем
позва: позвали
разработк: разработке разработках разработка
закладк: закладки
увидет: увидеть
вал: валятся валится
уверен: уверенностью уверенность уверенным
стара: старается старайтесь
программн: программного
плоскост: плоскость
итог: итоге итогу
вспомина: вспоминаем
минут: минуту минуты
стольк: столько
вопрос: вопроса вопросы вопросу вопрос вопросом вопросов
ближайш: ближайшее
рассказа: рассказать
игра: играть
внутрен: внутренней
устройств: устройство
специализир: специализирующихся
переход: переходе
договарива: договариваются
проход: проходит проходят проходить
ответ: ответа ответ ответить ответы
изучен: изучения изучении
лидовск: лидовскими
сталкива: сталкиваюсь
срок: срок
ручн: ручное ручных
алгоритм: алгоритм
расширен: расширение
копипаст: копипаста
слыша: слышал
поднима: поднимаете
мегапроект: мегапроекты
хабр: хабр
абстрактн: абстрактный
отношен: отношения
иска: искаться
продолжительн: продолжительный
обща: общается общаются общаешься
мысл: мысль
практик: практики практике
последн: последнем последние
заявлен: заявленных заявленные заявленными
сам: самую самая самый
копилк: копилку
качествен: качественный качественной
сутк: сутки
стартап: стартапам
задава: задавать
школ: школ
образован: образования
подобн: подобными подобная
посмотр: посмотрим
управлен: управление
принят: принятие принятым принятия
скрининг: скрининге скрининг
представл: представлена
век: века
начина: начинаю начинает начинающих
тонкост: тонкости
обязан: обязанностей обязанности
покаж: покажу
мотив: мотивы
област: областей области область
сво: свой
веб: веб
приемк: приемки
программирован: программированию программирования
реша: решал решает решать решаемых
специалист: специалист специалиста специалистов
собесед: собеседующий
перспектив: перспективам
тест: тестов тест
истин: истинный
тесн: тесно тесном
ручник: ручниках ручнике ручник
явля: является
появлен: появлениями
теря: теряется
развит: развития
первичн: первичного первичный первичном
владеет: владеет
сайт: сайта
обеспечен: обеспечения
научпоп: научпоп
технолог: технологий технологиях
происход: происходит происходить
задач: задачами задача задачах задачей задачу задачи задач
придержива: придерживаться
выясн: выяснить
пользова: пользоваться
недосказан: недосказанности
различн: различных
достигнут: достигнут
отрабатыва: отрабатывать
подойдет: подойдет
пар: пару
виж: вижу
корзин: корзину
инструментар: инструментарию
зовут: зовут
истор: истории
ход: ходу
двум: двумя
пробл: проблему проблем
факт: факт факту фактом
закрыва: закрывать
убра: убрать
вид: видит виды видим
конфиденциальн: конфиденциальность
отведен: отведенное
умен: умением умений умение
кошк: кошки
теор: теории теорией теорию
печальн: печальный
диапазон: диапазон
нескольк: несколькими
обеща: обещающих
хот: хотите
позволя: позволяет
ставьт: ставьте
хоч: хочу
рейтинг: рейтинг
переезд: переезда
компетенц: компетенций
способн: способных
зп: зп
сторон: сторон стороны сторону
шоков: шоковую
поток: потоки
указыва: указывают
смотр: смотрим
поддержк: поддержка
пройден: пройденные
тысяч: тысячи
глубок: глубокое глубоко глубокие
модульн: модульное
принцип: принципе принципу принципов
ид: идем
переделыва: переделывал
предыдущ: предыдущим предыдущему предыдущих
ин: иного
пользовател: пользователей
успешн: успешно
над: надеюсь
выгод: выгоден
большинств: большинства большинстве большинство
сервис: сервисов
регулярн: регулярно
информац: информацию информацией информация информации
описа: описать
призыв: призывы призывами
сход: сходить
ключев: ключевые ключевыми ключевому
автоматизатор: автоматизаторам автоматизатором
анализ: анализа анализом анализ
собеседова: собеседовал собеседоваться
скрыт: скрытым
скилл: скиллы скиллами
экран: экране
английск: английского английским
максимум: максимум
навод: наводит
упа: упало
закрыт: закрытия
например: например
подготовк: подготовки подготовка
коллег: коллегам
классн: классных
попрош: попрошу
рекомендац: рекомендации
понятн: понятно
соответств: соответствует
нативн: нативных нативные
безнадежн: безнадежности
огромн: огромным
месячн: месячный
ответствен: ответственные
потрачен: потраченного потраченное
стран: странно
уровн: уровне уровнем
отлич: отличие
мо: моим моему мое
сист: систем
качеств: качествам качества
смс: смс
выбор: выбор выбора выбором
наскольк: насколько
разочарова: разочарован
пиш: пишите
проблем: проблема
соверша: совершать
стрессов: стрессовой
планк: планку
раздел: разделы
кружок: кружок
унифицирова: унифицированы
лучш: лучшие
формат: формата
умеют: умеют
относ: относится
крайн: крайне
пойдет: пойдет
интересн: интересна интересные
возможн: возможность
погружа: погружается погружаться
оп: опыт
артефакт: артефакты
упуст: упустил
огон: огонь
открыт: открытой открытым открытием
выбра: выбрав выбраны выбрать
буквальн: буквально
увелич: увеличить
хочет: хочет
сот: сотен
оптимизирова: оптимизировать
страниц: страницы
взгляд: взглядом
портфол: портфолио
бытов: бытовой
архитектур: архитектуре
смеща: смещаться
улучша: улучшать
откр: открыть
справля: справляется справляться
никак: никаких никакого
слуша: слушаю
каков: какова
studio: studio
android: android
js: js
hr: hr
handshak: handshake
adalan: adalan
sql: sql
youtub: youtube
qa: qa
mobil: mobile
twitter: twitter
desktop: desktop
xctest: xctest
selenium: selenium
web: web
playwright: playwright
enter: enter
adb: adb
espresso: espresso
appium: appium
test: test
facebook: facebook
xxi: xxi
telegram: telegram
url: url
junior: junior
senior: senior
unit: unit
codeceptj: codeceptjs
vk: vk
alexand: alexander
uiautom: uiautomator
habr: habr
adushev: adushev
