жертв: жертвами жертвы
готов: готовится
максимальн: максимальной максимально
оценк: оценке
аудиодорожк: аудиодорожку
движ: движемся
информацион: информационная информационной
криптограф: криптографии криптография
верифицирова: верифицировать
независим: независимой
образ: образом
стат: стать статье
воен: военный
стар: старая старую
ввод: ввода
эксфильтрац: эксфильтрацию
обычн: обычная
рабоч: рабочем
видеозап: видеозапись
стал: стала стало
окт: окт
предлага: предлагают
электроник: электроники
появ: появился появились
случа: случае
един: единое
работ: работа работы
запуска: запускает
правок: правок
показыва: показывает показывать
дополнительн: дополнительный
практическ: практически
сценар: сценарий
доступ: доступ доступе
вернут: вернуться
выяв: выявить
подпольн: подпольном
съ: съ
получен: полученный получение получения
основан: основания
человек: человека человеку
децентрализова: децентрализованные
схем: схема схемы
янв: янв
д: д
специализирова: специализированный
менеджмент: менеджмент
вектор: вектор
и: ии
единствен: единственная
экра: экрана
местоположен: местоположение
арм: армии
личност: личность личности личностей
мобильн: мобильных
изменя: изменялось
парольн: парольный парольному парольной парольного
гуден: гудении
исследовательск: исследовательской
публикац: публикации
скопирова: скопировать
дава: давайте
отправ: отправить
распечата: распечатать
поэт: поэтому
человеческ: человеческой
назван: название
котор: которое которую
цивилизац: цивилизации
времен: временем
редактирова: редактировать
мин: мин
вариант: варианты вариант
мир: мир мире
писа: писать
эксперимент: эксперимент
предприят: предприятия
ящик: ящик ящика
совершен: совершенно
хакерск: хакерское хакерских
связа: связать
безопасн: безопасных безопасность безопасным безопасности
этап: этап
мка: мка
уч: уч учить
проект: проекты
связ: связи
приватн: приватные
относительн: относительно
опас: опасаясь
адресат: адресату
профил: профиль
дела: делают
сообщен: сообщения сообщений
тренд: тренды трендов
получ: получили получила получено
игрушек: игрушек
дискусс: дискуссия
документац: документации
публик: публикуют
распечатк: распечатку
колебан: колебания
несущ: несущей
верс: версию версия
важн: важно
провел: провели
маркетинг: маркетинг
увеличива: увеличиваться увеличивает
книг: книг книги
национальн: национальный
рук: руки
час: часа
чат: чате
прост: простой простое
трафик: трафика
метк: метку
нно: нной
прям: прямую
ауд: аудио
индустр: индустрию индустрии
типографск: типографской
свободн: свободный
мку: мку
светл: светлое
постквантов: постквантовые постквантовых
движен: движений движения
нов: новые новый
клавиш: клавиш
софт: софт
больш: большой
ответн: ответную
медийн: медийная
мест: места
цифров: цифровая цифровых цифровом
порядок: порядок
слож: сложилась
подделк: подделки
опубликова: опубликовала опубликовал
предполож: предположим
устро: устроено
слов: словах
журна: журнала
шифрован: шифрованием шифрования шифрование
поддела: подделать
акселерометр: акселерометру
аналогичн: аналогичными
двоичн: двоичной
пострада: пострадал
полезн: полезны
нны: нные нный
системн: системный системных
гомоморфн: гомоморфное гомоморфного
сдела: сделать сделаны сделано
эффективн: эффективную
выкладыва: выкладывают
сложн: сложный сложнее сложно
брутфорс: брутфорс брутфорса брутфорсом
дают: дают
любител: любителям
совет: совет
примен: применить применили
ост: оста
жизн: жизни
превыс: превысило
подключа: подключаются
квантов: квантовых квантовым
аутентификац: аутентификации аутентификация
систем: система
отд: отда
генерирова: генерировать
полноцен: полноценные
расшифровк: расшифровки
узна: узнать
государствен: государственного
момент: момент
выд: выда
шрифт: шрифтов шрифт
лишн: лишним
трудн: трудно
упаковк: упаковки
вышл: вышла
обрабатыва: обрабатывать
бесед: беседу
математик: математика
сша: сша
метод: методы метод метода
машин: машинное машинного
процесс: процессе
преодолева: преодолевать
хеллма: хеллмана
выпуска: выпускает
гироскоп: гироскопу
шь: шь
почт: почты
требован: требования
офисн: офисные
постепен: постепенно
нных: нных
хронолог: хронология
консалтингов: консалтинговой
актуальн: актуальны
провод: проводить
нужн: нужны
букв: буквы
случайн: случайных случайно
помога: помогают
меня: менялись менять
хаб: хабы
описан: описанию
рынк: рынке
бэкап: бэкапов
неизвестн: неизвестно
современ: современные современную современном современного
помощ: помощью
выш: выше
востребова: востребованы
лог: логах
приложен: приложение приложений приложения
напряжен: напряжения
разработчик: разработчикам разработчиков разработчиком разработчика
секунд: секунд
вычислен: вычисления вычислений
введ: введ
дорожн: дорожного
киберпанк: киберпанк
настройк: настройка
опасн: опаснее
обнаруж: обнаружить
промышлен: промышленные
текст: текстов
инсталляц: инсталляции
сигнал: сигнале
документ: документы документов
метатег: метатегов
последовательн: последовательность
прочтен: прочтение
будущ: будущее будущие будущем
тепловизор: тепловизоры
ссылк: ссылку
крив: кривых
нуж: нужен
спокойн: спокойно
прочита: прочитать
нул: нулю нуля
ключ: ключ ключи
интерес: интерес
средств: средство
дан: данными данные данных данный
сравнен: сравнение
придумыва: придумывают
дат: дата
имен: именами
указа: указано
посторон: постороннем постороннего посторонних постороннему посторонний
раскрыт: раскрытия
закон: законное
неординарн: неординарный
плох: плохим
станет: станет
код: код кода
паттерн: паттернов паттернами
регистрац: регистрация регистрации
монтаж: монтажа
медицинск: медицинской
камен: камень
технологическ: технологический
коп: копии копия
ситуац: ситуацию
числен: численность
генератор: генератором
счита: считать
функц: функция функции
камер: камеру
отказа: отказались
пометк: пометки
цел: целое целей
отлича: отличается
звуч: звучит
доступн: доступнее
человечеств: человечества
звук: звук
кажд: каждую каждого
возника: возникает
увид: увидит
рядов: рядовых
регистр: регистрах
дзен: дзен
подключ: подключ
политик: политика
вмест: вместо
минимум: минимум
финансов: финансовой
кажут: кажутся
коммерческ: коммерческие
интеллектуальн: интеллектуальную
отличн: отлично
обнов: обновить
разработк: разработка разработки
закладк: закладки
налич: наличие
частност: частности
использова: использовать использовали
разработа: разработали разработаны
юзернейм: юзернеймы
логик: логику логики логика
перифер: периферия
трекинг: трекинге
желез: железо
установл: установлено
программн: программный
достаточн: достаточно
резервн: резервное резервные
сюд: сюда
гарантир: гарантирует
преимуществ: преимущества
список: список
знаком: знакомое
ввест: ввести
повыша: повышаются
след: следы следу следов
институт: институт
дек: дек
инспекц: инспекцию
вопрос: вопрос вопросам вопросы
организац: организации организация
ближайш: ближайшие
дизайн: дизайн
бесполезн: бесполезная
взлом: взлому взлом взлома
невозможн: невозможно
стремительн: стремительно
жит: жить
пошагов: пошагово
устройств: устройство устройств устройства
обфускац: обфускации
программируем: программируемый
текстов: текстовому
клиент: клиента
записыва: записывается записывают
ваш: вашему вашего
изучен: изучение
ответ: ответа
так: таким
нормальн: нормальную
нотаризац: нотаризация
полност: полностью
усил: усилия
недавн: недавней
нажат: нажатых нажатию нажатий
копирован: копирование
баз: базе
техническ: техническая технически
хран: храните
мощн: мощные
уда: удал
стойк: стойкой
алгоритм: алгоритмы алгоритмов
фев: фев
разниц: разница
расширен: расширения расширение
символ: символов
слыша: слышали
поднима: поднимается
мегапроект: мегапроекты
целостн: целостность
хабр: хабре хабр
передов: передовой
смен: смены
проника: проникают
пишут: пишут
снима: снимать
рутин: рутинная
обучен: обучения обучение
обсуд: обсудил
некотор: некоторые
предпочита: предпочитают
кук: куки
потенциальн: потенциально
куп: купить
обща: общаться
флешк: флешка
клавиатур: клавиатуры клавиатуру
количеств: количество
теплов: тепловому
соглашен: соглашение
логичн: логичными
добав: добавить
просмотр: просмотров
практик: практика
транспорт: транспорт
последн: последнее последние
друз: друзей
месяц: месяцев
сам: самое самый самых
сквозн: сквозное
сканирован: сканирования
друг: другом друг другим
стартап: стартапам
приход: приходу приходит
подключен: подключении
правильн: правильного
школьн: школьные
аппаратн: аппаратный
спорн: спорные
абсолютн: абсолютно
краж: кражи
посмотр: посмотрим
называ: называемые
вероятн: вероятно
менеджер: менеджеру менеджера менеджер
компан: компаний компании
рассказыва: рассказывали
программ: программе программы
электрическ: электрического
длин: длиной
коммуникац: коммуникаций
наслед: наследием
главн: главное главная
принят: принятие
распознаван: распознавания распознаванием
обеспечива: обеспечивают
созд: созда
век: века
жно: жной жное жно
предполага: предполагается
начина: начинает
стандарт: стандартом стандарты стандартов
рубеж: рубеж
видеосъ: видеосъ
формир: формируется
вер: верить
млрд: млрд
вс: вс
популярн: популярных популярное
прогноз: прогнозы прогнозам
мишен: мишень
област: областях
использ: используются
наблюдател: наблюдателю
научн: научно
созда: создана
веб: веб
программирован: программирование программирования
отдельн: отдельный
нача: начал
авг: авг
частот: частоты
специалист: специалистам
сохранен: сохранением
передач: передачи
станов: становятся становится
перспектив: перспективы
интернет: интернет интернете
необычн: необычный необычные
атак: атакам атак атаку атаки атака
хранен: хранения
прода: продаются
тег: теги
двухфакторн: двухфакторная
гц: гц
редактирован: редактирования
жны: жный
вещ: вещей
неудивительн: неудивительно
свод: сводя
тем: тема темы тему
основател: основатели
пришл: пришли
администрирован: администрирование
развит: развития
почтов: почтовый почтового
представ: представить
датировк: датировка
сайт: сайта сайтов сайт
периодическ: периодической
десят: десяти
знан: знания
контрол: контроля
др: др
научпоп: научпоп
привлека: привлекают
технолог: технологий
глазг: глазго
комментар: комментарии
файл: файла файлы
энтроп: энтропии энтропия
обществен: общественный
поставл: поставлен
проприетарн: проприетарные
сотрудник: сотрудники
различн: различные
нейросет: нейросетью нейросети
задан: заданий
компьютер: компьютеров компьютерах компьютеру компьютер
сертификат: сертификата сертификатов сертификатах сертификаты
работа: работает
сильн: сильно
проф: профили
песочниц: песочница
кубит: кубиты
бег: бег
десятилет: десятилетия
услуг: услуг услуги
подписчик: подписчики
телефон: телефон
треб: требуется
блог: блог
даркнет: даркнете
истор: история
числ: числе
гражда: граждан
зрен: зрения
лондон: лондон
цифр: цифры
скрипт: скрипт
шум: шума
модел: модель
доксинг: доксинга
ещ: ещ
спецсимвол: спецсимволы
автор: авторы авторов автором
сен: сен
чита: читать
легк: легко
вид: виду виде
сет: сетях сети сеть
конфиденциальн: конфиденциальность конфиденциальные
жд: жд
виде: видео
подход: подходят
защит: защита защитой защиты
наимен: наименее
экосистем: экосистемы экосистеме
рандомизац: рандомизации
температур: температуру
чуж: чужой
сесс: сессия
расписа: расписаться
вплот: вплоть
быстр: быстрого быстро
кибербезопасн: кибербезопасности
типичн: типичный
бизнес: бизнесе
наук: науки
прогресс: прогресса
хот: хотят
тип: типа
позволя: позволяют позволяет
характеристик: характеристика
бумаг: бумаги
эпох: эпоху
рейтинг: рейтинг
портативн: портативный
печа: печать
дом: дома
реч: речь
стандартизац: стандартизации
реш: решена
способн: способных способны
краегольн: краегольный
международн: международных международная
известн: известно известного известное
общ: общего общей
недостатк: недостатки
постав: поставить
сторон: стороны
кратн: кратной
поток: потоки
защища: защищать
поддержк: поддержка
специфическ: специфическом
контрмер: контрмеры
набор: набор
недел: неделю
поддержива: поддерживается поддерживать
претенз: претензий
хорош: хорошим
классификац: классификация
защищ: защищ
удобн: удобна
зашифрова: зашифрованными
подконтрольн: подконтрольна
социальн: социальные социальных
нахожден: нахождение
ис: исо
реферат: рефераты
пользовател: пользователя пользователей пользователям пользователем
просьб: просьбе
люб: любые любой
успешн: успешно
энергосет: энергосети
язык: языках языка
большинств: большинство
подрядчик: подрядчик
сил: силу
наз: назов
разрабатыва: разрабатывает
обязательн: обязательна
сервис: сервисах
эллиптическ: эллиптических
фактор: фактор
измерен: измерений
информац: информация информации
облачн: облачных
злоумышленник: злоумышленники
земл: земле
разн: разными разный разные разных
тных: тных
редакцион: редакционной
образц: образцом
документооборот: документообороте документооборота
удален: удаления
трат: трата
отсканирова: отсканировать
скрыт: скрытое
люд: людей
наград: награду
антивирус: антивируса
отвеча: отвечающая
противостоя: противостоять
год: годы
целев: целевом
предварительн: предварительных
трудност: трудности
конкретн: конкретное
открыва: открывает
парол: пароли паролей пароль пароля
физическ: физическая
мессенджер: мессенджеры мессенджерах мессенджеров
применен: применений
обработк: обработка
особ: особый
ходьб: ходьба
сериа: сериала
облак: облаках
вывод: выводу
закрыт: закрытой
прич: прич
запис: записи
подп: подпись
производств: производство
например: например
одн: одна одним одно
отправля: отправлять
согласн: согласно
реклам: реклама
прид: прид
вставк: вставки
вор: ворует
корпоративн: корпоративный
подобра: подобрать
рекомендац: рекомендации
бумажн: бумажная
нативн: нативные
одинаков: одинаково
звукозапис: звукозаписи
инструмент: инструменты инструмент
смоделирова: смоделировать
шифр: шифруют шифры шифров
ток: тока
команд: команды
маскировк: маскировки
насчитыва: насчитывается
сообществ: сообщества
референсн: референсной
подня: поднялась
таков: таковым
мощност: мощности
врод: вроде
уникальн: уникальный
электрон: электронного
участ: участие
атрибут: атрибут
январ: января
использован: использование использования использованием
уровн: уровне
криминалистик: криминалистика
запрос: запросу
поскольк: поскольку
включа: включает
консол: консоль
сист: систему
сентябр: сентябре
япон: япония
войт: войти
аккаунт: аккаунтов аккаунт аккаунты
подпис: подписи подписью
дета: детали
сраз: сразу
наскольк: насколько
производ: производит производить
смартфон: смартфоне смартфоном
проблем: проблема
но: ноя
сервер: серверу сервер сервере сервера
раздел: разделы
исследовател: исследователи
ны: ные
яндекс: яндекс
университет: университета
новост: новости
лучш: лучшие
существ: существуют
чувствительн: чувствительных
перв: первая первых первым
желательн: желательно
перехват: перехвата перехватить
госучрежден: госучреждения
сейф: сейфе
написа: написанное
поиск: поиск
возможн: возможности
интересн: интересное интересный
форум: форуме
запомн: запомнить
взлома: взломали
открыт: открытом открытые
вымогател: вымогатели
проникновен: проникновения проникновение
файлохостинг: файлохостингах
образовательн: образовательные
как: какие
определ: определить
пиксел: пикселя
голос: голосов
страниц: странице
гул: гулу
пк: пк
повлия: повлиять
тся: тся
взгляд: взгляд
выпуск: выпуска
прошл: прошлом
реальн: реально
гаджет: гаджеты
лома: ломает
произвольн: произвольный
точн: точную точно
изображен: изображений
точк: точки
сфер: сфере
улучша: улучшает
любительск: любительском
преимуществен: преимущественно
стандартн: стандартные стандартный
откр: открыть
способ: способов способ способы
июл: июле
мер: мерах мере
криптографическ: криптографической
браузер: браузер браузере браузера браузеров браузеры браузерах
легитимн: легитимного
улучшен: улучшенной
компьютерн: компьютерную компьютерное
кнопк: кнопки
дифф: диффи
никак: никаких
источник: источника источник
рекоменд: рекомендуется
sourc: source
captur: capture
usb: usb
csv: csv
project: project
forb: forbes
program: program
iot: iot
robot: robot
twitter: twitter
pluggabl: pluggable
frost: frost
rubber: rubber
html: html
chrome: chrome
io: ios
develop: developer
javascript: javascript
amazon: amazon
sullivan: sullivan
maco: macos
vk: vk
habr: habr
thermosecur: thermosecure
fa: fa
globalsign: globalsign
gmail: gmail
rsa: rsa
postscript: postscript
appl: apple
admin: admin
global: global
youtub: youtube
rss: rss
ransomwar: ransomware
award: award
leadership: leadership
njvc: njvc
enf: enf
chatgpt: chatgpt
email: email
fhe: fhe
ducki: ducky
facebook: facebook
match: matching
telegram: telegram
transport: transports
competit: competitive
strategi: strategy
nist: nist
target: target
pdf: pdf
googl: google
tl: tls
open: open
