шляп: шляпу
говор: говорят
консольн: консольным
фактическ: фактическим
расскаж: расскажу
рассказ: рассказ
назов: назову
стат: стать статью статье статьи статья
сравн: сравню
стар: старую
катк: катками
стал: стало
мнен: мнение
став: ставит
реализова: реализован реализовать
работ: работу работы работе
завис: зависит
показыва: показывать
дополнительн: дополнительную дополнительные
функтор: функторы функтор функтора
инфраструктур: инфраструктуры
пол: пол полей поле
размеща: размещаем размещаются
финальн: финальный
менеджмент: менеджмент
мобильн: мобильных
должн: должна
знакомств: знакомство
структур: структуры
суд: судить
публикац: публикации
скопирова: скопировать
карт: карты
балл: баллах
превознос: превозносят
назван: название
благодар: благодаря
взаимосвяза: взаимосвязанными
котор: которое котором
скучн: скучного
времен: временной
эксперимент: эксперименте
шаг: шагом шаг
связа: связанные связана
обратн: обратной
манифест: манифестам манифестов манифесты манифестами манифеста
проверя: проверяющей
отмет: отметить
либ: либо
проект: проекты проектов проекте
связ: связь связи
вперв: впервые
строков: строковых
оторва: оторвать
зад: зада
профил: профиль
дела: делать
приветств: приветствую
змейк: змейка
читальн: читальный
верс: версии версий версию
рекурсивн: рекурсивное
маркетинг: маркетинг
книг: книги
разобра: разобраться
прост: простое простая простого простым простой
просн: просн
позвол: позволила
анекдот: анекдот
зал: зал
сосед: соседа
рушат: рушатся
проверк: проверки
занима: занимающегося
эксплуатац: эксплуатации
уровен: уровень
нов: новые новую
придума: придумаем
медийн: медийная
част: часть части
пораньш: пораньше
динамическ: динамический
литератур: литература
постоя: постоянного
системн: системное
сдела: сделать
маятник: маятник
особен: особенности
сложн: сложный
уточнен: уточнения
ориентац: ориентацией
капот: капотом
примен: применить
пут: путь пут путем
пример: примерами примеры примере
природ: природу
алгоритмическ: алгоритмический
систем: системы
инициирован: инициированием
упрощен: упрощенной
класс: классы классов
рефакторинг: рефакторинг
узна: узнал
поверхн: поверхности
закреп: закрепить
изобрел: изобрели
курс: курсов
облада: обладал
ресурс: ресурсов ресурса ресурсы
процесс: процессе
восхищ: восхищены
шел: шел
свойств: свойства
требован: требования
постепен: постепенно
написан: написания
хотел: хотелось хотел
размест: разместить
культур: культуре
комфортн: комфортной
номер: номер
подряд: подряд
бесплатн: бесплатно
помощ: помощью помощи
современ: современных современном
кредитн: кредитной
заморачив: заморачиваясь
приложен: приложение приложения приложениях приложений
командн: командной
секунд: секунд
попытк: попытки
вклад: вклад
кроват: кровати
робототехник: робототехники
корректн: корректность
выстроен: выстроенных
наоборот: наоборот
навык: навыки
фильтр: фильтров
нул: нуля
жног: жного
экшн: экшн
интерес: интерес интересующей
трубн: трубно
программист: программист программисты программисту программистам программистами
охват: охват
закон: законов законы
плох: плохо
зарегистрирова: зарегистрировавшись
помогл: помогли
прикол: приколу
регистрац: регистрация
издательск: издательский
имеет: имеет
каза: казалось
счита: считанные
отсутств: отсутствия
причин: причина
различ: различии
упрост: упростить
предусмотрен: предусмотренные
воплоща: воплощается
цел: целом целью
бунин: бунина
кажд: каждого каждой
дзен: дзен
подкачива: подкачивает
создава: создаваемое
отличн: отличным
всяк: всяк всякого
донастройк: донастройка
частност: частности
использова: использоваться использовалась
прекрасн: прекрасного
логик: логику
значим: значимостью
повседневн: повседневной
достаточн: достаточно
сюд: сюда
список: список
протокольн: протокольно
отраз: отразилось
строг: строго
прошедш: прошедшие
след: следующее
строк: строки
дизайн: дизайн
концепц: концепции
сконструирова: сконструирован
поясня: поясняется
попыта: попытаемся
так: такого таком
аннотац: аннотация
событ: событий
сниз: снизить
баз: базе
техническ: техническая
условн: условно
мощн: мощным
фев: фев
назва: назвать назвал
заметк: заметке
внест: внести
тумбочк: тумбочку
некотор: некоторые некоторого
предпочита: предпочитаете
рассмотр: рассмотрим
потенциальн: потенциальный
подума: подумать
количеств: количество
чистот: чистоты
соглашен: соглашение
диалог: диалог
попа: попали
добав: добавить
просмотр: просмотров
специальн: специальное
зна: знаю
конфигурац: конфигурация конфигураций
объем: объемами
представля: представляет
исслед: исследует
питер: питер
приход: приходится приходилось
поня: понять
реактивн: реактивности реактивного реактивную
кластер: кластере
компан: компаний компании
рассказыва: рассказываю
программ: программ программы
ограничен: ограничения
получа: получаем
действ: действия
разбира: разбираю
фундаментальн: фундаментальный
предъяв: предъявить
обеспечива: обеспечивающих
страда: страдал
состоян: состоянием состояние состояния
поможет: поможет
зайд: зайдя
стака: стакана
рад: рад
использ: используется использует используются
имеют: имеются
магазин: магазин
созда: создать
объясня: объясняется
ран: ранних ранее
помн: помните
отдельн: отдельно
стол: столь
передач: передача
интернет: интернета интернете
осознан: осознания
тем: тема
применя: применяются применять
полн: полный
администрирован: администрирование
знат: знать
легковесн: легковесного
определя: определяет
бел: белый
знан: знаниями
знал: знал
комментар: комментарии
некомпетентн: некомпетентные
рамк: рамках
прош: прошу
работа: работают работать работал работающее работает работающий
сильн: сильнее сильно
контраст: контрасте
песочниц: песочницы песочница
услуг: услуги
квазицитирован: квазицитирования квазицитирование
доработа: доработан
преподаван: преподавания
блог: блог
интерьер: интерьере
фреймворк: фреймворк фреймворка фреймворков
прод: прод
модификац: модификацией
интерфейс: интерфейс интерфейсом
адепт: адепты
прореагирова: прореагировал
чист: чистой
наследован: наследование
сложност: сложности
пойт: пойти
видн: виднее
автор: авторы автору автор автором авторов автора
пойм: пойм поймем
чита: читать
завезут: завезут
виде: видео
локальн: локальной
подход: подходах подход
пойд: пойдем
разбир: разбираясь
наимен: наименее
тестирован: тестирование
минувш: минувший
принима: принимал
тип: типа типов
предмет: предметы
реш: решил решить решиться решили
многолетн: многолетних
олег: олега
зада: задаться
набор: набор
поддержива: поддерживаются
включ: включая
изобретен: изобретение
одностраничн: одностраничное
профессиональн: профессиональная
срез: срез
слыш: слышишь
может: можете
мног: многими многих
люб: любой
зависим: зависимостей
тки: тки
язык: языков языка языки языку языках языком
согласова: согласованных
захочет: захочет
несложн: несложной
обязательн: обязательно
содержа: содержащие
гол: голого
взаимосвяз: взаимосвязь взаимосвязей
люд: людей
центричн: центричной
разв: разв
удовольств: удовольствия
год: годы
использу: используя используем
создан: создания создании создание
особ: особого особо
рассужда: рассуждать
храня: хранящихся
прич: прич
сахар: сахара
привод: приводит приводятся
постара: постараемся
одн: одно одним
широк: широко
реклам: реклама
онтик: онтико
разбер: разберем
настольк: настолько
корпоративн: корпоративный
функциона: функционала
синтаксическ: синтаксического
шаблон: шаблонного шаблонов шаблон
инструмент: инструмент инструментов
нехитр: нехитрое
доклад: доклада
команд: команды
склон: склонны
сообществ: сообществом
врод: вроде
атрибут: атрибутом
удивлен: удивление
глас: гласит
использован: использования использованием использовании
голосован: голосования
платформ: платформах
запрос: запросы запросами
войт: войти
аккаунт: аккаунт
глаз: глаз
генерируем: генерируемых
протокол: протоколы
конструирован: конструирования конструирование
порядк: порядку порядка
декларативн: декларативном
репозитор: репозитории
излага: излагается
рекурс: рекурсия рекурсии
сект: секту
бот: бот бота ботов
похож: похожую
жела: желающим
вполн: вполне
продума: продумана
яндекс: яндекс
новост: новости
перв: первую первой первым первое первого первом
возрастн: возрастном
написа: написать написал написана
поиск: поиск
возраста: возрастает
преодолет: преодолеть
основ: основа основе основы
образовательн: образовательные
как: какую каком какие
голос: голосов
тся: тся
прошл: прошло
скептическ: скептически
реальн: реального реальной реальными
втор: вторую
точн: точнее
рол: роль
способ: способ способом
мер: мере
конференц: конференции
готов: готовых
образ: образом
учет: учетом
окт: окт
электроник: электроника
появ: появилось
случа: случае случай
прелест: прелестей
рейс: рейсами рейсах
вернут: вернуться
парадигм: парадигму
бесконечн: бесконечная
янв: янв
вообщ: вообще
и: ии
единствен: единственным
ошибок: ошибок
дава: давайте
показа: показать показал показано
поэт: поэтому
модификатор: модификаторах
несовершенств: несовершенство
мин: мин
памят: памятью
мир: мир
писа: писать
идеальн: идеальной
совершен: совершенный
безопасн: безопасную
этап: этапах
скор: скорее
бекенд: бекенд
получ: получил получить
ясност: ясности
синхронизац: синхронизации
перевод: перевод
качнул: качнулся
час: час
чат: чат чата чате
столкнул: столкнулся
подписк: подписки
софт: софта
больш: большими
иде: идея
счет: счет
игр: игру игр игры
полезн: полезно
миниатюрн: миниатюрными
существен: существенные существенно
эффективн: эффективно эффективны
мерф: мерфи
видет: видеть
грязн: грязнов
доставля: доставляли
исправлен: исправлений
осн: основ
генерац: генерации генерация
видел: видел
ост: оста
жизн: жизни
мог: могу
грокнув: грокнув
технотекст: технотекст
затрон: затронем
момент: момент момента
обсужден: обсуждении
принципиальн: принципиально
вышл: вышло
завезл: завезли
математик: математика математику математикой
неплох: неплохо
основа: основанные основан
скрыва: скрывает
психологическ: психологический
решен: решений решение решения решением
удив: удивитесь
средн: средний
личн: личному
нужн: нужным нужны
отч: отчего
хаб: хабы
описан: описания
вылож: выложил
позиционирова: позиционировались
бенчмарк: бенчмарками бенчмарки
любл: люблю
результат: результат результаты
вызыва: вызывает
опыт: опыту опыте
дав: давая
продвинут: продвинутыми
экскурс: экскурс
павел: павел
настройк: настройка
дал: далее
пониман: понимание
документ: документы
прочтен: прочтение
предложен: предложенное
ссылк: ссылку
сортирова: сортировать
восприят: восприятия
фрейморк: фрейморка
дан: данных данные данной данный
болта: болтают
прицел: прицелом
имен: именем
код: код кода коде
паттерн: паттерн паттерна
прочувству: прочувствуем
кон: кон
кот: котами кот котов
соединен: соединения соединение
генератор: генераторах генераторы
формирован: формирования
функц: функция функцию функций функции функцией
внесен: внесения
брат: брат
используем: используемая
суперсовремен: суперсовременный
предлож: предложен предложил
валидац: валидации валидацию
оболочк: оболочки
монад: монады
кодер: кодеры
синтаксис: синтаксис
увидел: увидел
обнов: обновить
императивн: императивных императивные императивной
объект: объектов объектам объект объектами
разработк: разработкой разработке разработках разработка разработки
закладк: закладки
важ: важен
разработа: разработанный
жил: жили
муч: мучился
программн: программных программного
заблужден: заблуждения
преимуществ: преимуществ преимущества
пост: посте пост
ориентирова: ориентированные ориентированное ориентированным
произошл: произошло
минут: минуты минут
дек: дек
дел: дело делили
вопрос: вопросом вопрос
сохраня: сохраняется
игра: играть
устройств: устройство
переход: переходить
изучен: изучению изучения
попрактикова: попрактиковаться
ответ: ответом
генерир: генерирующих
полност: полностью
дженерик: дженериках дженерики дженериков
проектирован: проектирование
срок: срок
собствен: собственно
идеал: идеалу
измен: изменило
существован: существовании
алгоритм: алгоритмы
расширен: расширении
тривиальн: тривиальное
слыша: слышать
мегапроект: мегапроекты
хабр: хабре хабр
компетентн: компетентный
ртыван: ртывание ртыванием ртывания
аэропорт: аэропортами аэропортах
посмотрет: посмотреть
практик: практика
последн: последний
месяц: месяц
сам: самые самых
манипулирова: манипулировать
стартап: стартапам
туториа: туториал
возвраща: возвращать
посмотр: посмотрим
управлен: управление управления
предназначен: предназначенного
мейоз: мейоз
видеоформат: видеоформате
представл: представлен
смысл: смысла
век: век
начина: начинаю начинающих начинать
стандарт: стандартом
очередн: очередной
популярн: популярной популярного
вс: вс
неинтересн: неинтересный
начн: начн
барьер: барьер
сво: сво свой
веб: веб
программирован: программированию программирование программировании программирования программированием
нача: начать начал
прокачива: прокачивайте
реша: решает решают
порог: порог
просто: простоя
реализ: реализуют
лежа: лежало
делегирован: делегирование
хранен: хранения
полуреш: полуреш
явля: является являются
сигнатур: сигнатуру
вещ: вещь вещах
спроектирова: спроектирована
законч: закончим
теря: терял
де: де
представ: представила
сайт: сайте сайта сайтов
непонят: непонятен
обеспечен: обеспечения
научпоп: научпоп
технолог: технология технологии
продолж: продолжим
задач: задачи задач
развив: развивая
трех: трех
различн: различные различных
смотря: смотрящий
конструктивн: конструктивной
пар: пару пара
базов: базовыми
треб: требует
истор: историю истории история
зовут: зовут
мышлен: мышление
двум: двумя
неопытн: неопытности
аппликативн: аппликативный аппликативные аппликативного
пробл: проблему проблем
факт: факто
ещ: ещ
произошел: произошел
легк: легко
сет: сети сетями
иррационал: иррационален
конфиденциальн: конфиденциальность
теор: теории
науч: научила
разумн: разумно
нескольк: нескольких
вышеперечислен: вышеперечисленных
повтор: повторить
стрем: стремившиеся
хот: хотите
позволя: позволяют
платн: платной
хоч: хочу
рейтинг: рейтинг рейтинга
дом: дом дома
способн: способны
известн: известный
дот: доты
сторон: стороны
поток: поток потоки
пута: путаться
поддержк: поддержки поддержка
остальн: остальной
дня: дня
доб: добиться
принцип: принципе
хорош: хороший
библиотек: библиотекой библиотек библиотеке
пуст: пустой
ид: идей
опира: опирался
предыдущ: предыдущем
ин: иной
наш: наших
улучш: улучшить
кика: кикать
пользовател: пользователей
стэнфордск: стэнфордских
объектн: объектно
компонент: компонентов
умн: умные
сил: силу
син: синий
шарик: шарика
план: планы
сервис: сервис
оперативн: оперативно
тройк: тройка
информац: информацию информация информации
восторг: восторге
обрета: обретают
выгляд: выглядит
анализ: анализ
математическ: математические математическую
объедин: объединить
ко: ко
поговор: поговорим
грока: грокаем
порожда: порождает
например: например
подготовк: подготовку
коллег: коллеги
перепробова: перепробовал
орланд: орланд
понятн: понятным
соответств: соответствующее
нативн: нативные
познаком: познакомился
рассмотрел: рассмотрели
отлич: отличия
мо: моем моему
осваива: осваивать
сист: систем
прокача: прокачать
пригод: пригодится
пит: пить
пиш: пишу пишем
но: ноя
планк: планку
сервер: сервера
раздел: разделы
автоматическ: автоматически
выражен: выраженной
исследовател: исследователями
транслируем: транслируемые
унифицирова: унифицированно
лучш: лучшие лучших
механизм: механизм
управля: управлять
небольш: небольшой
дума: думать
формат: формате
относ: относиться
корн: корни
крайн: крайней
возможн: возможности возможность возможно
оп: опыт
интересн: интересным
ленив: ленивые ленивый
буквальн: буквально
дает: дает
хочет: хочет
гляд: глядя
функциональн: функционально функционального функциональное функциональном функциональному функциональность
сконфигурирова: сконфигурированных
крут: крутая
авиакомпан: авиакомпаниями авиакомпаниях
взгляд: взгляд
провозглаша: провозглашают
адресова: адресована
изначальн: изначально
архитектур: архитектуры
потоков: потоковая
преимуществен: преимущественно
откр: открыли открыть
двунаправлен: двунаправленная
наход: находится
никак: никакого
термин: терминах
каков: каковы
sourc: source
css: css
extens: extension
devop: devops
argocd: argocd
vkni: vkni
program: programming
helm: helm
coredataswiftuiflight: coredataswiftuiflights
telebot: telebot
twitter: twitter
java: java
mvvm: mvvm
identifi: identifiable
statefulset: statefulset
api: api
fetchrequest: fetchrequest
psyhast: psyhaste
python: python
github: github
io: ios
manag: manager
grpc: grpc
javascript: javascript
junior: junior
airport: airports
maco: macos
augh: aughing
vitter: vitter
habr: habr
travers: traversable
object: objective
flight: flights
pod: pod
appl: apple
evron: evrone
patientzero: patientzero
js: js
secret: secret
youtub: youtube
result: result
rss: rss
jsonnet: jsonnet
kustom: kustomize
stream: stream streaming
enrout: enroute
packag: package
uikit: uikit
barbalion: barbalion
cvv: cvv
facebook: facebook
wwdc: wwdc
flightawar: flightaware
cs: cs
sale: sales
hakain: hakain
tl: tl
iokasimov: iokasimov
kati: katie
haskel: haskell
scalafx: scalafx
fierc: fierce
open: open
garbag: garbage
df: df
sivchenko: sivchenko
data: data
airlin: airlines
gotcha: gotcha
wildgreyplu: wildgreyplus
poll: polling
do: dos
dr: dr
deploy: deployment
swiftui: swiftui
view: views
samsergei: samsergey
ui: ui
commun: community
html: html
yaml: yaml
swift: swift
grbit: grbit
viewmodel: viewmodels
spa: spa
lisp: lisp
xcode: xcode
translat: translate
observableobject: observableobject
core: core
servic: service
bidirect: bidirectional
mosx: mosx
vk: vk
pycharm: pycharm
swftui: swftui
primetalk: primetalk
scala: scala
bot: bot
android: android
quasiquot: quasiquotation
kubernet: kubernetes
collector: collector
rust: rust
git: git
piter: piter
appli: apply
megamufa: megamufa
json: json
class: class
custom: customization
telegram: telegram
xd: xd
creditcard: creditcard
gitop: gitops
kalipsomoon: kalipsomoon
appkit: appkit
django: django
vadimr: vadimr
ph: ph
amarao: amarao
