замедля: замедляющих
оценк: оценки
говор: говорят
понима: понимать
остатк: остатков
стат: стать статьи статей статья
воен: военные
стар: старое старую
рабоч: рабочие
стал: стало
объясн: объяснить
последств: последствий
работ: работы
завис: зависит
центр: центрами центры
показыва: показывать
мероприят: мероприятии
сч: сч
терминал: терминалов
получен: получения
инфраструктур: инфраструктура
сто: стоит
человек: человека
ти: ти
специализирова: специализированных
менеджмент: менеджмент
неспособн: неспособны
лазер: лазеры
каса: касается
шнурк: шнурки
производим: производимой
регулир: регулирующих
публикац: публикации публикация
скопирова: скопировать
гигантск: гигантские
попрост: попросту
благодар: благодаря
деля: делящихся
котор: которое
цивилизац: цивилизации
времен: временно
изго: изгоями
автомобилист: автомобилистов
моделирован: моделирования
эксперимент: эксперименты
связа: связанные
природн: природных
проект: проекты проектов
ирланд: ирландии
вперв: впервые
высыпа: высыпать
обита: обитаемых
профил: профиль
пауэрбанк: пауэрбанк
часов: часового
документац: документацией
верн: верн
верс: версии версию
подводн: подводные
шкал: шкале
маркетинг: маркетинг
нейтрон: нейтронах
шкаф: шкаф
прост: простой простые прост
нно: нное
разрознен: разрозненными
позвол: позволяя
справ: справиться
занима: заниматься
ложн: ложных
уровен: уровень
очевидн: очевидные
нов: новый новую новые новых новая
медийн: медийная
част: часть частая
сокрыт: сокрытые
цифров: цифровой
подвест: подвести
слов: слова слово
пригодн: пригодные
завод: завода завод
сопернича: соперничает
наворот: наворотов
надоел: надоели
допущен: допущение
посчита: посчитали
нны: нные
сдела: сделать сделай сделаем
определен: определения
особен: особенностям
гигаваттн: гигаваттной гигаваттный
сложн: сложный сложнее
калининградск: калининградской
выставк: выставке выставка
прогнозир: прогнозируют
любител: любителям
камн: камнями
вблиз: вблизи
примен: применить
пут: пути
зарядок: зарядок
пример: примере
лодк: лодки
подключа: подключаются
хранилищ: хранилища
систем: системах системы
строительств: строительство
выж: выжить
провайдер: провайдер провайдера
текущ: текущая
читател: читателей читателям
процесс: процессы
простеньк: простенькие
групп: группами
астрофизик: астрофизики
приведен: приведенная
выпуска: выпускать
окружа: окружающие
мкост: мкость мкости
постепен: постепенно
солнечн: солнечный солнечная солнечные солнечных солнечной
нных: нных
размест: разместить
актуальн: актуально
продолжа: продолжаются продолжаем
электростанц: электростанций электростанция
подряд: подряд
бесплатн: бесплатных
современ: современных современной
помощ: помощью
зды: зды
неко: некоего
напряжен: напряжения
климат: климата
опасн: опасно
вклад: вклад
промышлен: промышленного
разряжен: разряженном
будущ: будущее будущему
универсальн: универсальных
желан: желанны
выделен: выделением
потребительск: потребительской
гравитацион: гравитационные
интерес: интерес
агрессивн: агрессивной
средств: средств
пожал: пожалейте
широкодоступн: широкодоступных
картинк: картинка
протяжен: протяжении
остаточн: остаточную
ампер: ампер
росс: россии
регистрац: регистрация
толк: толку
моделир: моделирует
туман: туманность
автомобил: автомобилей
убед: убедиться
ситуац: ситуация
счита: считают
причин: причинах
отлича: отличается
повышайк: повышайками повышайкам
изуча: изучать изучали
человечеств: человечества
российск: российской
катаклизм: катаклизма
дзен: дзен
эр: эру эра
множеств: множество
новорожден: новорожденные
искусствен: искусственный
завершен: завершению
частност: частности
использова: использовать использовал
металлогидридн: металлогидридных
растут: растут
желез: железо
значим: значимое
достаточн: достаточно
примерн: примерно
установк: установки
сюд: сюда
список: список
ядерн: ядерных ядерного ядерный ядерной
энерг: энергию энергия энергии энергиями
след: следующий следите
дизайн: дизайна дизайн
заряд: заряда
льшу: льшую
помим: помимо
гвт: гвт
подвезт: подвезти
металлическ: металлическое
аэс: аэс
светов: световых
так: такими такого таком таких
удосто: удостоены
недавн: недавнего
событ: событие события
видеоблог: видеоблоги
техническ: техническая
хран: хранить
мощн: мощный
наполн: наполнить
фев: фев
контролируем: контролируемой
подошл: подошли
собира: собирают
величин: величин
аналитик: аналитика
получш: получше
некотор: некоторые
рассмотр: рассмотрим
потенциальн: потенциально
аккумулятор: аккумуляторы аккумуляторами аккумуляторов
количеств: количество
соглашен: соглашение
увлека: увлекаюсь
шнур: шнура
добав: добавить
просмотр: просмотров
специальн: специально специальной
транспорт: транспорта транспорт
друз: друзья
конфигурац: конфигурация конфигурации
услов: условиях условия
пластин: пластин пластины
интеллект: интеллект
представля: представляю
синтез: синтеза
стро: строят
друг: друг
автомобильн: автомобильные
кабел: кабели кабелях
приход: приходит
роутер: роутера роутер роутером
наступ: наступил
шахтерск: шахтерских
компан: компаний компании
степен: степень
ограничен: ограничения ограничений
программ: программы
коммуникац: коммуникация коммуникации
получа: получаете
обеспечива: обеспечивающего
пят: пяти
велик: великую
низк: низкой
элемент: элементов элементы элементами
рац: раций
массив: массиве
привет: привет
состоян: состоянии
бесперебойн: бесперебойного бесперебойное
стоя: стоящую стоял
отдел: отделена
дайджест: дайджест
рад: рад
использ: используется
созда: создать
ран: ранее
отдельн: отдельное
стол: столь
гик: гиков
сохранен: сохранение
передач: передачу
конструкц: конструкций конструкция
интернет: интернету интернет интернета
предоставля: предоставляет
необычн: необычные
цод: цод цодов
реализац: реализации
уменьшен: уменьшения
тем: тема тему теме
привычн: привычных
астроном: астрономов астрономам астрономия астрономии
администрирован: администрирование
питан: питание питания
знан: знаний
комментар: комментарии
проприетарн: проприетарными проприетарным
физик: физика физик
проч: прочие
работа: работают работающих работать работает
самосва: самосвал
аналогов: аналоговый аналоговую
песочниц: песочница
долж: должен
останавлива: останавливаться
блок: блоки
высокопробн: высокопробное
десятилет: десятилетия
услуг: услуги
несоответств: несоответствующие
кандидат: кандидат
телефон: телефонных
блог: блог
биолог: биолог
числ: числа числе
тяжеловодн: тяжеловодных
интерфейс: интерфейсы
модел: модель
исследова: исследовать
сложност: сложности
параметр: параметров
вниман: вниманию
девайс: девайсов девайсы девайса
автор: авторы автор автором авторов
здну: здную
реакц: реакции
чита: читать
прогремел: прогремело
отдач: отдачу
локальн: локальные
обстановк: обстановке
легководн: легководных
температур: температуры температуре
кремниев: кремниевых кремниевые
цепн: цепной
оста: осталось остались
быстр: быстрых быстрой
бизнес: бизнес
предмет: предметов
воспринима: воспринимаю
межзв: межзв
альтернативн: альтернативные альтернативной
отрасл: отрасли отрасль
реш: решил решить
лаборатор: лабораториях лаборатории
бин: бин
общ: общих
зада: задал
недел: недели
поддержива: поддерживают
электроэнерг: электроэнергией
снабжен: снабжения снабжением
профессиональн: профессиональных
азиатск: азиатских азиатского
тысячелетн: тысячелетней
сред: среды
лайфхак: лайфхаки
распад: распад распада
мног: многие
разнообразн: разнообразные
нулев: нулевого
ядр: ядра
люб: любой любят
снят: сняты
язык: языком языка
крупномасштабн: крупномасштабные
содержа: содержащем содержащими
сгоран: сгорания
разъ: разъ
чердак: чердаке
энергопотреблен: энергопотребление
топливн: топливных топливными
правд: правда
кших: кших
разн: разных
образц: образцы
планет: планету планета
прорыв: прорыве
отправн: отправную
люд: людям людей
наград: наград
низкообогащ: низкообогащ
крохотн: крохотные
делен: деления
производител: производители производителей
использу: используя
нюанс: нюансы нюансами
гравитац: гравитация
потребля: потреблять потребляющий потребляют
неизбежн: неизбежно
встроен: встроенным
создан: создания создание
рассужда: рассуждать
неограничен: неограниченной неограниченности неограниченный
рассея: рассеяло
прикинут: прикинуть
производств: производство производства производству
знает: знаете
перспективн: перспективным
телескоп: телескопами
волн: волн
одн: одному одним одними одна
мал: малые
мам: мам мами
реклам: реклама
разбер: разбер
настольк: настолько
корпоративн: корпоративный
мохаммед: мохаммеда
пода: подать
эколог: экология
ток: тока током
команд: команду
массивн: массивных
таблеток: таблеток
корабл: корабли
использован: использование использования использованием
горазд: гораздо
испытан: испытания
войт: войти
конечн: конечный конечном конечного
аккаунт: аккаунт
состав: составило
испар: испарится
деятельн: деятельности
счаст: счастью
протокол: протокола
сраз: сразу
возобновля: возобновляемые возобновляемой
подержа: подержать
рецепт: рецепты
похож: похожая
яндекс: яндекс
новост: новости
существ: существуют
перв: первой первое
непрост: непростая
близк: близкого
добр: доброй
написа: написано
поиск: поиск
изменен: изменения
энергетик: энергетики энергетикой
планир: планируется
привыкл: привыкли
уранов: урановой урановое
преобразовател: преобразователи
образовательн: образовательные
как: какие
определ: определ
голос: голосов
топлив: топливе топливом топливо топлива
рассматрива: рассматриваются рассматривал
днях: днях
высок: высокими высокий
реальн: реальной реально
гаджет: гаджеты
рол: роль
окл: окло
точк: точку точки
зондирова: зондировать
сфер: сфер сфере
способ: способов способами способы
избав: избавиться
компьютерн: компьютерное
термина: терминал терминала
найт: найти
провер: проверим
энергетическ: энергетическая
лампочк: лампочка
независим: независимость независимых
заверша: завершается
конц: конце
дорог: дорогие
найд: найдены
предлага: предлагаю
обзор: обзора обзор
электроник: электроники электроника электронику
случа: случае
появ: появиться
наподоб: наподобие
практическ: практически
доступ: доступа
вернут: вернуться
прожорлив: прожорливых
достигнет: достигнет
мил: мили
послед: последующие
янв: янв
свалк: свалках
единствен: единственное
вольт: вольтам вольт
пита: питать
потреблен: потребление
дава: давайте
х: х
ч: ч
поэт: поэтому
звезд: звезды
ничт: ничто
мин: мин мини
вариант: вариант
мир: миру
предприят: предприятии
миф: мифы
исследован: исследований исследованиях исследования
перестаньт: перестаньте
модн: модного
воспроизвод: воспроизводить
вложен: вложенных
перевод: перевод
руд: руды
экономическ: экономически
рук: руках руками
час: час часа
ежегодн: ежегодно
внутр: внутри
шанс: шанс
балльн: балльной
измеря: измерять
позиц: позиции
могл: могли
больш: больших большим большой большую большего
мест: место места мест
предполож: предположив
длительн: длительных
вход: входит
аналогичн: аналогичные
сверхнов: сверхновые
подталкив: подталкивая
эффективн: эффективным
прозондирова: прозондировать
испытыва: испытывать
оперир: оперирующие
реализуем: реализуемым
вздрагива: вздрагиваю
жизн: жизни
питон: питон питоне
мов: мов
развива: развиваться
бренд: брендов
необязательн: необязательно
инвертор: инвертору
категор: категорий
пойма: пойманных
решен: решений решением решения
средн: средний
удачн: удачных
хаб: хабы
гэс: гэс
нужд: нужды
результат: результаты
вызыва: вызывающим
опросник: опросник
настройк: настройка
дал: далее дал
астрон: астроном
воссоздан: воссоздания
враща: вращающейся
пониман: понимание
документ: документы
прочтен: прочтение
аккумуляторн: аккумуляторных
ссылк: ссылку
рациональн: рационального
ключ: ключ
дан: данных данные данной дании
минибизнес: минибизнеса
дат: дата
взрыва: взрывать
модул: модули
снабжа: снабжают
технологическ: технологические технологическое
кругл: круглым
электроэнергетик: электроэнергетики электроэнергетике
пустот: пустоту
вегас: вегасе
мся: мся
построен: построенной
порассужда: порассуждать
доступн: доступные доступных
шахт: шахтах шахты шахт
заран: заранее
номинац: номинаций
возника: возникающей
оцен: оценены оценил
малоизвестн: малоизвестный
перебо: перебоях
подключ: подключить
глобальн: глобального
рассчита: рассчитана
минимум: минимум
разбор: разбору
позабот: позаботиться
достич: достичь
обнов: обновить
объект: объектов объекты объектам
разработк: разработка
закладк: закладки
незаменим: незаменимым
обогащен: обогащения
жил: жила жилья
загружа: загружаемых
начал: начале
продолжен: продолжение
экспертн: экспертной
горел: горела
лабораторн: лабораторных лабораторные
заброшен: заброшенных заброшенные
резервн: резервная резервную
корпус: корпуса
таинствен: таинственным
итог: итоги
обеспеч: обеспечить
дел: делая деле
вопрос: вопросов
жит: жить
мактум: мактума
устройств: устройство устройствам устройств устройства
вскор: вскоре
переход: переходу
двигател: двигателя двигатель
жаждущ: жаждущий
ваш: вашего вашему
проход: проходит
ответ: ответ ответов
изучен: изучения
экзопланет: экзопланеты экзопланет
полност: полностью
собствен: собственные собственными собственного
измер: измерил
станц: станции станцию
публику: публикуем
экономичн: экономичным
мегапроект: мегапроекты
хабр: хабр
смен: смену
изрядн: изрядно
отношен: отношении
гнезд: гнездо
куп: купить
механическ: механические
ал: аль
посмотрет: посмотреть
саг: сагой
последн: последней последних последние
месяц: месяц
приказа: приказала
сам: самых самые
геолог: геолог
стартап: стартапов стартапам стартапа
туториа: туториал
дик: дико
инач: иначе
нацелен: нацеленной
подключен: подключения
организова: организовать
потребител: потребитель потребителей
бо: бо
пробежа: пробежаться
высокотемпературн: высокотемпературных
предназначен: предназначенные
неожида: неожиданную
предпочтен: предпочтения
запитыван: запитывания
век: века
начина: начинаем начинающих
загнива: загнивающих
тонкост: тонкости
расстоян: расстояние
аппетит: аппетиты
вс: вс
популярн: популярными популярное
прогноз: прогнозы прогнозов
вмешательств: вмешательства
вт: вт
изотоп: изотопы изотопов
смертельн: смертельно
област: областях области
выдержат: выдержат
научн: научно
воткнут: воткнуть
батар: батарей батареи
сво: своими сво свой
нача: начать
плотност: плотность
специалист: специалисты
порог: порог
реализ: реализуется
станов: становятся становиться
попробу: попробуем
тест: тест
хранен: хранения хранение
явля: является являются
парк: парк
дорогостоя: дорогостоящую
поселк: поселков
полярн: полярности
ячеек: ячеек
резистор: резисторов резисторы резисторами
теря: теряют
развит: развитием развитие
представ: представить
сайт: сайта
обеспечен: обеспечение
оборудован: оборудование
научпоп: научпоп
технолог: технологий технология технологии
происход: происходит происходить
задач: задачу задача
рашид: рашида
различн: различных различным
нейросет: нейросети нейросетей
инженерн: инженерные
трет: трети
смогут: смогут
перес: перес
фотоэлектрическ: фотоэлектрических фотоэлектрические
виж: вижу
посвящ: посвящ посвящена
треб: требуют
приветствова: приветствовать
поистин: поистине
истор: истории
зрен: зрения
двум: двумя
ещ: ещ
факт: факт
частиц: частицы
сер: серии
вид: видов
конфиденциальн: конфиденциальность
мастер: мастерить
науч: научились
ищут: ищут
радиосвяз: радиосвязь
розетк: розеткой
неэффективн: неэффективно
обеща: обещают
наук: наука
инновац: инноваций
хот: хотим
позволя: позволяют позволяет
зв: зв
дне: дней
избыточн: избыточной
рейтинг: рейтинг рейтинга
дом: дом
известн: известно
сторон: стороне
поток: потоки
кратк: краткому
поддержк: поддержкой поддержка
остальн: остальные
конкурир: конкурирующие
дня: дня
модульн: модульные
принцип: принцип
хорош: хорошей
библиотек: библиотек
классификац: классификации
воссозда: воссоздать
ид: идеи
мким: мкими
любим: любимого
наш: нашего нашей наших
ватт: ватт
возьм: возьм
темп: темпами
пользовател: пользователя
успешн: успешно
зарядн: зарядную зарядных
зарядк: зарядкой
компонент: компоненты
большинств: большинство
умн: умный
затрат: затрат
измерен: измерений измерением
прибор: приборы
информац: информация
поставля: поставляемой
земл: земле
реактор: реактор реакторах реакторов реактора реакторами реакторы
берег: берегах
спуст: спустя
автономн: автономность
упа: упало
ко: кой
собра: собрать
никел: никель
например: например
заряжа: заряжать заряжаем
запуст: запустить
ура: уран
нативн: нативные
надежн: надежный
огромн: огромных огромного огромное
энкор: энкор
познаком: познакомимся познакомит
акб: акб
мощност: мощность
стран: странах страну страны стран
вол: воли
январ: января
уровн: уровня
дур: дурят
мо: мо
южн: южной
ячейк: ячейки
уясн: уяснив
спецификац: спецификации
сбива: сбивает
ноутбук: ноутбуков ноутбуки
выживан: выживание
дуб: дубая
наскольк: насколько
техновыставк: техновыставки
лас: лас
проблем: проблемы
раздел: разделы
исследовател: исследователи
нек: некий
пресловут: пресловутых
ориентиру: ориентируясь
лучш: лучшие лучших
микросхем: микросхемой микросхемами
космическ: космические
дума: думать
оп: опыт
интересн: интересна
возможн: возможности возможностями возможностей возможные
разряд: разряда
четыр: четыр
открыт: открытые открытых
учитыв: учитывая
обещан: обещаний обещание
судн: судного
крупн: крупнейших крупные
меша: мешает
провозглаша: провозглашают
пустын: пустыне
стабильн: стабильным
субатомн: субатомные
изображен: изображения
прежн: прежними
откр: открыли открыть
таблетк: таблетки
источник: источники источниками источник
ruvd: ruvds
dii: diy
usb: usb
yuasa: yuasa
vconn: vconn
dan: dan
qc: qc
high: high
twitter: twitter
starlin: starline
electron: electronics
enrich: enriched
nuscal: nuscale
toshiba: toshiba
ea: ea
nova: nova
aa: aa
zel: zel
exid: exide
getmatch: getmatch
wifi: wifi
python: python
freepik: freepik
nimh: nimh
selectel: selectel
ivansychev: ivansychev
vd: vds
translat: translate
househusband: househusband
na: nas
solit: solite
mikeveng: mikeveng
vk: vk
marker: marker
consum: consumer
gpon: gpon
habr: habr
je: je
uranium: uranium
batteri: battery
aaa: aaa
lora: lora
sly: sly
ru: ru
berdchen: berdchen
nucl: nucl
ekaterina: ekaterina
bright: bright
sdy: sdy
arnak: arnak
mazda: mazda
sea: sea
alexeynadezhin: alexeynadezhin
youtub: youtube
rss: rss
premium: premium
panason: panasonic
man: man
power: power
chatgpt: chatgpt
tinyelectronicfriend: tinyelectronicfriends
cc: cc
ce: ces
avshkol: avshkol
torumgroup: torumgroup
haleu: haleu
alizar: alizar
assai: assay
greiv: greiv
facebook: facebook
xxi: xxi
telegram: telegram
furukawa: furukawa
super: super
pe: pe
lamptest: lamptest
microusb: microusb
pi: pi
mark: marks
tnenergi: tnenergy
dc: dc
