обрат: обратиться
готов: готовы готовых готово
случ: случиться
говор: говоря
информацион: информационная
фактическ: фактическим
расскаж: расскажу
стат: стать статью статье статьи статей статья
обычн: обычным
стар: старую
рабоч: рабочие рабочих
мнен: мнение
предлага: предлагаю
обзор: обзор
появ: появилась
став: став
случа: случается
един: единого
реализова: реализован реализовать реализовали
последств: последствия последствий
работ: работа работе работы работу
запуска: запускали запускаем
рекламн: рекламные
показыва: показывают показывать
дополнительн: дополнительные
доступ: доступа доступ доступен
вернут: вернуться
под: подах
сетев: сетевого сетевую сетевые
принос: приносит
четверт: четвертая
сокраща: сокращает
инфраструктур: инфраструктуры инфраструктуру инфраструктура
приглаша: приглашаем
учебн: учебных
критическ: критически
схем: схема схемы
специализирова: специализированных
менеджмент: менеджмент
единствен: единственным
интеграц: интеграции
прототипирован: прототипированию
галочк: галочками
топик: топиками
н: н
неприятн: неприятность
публикац: публикации
скопирова: скопировать
дава: давайте
х: х
подел: поделиться поделились
показа: показана показать
сезон: сезон
модификатор: модификаторах
благодар: благодаря
котор: котором которыми
девопс: девопсу девопс
мин: мин
вариант: вариант
сборок: сборок
изолент: изоленты
реализовыва: реализовывать
повторяем: повторяемостью
продава: продавать
мультитенантн: мультитенантными мультитенантной мультитенантном
связа: связанные связанных
прав: права прав правило
безопасн: безопасности безопасность
манифест: манифестам манифестов манифесты манифестами манифеста
вовс: вовсе
либ: либо
проект: проектов проектам проекты проектами
ива: иван
появля: появляется
строков: строковых
зад: зада
опас: опасаясь
профил: профиль
дела: делали делать
столкнут: столкнуться
извн: извне
получ: получили получить
синхронизац: синхронизации
документац: документации
верн: верно
объявлен: объявлений
перевод: перевод
хост: хостах
верс: версию
защ: защите
маркетинг: маркетинг
каноничн: каноничной
час: час
столкнул: столкнулись
прост: простой простое
трафик: трафика
конфигурируем: конфигурируемого
альтернатив: альтернативы
позвол: позволят
индустр: индустрии
занима: занимающегося занимаюсь
свободн: свободного свободные
возражен: возражения
следова: следовать
заработа: заработала
встрет: встретила встретить
эксплуатац: эксплуатации
уровен: уровень
нов: новый нового новой новые новым новая
специфик: специфику
ног: ногу
внешн: внешних внешние
больш: большой
медийн: медийная
мест: места
част: часть
алекс: алексей
смартап: смартап
устро: устроить
карьер: карьера
вход: входа
инженер: инженер инженерией инженеров
аналогичн: аналогичных
попаст: попасть
постоя: постоянно постоянными постоянное
системн: системное
существен: существенные существенно
внимательн: внимательно
сдела: сделать
особен: особенность
мерф: мерфи
устанавлива: устанавливаем
сложн: сложный сложные
исправлен: исправлений
представлен: представление
генерац: генерации генерация
иерархическ: иерархические иерархических
контейнерн: контейнерными контейнерных
примен: применить
пут: пути пут
окружен: окружения окружении окружение
контейнеризирова: контейнеризированных
пример: примере
технолодж: технолоджи
хранилищ: хранилищами хранилище
аутентификац: аутентификации
систем: системы системе система системах
бесполез: бесполезен
мож: можем
узна: узнаем
обсужден: обсуждение
микросервис: микросервисов
трудн: трудно
курс: курса
ресурс: ресурса ресурс ресурсы ресурсов
машин: машинах машин
лидер: лидерами
процесс: процессы процессов процесс
основа: основанные
свойств: свойства свойствам свойств
подготов: подготовили
требован: требования требованиями
решен: решений решение решения
хотел: хотелось
владельц: владельцам
масштабирован: масштабирование масштабирования
средн: средний
живет: живет
продолжа: продолжаем
нужн: нужные
домашн: домашнем
поздн: поздно
вакуум: вакууме
подряд: подряд
хаб: хабы
описан: описание описания
вечер: вечеров
помощ: помощью
приложен: приложениями приложение приложениях приложений
разработчик: разработчик разработчику
результат: результатов
командн: командной
красив: красиво
бессердечн: бессердечной
ваканс: вакансии
настройк: настройка настройке
вклад: вклад
дал: далее
пониман: понимание понимании
документ: документы
прочтен: прочтение
желан: желание
корректн: корректного
мечта: мечтает
ссылк: ссылки ссылка ссылку
навык: навыков навыки
средств: средством
дам: дамой
дан: данных
пожал: пожалуй
охват: охват
установ: установить
конфигурирован: конфигурирования конфигурированию
квест: квестов
состоя: состоящим
закон: закону
любопытств: любопытство
хват: хватить
код: кодом
детальн: детального
модул: модули модулями
регистрац: регистрация
кон: коня
технологическ: технологический
перевел: перевела
кругл: круглый
имеет: имеет
генератор: генераторах генераторы
формирован: формирования
отсутств: отсутствии
функц: функцию
внесен: внесения
упрост: упростить
мся: мся
используем: используемых
цел: целом целых
изуча: изучаю
самописн: самописного
кажд: каждого
заран: заранее
техлид: техлид
настро: настроить настроено
нагрузок: нагрузок
следован: следовании
дзен: дзен
политик: политики политику
вмест: вместе
отличн: отличные
жив: живое
обнов: обновить
оффер: оффере
внепланов: внеплановую
донастройк: донастройка
настроен: настроенных
разработк: разработкой разработка разработки
закладк: закладки
налич: наличии
использова: использоваться
программн: программных программного
поколен: поколения
контейнер: контейнеров контейнера контейнер контейнерах контейнере контейнером
пройт: пройти
установк: установку установке
метрик: метрик
сюд: сюда
релиз: релизе
настоя: настоящая
глобус: глобус
список: список
непреодолим: непреодолимое
отполирова: отполированного
итог: итоге
замечательн: замечательных
след: следили
минут: минут
строк: строки
завест: завести
вопрос: вопрос вопросы вопросе вопросов
организац: организациям
дизайн: дизайн
концепц: концепции
пошагов: пошаговая
устройств: устройство
пришел: пришел
переход: переход
клиент: клиента клиент
коротк: короткие
ваш: вашей ваших вашими
ответ: ответы ответами
так: такими таких
пространств: пространств пространстве пространствах пространства
полност: полностью
собствен: собственную собственно
флант: флант фланте
баз: баз базы
техническ: техническая
дьявол: дьявол
красот: красотой
держа: держать
фев: фев
расширен: расширений
заметк: заметке
внест: внести
мегапроект: мегапроекты
хабр: хабр
сэконом: сэкономил
некотор: некоторые
рассмотр: рассмотрим
потенциальн: потенциальный потенциальные
аз: азов
ртыван: ртывание ртыванием ртывания
количеств: количество
соглашен: соглашение
логичн: логичностью
остава: оставалось
услыша: услышать
добав: добавить добавив
щелкнут: щелкнуть
оркестрац: оркестрации
просмотр: просмотров
специальн: специальное
мысл: мысль
содержан: содержание
практик: практикующих
ряд: ряд
последн: последние
разновидн: разновидности
конфигурац: конфигурация конфигураций
услов: условиях
сам: самые самым
представля: представляют представляет
манипулирова: манипулировать
бд: бд
виртуальн: виртуальных
настраива: настраиваемый
стартап: стартапам
туториа: туториал
правильн: правильно
оказыва: оказывается
запущ: запущены
посмотр: посмотрим
называ: называют
кластер: кластерами кластеров кластере кластер кластера кластерах
менеджер: менеджер
развертыван: развертывание развертыванию развертывания
компан: компаний компании
рассказыва: рассказывали
программ: программы
управлен: управление
гулак: гулаков
получа: получать
ежедневн: ежедневные
предназначен: предназначенного
разбира: разбирался
нашл: нашли
предъяв: предъявить
доделыва: доделывали
вошел: вошел
ненормальн: ненормальное
митигирова: митигировать
умолчан: умолчанию
предполага: предполагает
начина: начинающий начинающих
стандарт: стандартом
привет: привет
очередн: очередной
состоян: состоянием состояние
начн: начнем
использ: используется используются
имеют: имеют имеются
спикер: спикеров
магазин: магазин
созда: создан
плагин: плагина
объясня: объясняем
веб: веб
кейс: кейс
программирован: программирование
отдельн: отдельный отдельных
стол: стол
отобража: отображаемые
реша: решать
прокачива: прокачивали
даст: даст
специалист: специалистов
порог: порог
сохранен: сохранение
интернет: интернет
реализац: реализации реализация
истин: истины
возникл: возникло
явля: является
свод: сводится
освет: осветить
применя: применяются
теря: теряется
пришл: пришлось
полн: полную
администрирован: администрирование
де: де
разграничен: разграничению
представ: представить представилось
контроллер: контроллер контроллерами контроллером
легковесн: легковесного
определя: определяет
сайт: сайта сайтов
знан: знания знаний
обеспечен: обеспечения обеспечению
суперадминистратор: суперадминистратора
научпоп: научпоп
технолог: технологиями технологией технологий технология технологии
задач: задачу задачи задач
комментар: комментарии
праздн: праздное
поставк: поставки
файл: файл
рамк: рамках
различн: различные различных
прощ: проще
трет: третья
работа: работают работающее работает
детал: деталях
песочниц: песочницы песочница
сегодняшн: сегодняшняя сегодняшнем
долж: должен
тарифн: тарифного
вызва: вызвала
пар: пару
посвящ: посвящена
услуг: услуги
базов: базовые
треб: требуется
логирован: логированию
натягива: натягивается
блог: блог
необходим: необходимо
фреймворк: фреймворк
зовут: зовут
истор: истории
интерфейс: интерфейсу интерфейс
пробл: проблему
сложност: сложности
факт: факто
ещ: ещ
закрыва: закрываем
автор: авторы автором авторов автора
неизменяем: неизменяемость
сер: серию
чита: читать
сет: сетей
конфиденциальн: конфиденциальность
собеседован: собеседовании собеседование
подход: подходах подхода
защит: защитить защиты
доход: доход
придет: придется
разумн: разумно
тестирован: тестирование
долгожда: долгожданном
нескольк: нескольких
вышеперечислен: вышеперечисленных
эксперт: экспертом
бизнес: бизнес
тип: типа типов
позволя: позволяют позволяет
хоч: хочу
рейтинг: рейтинг рейтинга
распространен: распространенным
реч: речь
реш: решил решить
общ: общем общее
горяч: горячие
сторон: стороны сторонних
поток: потоки
виртуализац: виртуализация виртуализации
поддержк: поддержке поддержки поддержка
зада: задали
угодн: угодно
набор: набора набор наборы
монтирован: монтирование
поддержива: поддерживаются
серг: сергей
удобн: удобно
оператор: оператора
сред: сред среди
тестов: тестовых
им: имен
ин: иной
наш: наших
сия: сияет
пользовател: пользователя пользователями пользователь
зависим: зависимости зависимостей
люб: любом любого любой
компонент: компонентов
язык: языку языка
потреб: потребуются
согласова: согласованных
син: синей
план: плана
крупномасштабн: крупномасштабными
содержа: содержащие
публичн: публичным публичный
сервис: сервиса сервисы сервис
информац: информацию информация
облачн: облачные
гот: готов
разн: разные
продакт: продакт
всевозможн: всевозможных
присваива: присваиваются
распараллел: распараллелили
разв: разв
отвеча: отвечающей
бустанул: бустануло
координац: координацию
гравитац: гравитация
добавлен: добавление
ревиз: ревизию
сборк: сборки сборка
ко: кое
размещен: размещения
собра: собрали
облак: облаке
закрыт: закрытия закрытое закрытом
храня: хранящихся хранящаяся
прич: прич
привод: приводятся
волк: волков
например: например
подготовк: подготовка
одн: одним
выстрел: выстрелят
широк: широко
мар: мар
реклам: реклама
неприемлем: неприемлемо
запуст: запустить
разбер: разбер
корпоративн: корпоративный
нагрузк: нагрузками нагрузки
соответств: соответствующее
нативн: нативные
масс: масса
шаблон: шаблона шаблонов шаблон
инструмент: инструментов инструменты
команд: команда команды команд командам
дербуш: дербуш
польз: пользы польза
архитектор: архитектор
рассмотрен: рассмотрения
стек: стек стеком
инструкц: инструкция
использован: использования использованием
отлич: отличия
платформ: платформе платформу платформы
консол: консоли
подозрительн: подозрительный
сист: систему систем
войт: войти
исходн: исходным
ноутбук: ноутбуком ноутбуке
качеств: качестве
мейнстримов: мейнстримовой
аккаунт: аккаунт
разделен: разделение
распараллеливан: распараллеливании
газпромбанк: газпромбанк
счаст: счастью
проблем: проблемы проблемами
репозитор: репозиторий репозитории
подробн: подробно подробную
излага: излагается
сервер: сервера серверу
сов: сова
раздел: разделить разделы
автоматическ: автоматически
жела: желавший
яндекс: яндекс
унифицирова: унифицированно
новост: новости
лучш: лучшее лучшие лучших
существ: существует
механизм: механизм
перв: первая
управля: управляем управлять
небольш: небольших
разворачива: разворачивается
борол: боролись
поиск: поиск
возможн: возможности возможно
интересн: интересное интересную интересных
автоматизирова: автоматизировали автоматизировать
изменен: изменение изменения
ос: ос
артефакт: артефактов артефакты
прочн: прочно
основ: основе
открыт: открытым
выбра: выбрать выбранными
позвольт: позвольте
голов: голове
образовательн: образовательные
как: каком какие
определ: определить
функциональн: функционального функциональное
крупн: крупных
все: всей
сконфигурирова: сконфигурированных
голос: голосов
содерж: содержит
рассматрива: рассматривали рассматривается
тся: тся
взгляд: взгляд
высок: высокими
обход: обходясь
мечт: мечты
втор: вторая
кроет: кроется
архитектур: архитектуры
риск: риски
уничтож: уничтожено уничтожить
откр: открыт открыть
способ: способен способа
кнопк: кнопку
термин: терминах
источник: источник источником
конференц: конференции
панел: панель
runtim: runtime
big: big
backup: backup
sourc: source
polina: polina
devop: devops
argocd: argocd
rocket: rocket
compos: compose
helm: helm
sso: sso
liquibas: liquibase
ssp: ssp
twitter: twitter
statefulset: statefulset
faq: faq
api: api
aa: aas
nat: nat
val: val
sokol: sokol
dsoastro: dsoastro
ip: ip
zap: zap
manag: manager
javascript: javascript
otu: otus
wellsbart: wellsbart
grafana: grafana
nativ: native
kafka: kafka
singl: single
habr: habr
cloudmt: cloudmts
suppli: supply
engin: engineering
pod: pod
bigwisehedgehog: bigwisehedgehog
avvolkov: avvolkov
secret: secret
yrepear: yrepear
youtub: youtube
catboost: catboost
rss: rss
jsonnet: jsonnet
kustom: kustomize kustomization
virtualbox: virtualbox
spark: spark
web: web
southbridg: southbridge
packag: package
contain: container
cento: centos
autoscal: autoscaler
facebook: facebook
upgrad: upgrade
observ: observability
seasadm: seasadm
prometheu: prometheus
imag: image
apach: apache
chart: chart
open: open
demin: demin
data: data
romapr: romapres
sign: sign
namespac: namespace
anna: anna
deploy: deployment
cloud: cloud
technolog: technology
ui: ui
kepiukik: kepiukik
andrei: andrey
yaml: yaml
tech: tech
askobin: askobin
lika: lika
distol: distol
averina: averina
containerd: containerd
amazon: amazon
ingress: ingress
servic: service services
vk: vk
mdo: mdos
http: http
terraform: terraform
scienc: science
primetalk: primetalk
deckhous: deckhouse
biryukov: biryukov
maxrokatanski: maxrokatansky
golang: golang
konstantin: konstantin
kubernet: kubernetes
platform: platform
docker: docker
saa: saas
git: git
flannel: flannel
postgresql: postgresql
wimbo: wimbo
linux: linux
aigrychev: aigrychev
vor: vor
json: json
backend: backend
chernigo: chernigo
smartup: smartup
shurup: shurup
rest: rest
kvin: kvin
zhbert: zhbert
goapp: goapp
mvp: mvp
custom: customization
kvap: kvaps
zuzza: zuzzas
telegram: telegram
env: env
horizont: horizontal
gitop: gitops
yandex: yandex
