дорос: дорос
максимальн: максимального
найт: найти
случ: случая
преобразован: преобразования
компромисс: компромиссы
информацион: информационных информационная
понима: понимаю
образ: образом
стат: стать статью статье статья
обычн: обычных
стар: старую
учет: учетом
найд: найден найдены
стал: стало
мнен: мнения
объясн: объяснить
обзор: обзор
получател: получателей
случа: случае
появ: появились
призва: призвана
последств: последствия
работ: работа работы работе
центр: центров
завис: зависит
показыва: показывать
дополнительн: дополнительные
доступ: доступ
сценар: сценариев
вернут: вернуться
сетев: сетевые
предел: пределах
четверт: четверть
инфраструктур: инфраструктурой
сто: стоит
основан: основания
человек: человеку
обновлен: обновления
инвестирова: инвестировать
схем: схему
д: д
менеджмент: менеджмент
и: ии
интеграц: интеграции
топик: топика
местоположен: местоположение
разговор: разговора
неприятн: неприятной
личност: личность
мобильн: мобильного
должн: должны
структур: структуры структуру
публикац: публикаций публикации
скопирова: скопировать
дава: давайте
означа: означает
интегратор: интеграторов
человеческ: человечески
иерарх: иерархию
жестк: жесткой
назван: названием
котор: котором которыми
мин: мин
вариант: вариантов
пор: порой
мир: миром мир
реализовыва: реализовывать
совершен: совершенно
прав: правил правила
безопасн: безопасной безопасных безопасность безопасная
компромиссн: компромиссные
статистик: статистики
проект: проекты проектами проекта
появля: появляются
профил: профиль
дела: делать
сообщен: сообщения сообщений
столкнут: столкнуться
получ: получить
режим: режиме
перевод: перевод
компенсир: компенсируют
верс: версии версию
маркетинг: маркетинг
разобра: разобраться
маршрутизац: маршрутизации
тупиков: тупиковых
прост: простой
прием: приемы
раскр: раскрыть
убедительн: убедительного
зациклива: зацикливаются
позвол: позволят
сериализац: сериализации
ауд: аудио
свободн: свободная
наследова: наследовать
неструктурирова: неструктурированными неструктурированные
движен: движение
повышен: повышению
позвон: позвонить
эксплуатац: эксплуатации
уровен: уровень
очевидн: очевидной
нов: новые новых новый
внешн: внешним
больш: большей большой
медийн: медийная
част: части частей часть частями
отбор: отбора
иде: идея
цифров: цифровые
динамическ: динамической
традицион: традиционной
карьер: карьеры
журна: журнал
направлен: направлений
игр: игр
полезн: полезно
одновремен: одновременно
сдела: сделать
эффективн: эффективной эффективным
плава: плавающей
особен: особенности
сложн: сложных сложное сложно
расшир: расширена
извлечен: извлечения
генерац: генерация
примен: применить
пут: путь
операцион: операционной
методолог: методологии
персонал: персоналом
систем: системы системой системе система
выход: выхода
должност: должности
класс: класса классов классы класс
провал: провалу
узна: узнаем
мошенничеств: мошенничеству
убежда: убеждают
момент: момент
основн: основные основной основном основная
сожален: сожалению
сможет: сможет
ресурс: ресурсов ресурса
лиша: лишать
метод: метод методов
машин: машины машинное машин
процесс: процессе
групп: группе
привест: привести
неудач: неудачи
решен: решений решения решением
актуальн: актуальных
средн: средний
личн: личную
номер: номер номеру
разметк: разметки
помоч: помочь
меня: меняют
хаб: хабы
нрав: нравится
помощ: помощью помощь
современ: современный
выш: выше
приложен: приложений
разработчик: разработчик
результат: результате
вызыва: вызывает вызывающем
красив: красивого красивости
чрезмерн: чрезмерной
попытк: попыткам
настройк: настройки настройка
вклад: вклад
дал: далее
проталкива: проталкивающем
документ: документы документов
прочтен: прочтение
ссылк: ссылке ссылку
навык: навыки
словн: словно
взрывн: взрывного
интерес: интересам интересы
средств: средств
дан: данные данных данными данном
пожал: пожалуй
займет: займет
установ: установить
дат: дата
разделя: разделять
осуществля: осуществлять осуществляется
код: кода код коде
целочислен: целочисленными целочисленные
паттерн: паттерны
подверга: подвергается
росс: россия
модул: модули
регистрац: регистрация регистрации
разговорн: разговорного
коп: копии
ситуац: ситуаций
числен: численность
соединен: соединения
камер: камеры
функц: функций функции функцией
причин: причиной
архитектурн: архитектурных
используем: используемой
отлича: отличаться отличаются
запят: запятой
доступн: доступной
заран: заранее
кажд: каждого каждой
настро: настроить
ниоткуд: ниоткуда
российск: российских
дзен: дзен
сохран: сохранить
множеств: множество
взаимодейств: взаимодействует
искусствен: искусственный
ошибк: ошибкам ошибки
мотивац: мотивацию
неинтуитивн: неинтуитивным
обнов: обновить
объект: объекта объектов
разработк: разработке разработка разработки
закладк: закладки
серьезн: серьезным
ведет: ведется
использова: использовать
настроек: настроек
высокопроизводительн: высокопроизводительный
стратег: стратегий
программн: программное
контейнер: контейнеров
векторизац: векторизация
добавля: добавлять добавляется
учитыва: учитывают
сюд: сюда
професс: профессию
преимуществ: преимуществ преимущества
список: список
принесет: принесет
ориентирова: ориентированному
реляцион: реляционной
строг: строгой
абонент: абоненте
напомн: напомним
дел: делая
организац: организация
дизайн: дизайн
сохраня: сохраняемого
внутрен: внутренних
устройств: устройство
пришел: пришел
текстов: текстовые
записыва: записываются
коротк: коротких
хакер: хакеры
бэкенд: бэкенде
так: такими таких
полнотекстов: полнотекстовый
несмотр: несмотря
уязвим: уязвимостей уязвимостях уязвимости
проектирован: проектировании проектирование
сталкива: сталкивался
собствен: собственного
баз: баз базами базы
техническ: техническая
хран: хранить
драйвер: драйверов
алгоритм: алгоритм
фев: фев
неявн: неявных
расширен: расширения расширений
рефлекс: рефлексии
внесл: внесли
мегапроект: мегапроекты
хабр: хабр
смен: сменил
запечата: запечатанные
аналитик: аналитиков аналитики
вредоносн: вредоносные
обсуд: обсудим
обучен: обучение
извлека: извлекаемого извлекать
некотор: некоторые
астрономическ: астрономических
рассмотр: рассмотрим
потенциальн: потенциальные
удовлетворя: удовлетворяет
количеств: количество
служб: служба
соглашен: соглашение
кратчайш: кратчайший
добав: добавить
щелкнут: щелкнуть
уявзим: уявзимости
просмотр: просмотров
содержат: содержат
практик: практик
мысл: мыслей
последн: последние
зна: знаем
конфигурац: конфигурациями конфигураций
сам: самых
интеллект: интеллект
бд: бд
виртуальн: виртуальных
стартап: стартапам
туториа: туториал
приход: приходят
сбор: сбор
подобн: подобные
называ: называемом
кластер: кластера
компан: компаний компании компаниях
выполнен: выполнения
ограничен: ограниченных
программ: программы
управлен: управление управления
действ: действии
неожида: неожиданных
соответствен: соответственно
пресс: прессе
представл: представлены
смысл: смысле
век: века
предполага: предполагает
начина: начинался
внедр: внедрить внедрен
состоян: состоянию
сопровожден: сопровождении
использ: использует используют
изуч: изучить
ран: ранее
веб: веб
помн: помнить
программирован: программирование
отдельн: отдельного
нача: начало начался
исследуем: исследуемых
непониман: непонимания
реша: решают
специалист: специалисты
сохранен: сохранения сохранение
забыва: забывать
предоставля: предоставляет
значительн: значительными
хранен: хранения хранение
гис: гис
оглянут: оглянуться
явля: является являются
стрим: стримы
узк: узком
вещ: вещи
узл: узлами узлам
тем: тема
сбалансирова: сбалансированной
архимейт: архимейт
полн: полному
администрирован: администрирование
определя: определять
анализир: анализируются
сайт: сайта сайт
обеспечен: обеспечение
знал: знали
научпоп: научпоп
технолог: технология технологии
продолж: продолжим
комментар: комментарии
происход: происходит
файл: файлов файлы
рамк: рамках
сотрудник: сотрудники
различн: различные различных различным
адрес: адресов адреса
типизац: типизацией
работа: работаю работает работающих
сильн: сильно
самозванц: самозванца
песочниц: песочница
услуг: услуги
подписчик: подписчики
треб: требуется
телефон: телефона
блог: блог
необходим: необходимые необходимости
мрачн: мрачных
индекс: индекса
числ: числами
автоматизац: автоматизацию автоматизации
интерфейс: интерфейсу интерфейса интерфейс
наследован: наследования
модел: модели
сложност: сложности сложностей
параметр: параметров
призыва: призывают
гибк: гибкой гибко
видн: видна
автор: авторы авторов автором
реакц: реакцией
чита: читать
вид: виде
сет: сети сетей
представител: представитель
конфиденциальн: конфиденциальность
виде: видео
подход: подходу подход
положен: положения
попада: попадаются
придет: придется
науч: научить
оста: остается
ущерб: ущерб
нескольк: нескольких
неразберих: неразбериха
эксперт: экспертов
бизнес: бизнеса бизнес
тип: типа типами типы
позволя: позволяют позволяет
воспринима: воспринимаю
мультимед: мультимедиа
хоч: хочу
рейтинг: рейтинг
распространен: распространенных
статическ: статическими статических
отрасл: отрасль
реш: решить
способн: способности
унаследова: унаследована
структурирова: структурированной
сторон: сторона сторону
постав: поставить
поток: поток потоки
поддержк: поддержка поддержку
остальн: остальные
высказыва: высказывались
данност: данность
набор: набор
глубок: глубокого глубокие
профессиональн: профессиональный
библиотек: библиотеки
конфигурацион: конфигурационные
звонк: звонки
удобн: удобным
документн: документной
сред: сред среду
ютуб: ютуб
мног: многое
пользовател: пользователя пользователям
посвящен: посвященных
зависим: зависимости
язык: языков язык языка языках
рекрутинг: рекрутинг
избежа: избежать
содержа: содержащими
таблиц: таблицам
застрахова: застрахована
информац: информацию информация информации
фронтенд: фронтенд
разн: разным разному
негативн: негативные
ключев: ключевых
выгляд: выглядит
анализ: анализ
способств: способствующей
подвержен: подверженных
удален: удаленного
координат: координат
отправк: отправка
отчет: отчетах
автономн: автономной
шумих: шумиха
предварительн: предварительно
предотврат: предотвратить
критер: критерий
поговор: поговорим
обработк: обработки обработка
применен: применение
создан: создания создании создание созданию
встроен: встроенной встроенных
стрелочн: стрелочные
клонирован: клонирования
закрыт: закрытые
содействова: содействовать
например: например
спам: спама
подготовк: подготовку
постара: постараюсь
одн: одним одно одном одна
отправля: отправляют
мар: мар
широк: широком
реклам: реклама
разбер: разберем
корпоративн: корпоративного корпоративный
потребн: потребности
нативн: нативный нативные
действова: действовать
расширя: расширяем
шаблон: шаблоны шаблонах шаблонов
инструмент: инструменты инструментах инструментов инструмента
надежн: надежных надежности
ведущ: ведущих
команд: команду команда команд
огранич: ограничить
апрел: апреля
архитектор: архитектора
ограничива: ограничивает
движок: движок
использован: использования использовании использованием
мо: моей
платформ: платформы
запрос: запросов
поскольк: поскольку
сист: систем
безагентск: безагентским
март: марта
зацикл: зациклится
войт: войти
качеств: качестве
интересова: интересовать
аккаунт: аккаунт
протокол: протокол протоколу протоколов
проблем: проблемы проблемой проблемам
обнаружен: обнаружения
сервер: серверов сервера
раздел: разделы
намн: намного
строгост: строгости
похож: похоже
выражен: выражениями выражения
ажиотаж: ажиотажа
угроз: угрозу
яндекс: яндекс
новост: новости
лучш: лучшие
существ: существует существующих
перв: первая первой
механизм: механизмами
управля: управляемым управляемого
относ: относится
приня: принять
крайн: крайне
написа: написать
поиск: поиска поиск
возможн: возможности возможность возможным возможных
изменен: изменениях
запомн: запомнить
мед: медиа
дает: дает
образовательн: образовательные
определ: определен определены определить
как: какие
крупн: крупных
голос: голосов
рассматрива: рассматривали рассматривать
произвольн: произвольных произвольной
архитектур: архитектура архитектуры
рол: ролей роли
выступа: выступать
наверняк: наверняка
прежн: прежнему
уничтож: уничтожить
риск: риски
сфер: сфере
потоков: потоковой потоковое
откр: открыть
способ: способа способов способах способ
узел: узел
продукт: продукта
источник: источников источник
панел: панель
exwil: exwill
rikki: rikki
devop: devops
ansibl: ansible
dacl: dacl
ssh: ssh
microsoft: microsoft
bit: bit
mode: mode
path: path
protocol: protocol
twitter: twitter
java: java
html: html
andrei: andrey
golovind: golovinds
shortest: shortest
python: python
kmongo: kmongo
ip: ip
daili: daily
adl: adl
javascript: javascript
rfc: rfc
ipv: ipv
nosql: nosql
otu: otus
kmoseenk: kmoseenk
grafana: grafana
vk: vk
architectur: architecture
habr: habr
descript: description
daneelzam: daneelzam
internet: internet
biryukov: biryukov
maxrokatanski: maxrokatansky
code: code
ru: ru
log: log
seal: sealed
js: js
kubernet: kubernetes
sql: sql
youtub: youtube
rust: rust
rss: rss
cve: cve
postgresql: postgresql
dmitriizolotov: dmitriizolotov
await: await
sm: sms
backend: backend
recoveri: recovery
mongodb: mongodb
chatgpt: chatgpt
structuredclon: structuredclone
tikki: tikki
pgx: pgx
sre: sre
facebook: facebook
kotlin: kotlin
telegram: telegram
observ: observability
ospf: ospf
url: url
async: async
googl: google
spotifi: spotify
reliabl: reliability
prometheu: prometheus
open: open
frontend: frontend
