грамматическ: грамматические
найт: найти
причаст: причаститься
говор: говорить
провинциа: провинциал
рф: рф
банк: банке
информацион: информационной
расскаж: расскажу
рассказ: рассказ
копирайт: копирайт
образ: образа
стат: стать статье статьи статей статья
леж: лежит
сравн: сравним
ввод: ввода
стар: старое старую
вызов: вызова вызовов
инвестор: инвесторам
вводн: вводных
конц: концов конце конца
федеральн: федеральной
стал: стало
указан: указания
предлага: предлагаемые
беспорядочн: беспорядочным
обзор: обзор обзору
стад: стадии
электроник: электроники
случа: случае
появ: появиться
реализова: реализован реализовать
работ: работая работы работу
показыва: показывать
дополнительн: дополнительный
мозг: мозгу
вернут: вернуться
грех: грехи
сч: сч
получен: получения
пол: полях
александр: александр
схем: схема
янв: янв
вообщ: вообще
менеджмент: менеджмент
з: з
единствен: единственной
лет: лету
й: й
л: л
разговор: разговор
н: н
мобильн: мобильных
личност: личностью
ожида: ожидать
п: п
снижен: снижение
ошибок: ошибок
редкост: редкостью
публикац: публикации
скопирова: скопировать
дава: давайте
подел: поделиться
техподдержк: техподдержка
показа: показать
поэт: поэтому
звезд: звездам
котор: которую котором
мин: мин
вариант: варианта вариант
адресн: адресной адресных
мир: миром мире мир
эксперимент: эксперименты
исследован: исследованиями исследование исследования исследованиях
идеальн: идеальны
обратн: обратную обратных обратного
отмет: отметить
метаверс: метаверса
проект: проекты проектов
связ: связь
появля: появляться
относительн: относительно
профил: профиль
обертк: обертки
сут: сути
сообщен: сообщений
аналог: аналогов
засел: засело
получ: получила получить получиться
вхожден: вхождения
документац: документацию документации документация
режим: режимов режима
начальник: начальник
публик: публики
перевод: перевод
верс: версию
маркетинг: маркетинг маркетинга
книг: книг
разобра: разобраться
центральн: центральное
час: часов
прост: простой простым
выпущен: выпущенном
врем: времен
нно: нной
фидбек: фидбек
занима: занимается занимают занимать занимаетесь
встреч: встречах
лиц: лицам
подписк: подписка
ложк: ложкой
встрет: встретить
метавселен: метавселенных
псб: псб
уровен: уровень
нов: новые новый нового
специфик: специфике
продуктов: продуктовые
внешн: внешних
больш: больших большим большой
потенциа: потенциал
медийн: медийная
мест: место места
част: часть части
ждат: ждать
цифров: цифровая цифровых
слож: сложившийся
рочк: рочка
карьер: карьер
инженер: инженеры
направлен: направления
промисификац: промисификация
сойдет: сойдет
модерац: модерации
полезн: полезна полезны
отказ: отказа
парен: парень
постуча: постучались
сдела: сделай сделать сделают
доставк: доставки
определен: определенной
реквизит: реквизитах
невнимательн: невнимательности
высокоскоростн: высокоскоростные высокоскоростного высокоскоростной
сложн: сложный сложной сложно
демографическ: демографическом
мягк: мягко
аскон: аскон
любител: любителей
примен: применить
пут: пути путь
виден: видение
жал: жал
жизн: жизни
русск: русской
пример: примеров примеры примера примером
раскладк: раскладку раскладке
идт: идти
заполнен: заполнении
сформирова: сформирован
систем: система системы
выход: выходить
упрощен: упрощения
завоева: завоевал
невероятн: невероятно
чайник: чайников
мом: мом
отклик: отклик
шрифт: шрифта шрифт
фаворит: фавориты
труд: труда
нема: немало
основн: основным
трудн: труднее
геометрическ: геометрического
текущ: текущая
сможет: сможете
облада: обладающий
читател: читателям
математик: математика
метод: методы
процесс: процесс
основа: основанных
групп: групп группах
выпуска: выпускайте
привест: привести
решен: решение решением
легкост: легкость
нных: нных
хотел: хотел
маломощн: маломощных
передава: передавать
удив: удивят
средн: средний
комфортн: комфортного
личн: лично
продолжа: продолжаем
номер: номера
ужасн: ужасно
почв: почве
подряд: подряд
помога: помогает
хаб: хабы
рынк: рынке рынка
повыс: повысилась повысить
помощ: помощью помощи
современ: современных
кредитн: кредитного
востребова: востребованным
приложен: приложений приложение приложения
результат: результатами
разработчик: разработчик разработчиков
дочк: дочки
вызыва: вызывают
банковск: банковская банковского
опыт: опытом опыте
продвинут: продвинутый
дав: давила
программирова: программировать
рынок: рынок
настройк: настройка
вклад: вклад
явлен: явлениях
дал: далее
текст: текста текстах
пониман: понимание
документ: документы документа документах
прочтен: прочтению прочтение
будущ: будущего будущем
желан: желание
ссылк: ссылка ссылку
наоборот: наоборот
навык: навыках
нуж: нужен
монет: монету
иммерсивн: иммерсивность
выросл: выросли
калькулятор: калькулятор калькулятора
пенсионер: пенсионеры
прочита: прочитана
дегт: дегтя
конкуренц: конкуренция
лпр: лпр
сычев: сычева
дам: дам
сравнен: сравнение
дан: данных
программист: программистом
весьм: весьма
незаверш: незаверш
дизайнер: дизайнера дизайнер дизайнерам
код: кода
модул: модули
регистрац: регистрация
документирован: документировании
неточн: неточностей
кругл: круглым круглый
ситуац: ситуация
цикл: цикл
счита: считаю
некорректн: некорректное
отсутств: отсутствия отсутствует
причин: причин
функц: функции
упрост: упростят
брифинг: брифинга
цел: целом целым
старт: старт
предлож: предложить
кажд: каждым
асинхрон: асинхронные асинхронности асинхронность
возника: возникает
переключа: переключаться
возраст: возраст
амбиц: амбиций
продемонстрирова: продемонстрировать
дзен: дзен
канал: каналу
непрофессиональн: непрофессиональности
взаимодейств: взаимодействия
вмест: вместе
эх: эх
создава: создавали создавала
ошибк: ошибки
обнов: обновить
миллисекунд: миллисекунды
име: имеем
веден: ведения
примеря: примеряете
типографик: типографика
объект: объекты
винд: виндой
проектир: проектирует
разработк: разработкой разработке разработка
закладк: закладки
ведет: ведет
важ: важен
разработа: разработан
хеш: хеш
графическ: графический
использова: использовать
прекрасн: прекрасных
желез: железо
стратег: стратегии
возвращен: возвращение
программн: программных
писател: писатель
руководств: руководством руководству
форматирован: форматирования
оснащ: оснащ
блестя: блестящего
стимул: стимул
совершенств: совершенство
дифференциальн: дифференциальные
сюд: сюда
спрята: спрятанный
список: список
сказа: сказано
пост: посте
памятк: памятка
рекомендова: рекомендовано
ориентирова: ориентироваться
итог: итоге итоги
типов: типовой
дел: делимся деле делюсь дело
строк: строки
организац: организаций
дизайн: дизайна дизайн дизайном
рассказа: рассказать
производительн: производительность
электронщик: электронщиков электронщики электронщикам
пошагов: пошаговая
помим: помимо
внутрен: внутренних
устройств: устройствах устройство устройства
размер: размером
недоч: недоч
клиент: клиенты клиентом клиент
коротк: коротко
вопиющ: вопиющей
изучен: изучение
так: таком
общен: общению
никт: никто
порт: порты порт
картин: картину
полност: полностью
семейн: семейное семейные
сталкива: сталкиваются
событ: событий
проектирован: проектировании проектирование проектированием
собствен: собственный собственного
техническ: технической техническая технический
цельн: цельную
фев: фев
неявн: неявное
дет: дети
расширен: расширения
заметк: заметки
символ: символа символ
собира: собираются
мегапроект: мегапроекты
хабр: хабре хабр хабра
привлекательн: привлекательных
аналитик: аналитика аналитики аналитикой аналитик
скриншот: скриншот
некотор: некоторое некоторых некоторые некоторым
отступлен: отступлением
рассмотр: рассмотрим
ад: ад
механическ: механических
клавиатур: клавиатурах клавиатуры клавиатуру клавиатура
употреблен: употребление
количеств: количество количеством
служб: службы
введен: введение
залг: залго
ал: алена
соглашен: соглашение
оформлен: оформлении
куч: куча
остава: оставалась
добав: добавился добавить
просмотр: просмотров
практик: практики
методик: методикой
разновидн: разновидностях
паяльник: паяльник паяльниках паяльнике
зна: знаю
сам: самые самым
набира: набираемого
качествен: качественном качественных
представля: представляет
справочник: справочников
захотел: захотелось
исчерпыва: исчерпывающего
закр: закрыть
стартап: стартап стартапам
туториа: туториал
кабел: кабелей
инач: иначе
приход: приходится приходят
подключен: подключения
патч: патч
правильн: правильно правильной
восстанов: восстановить
называ: называть называется
менеджер: менеджера
компан: компаний компании компания
рассказыва: рассказываем
программ: программы
коммуникац: коммуникация
управлен: управление
проектиру: проектируем
зов: зовите
цепочк: цепочки
допуска: допускаемых
пят: пят
лайфак: лайфак
смысл: смысле смысла
недорог: недорогом
неправильн: неправильное
предполага: предполагающая
стандарт: стандарта стандарт стандарте
привет: привет
стоя: стояла
вс: вс
популярн: популярность
отдел: отделы отдела
рад: ради
начн: начнем
использ: используется используют
простор: просторах
простот: простоту
магазин: магазин
фигурирова: фигурировали
проявлен: проявление
сво: своим
веб: веб
ролик: роликах
кейс: кейс
программирован: программирование программирования
нача: начать начало начали
отдельн: отдельных
зарплат: зарплат
специалист: специалистом специалистах специалистов
рисеч: рисече
порог: порога порог
гик: гиков
передач: передачу
станов: становится
накопительн: накопительных
интернет: интернету интернета интернет
предоставля: предоставляет
реализац: реализациях реализации реализациями
тег: тегов
явля: является
применя: применять применяла
спроектирова: спроектирован спроектировать
пришл: пришлось
полн: полное
администрирован: администрирование
развит: развитая
пользовательск: пользовательских
ди: дие
предусмотр: предусмотрен
питан: питания
сайт: сайта сайтах сайтов
знан: знаний
знак: знак
научпоп: научпоп
технолог: технологий технологии
продолж: продолжим
комментар: комментарии комментария
задач: задачу задачами задачи задач задача
терн: тернии
клиентск: клиентского
рамк: рамки
спаса: спасайтесь
различн: различными различных
сотрудник: сотрудников
хвата: хватает
адрес: адресам адресах
сильн: сильно сильной
работа: работают работает работать
песочниц: песочницы песочница
долж: должен
исключительн: исключительно
кнопкопоклонник: кнопкопоклонников
пар: пару пары
посвящ: посвящена
услуг: услуги
пром: промо
тред: тред
заинтересова: заинтересованным
треб: требует требуется требуют
высококачествен: высококачественных
блог: блог
вин: вина
истор: истории
числ: числу
зовут: зовут
довер: доверия
разрез: разрезе
интерфейс: интерфейсов интерфейса интерфейсы интерфейс
модел: модели
пробл: проблем
сложност: сложности
факт: факт
ещ: ещ
вниман: внимание
посредств: посредством
девайс: девайса
автор: авторы авторов автором
очеред: очередь очередей
чита: читать
лонгрид: лонгрид
решетк: решетки
конфиденциальн: конфиденциальность
положен: положение
подход: подходить
аватар: аватар
защит: защиты
потренирова: потренироваться
долгожда: долгожданным
естествен: естественно
оста: оставшаяся осталось
быстр: быстро
заключен: заключение
нескольк: несколькими нескольких
тик: тики
эксперт: эксперт
благосклон: благосклонно
влия: влияет
прогресс: прогресс
позволя: позволяет
хоч: хочу
рейтинг: рейтинг рейтинга
статическ: статические
портативн: портативного
скорост: скорости
альтернативн: альтернативный альтернативных альтернативного
реч: речь
дом: дом
реш: решил реш
отрасл: отрасли
способн: способны
остав: оставить
объ: объ
стка: сткая
сторон: сторон стороны
поток: потоки
сергеевич: сергеевич
вдохновля: вдохновляли
поддержк: поддержка поддержку
честн: честного честным
реж: режим
ноосфер: ноосферу
снабжен: снабженная
микрозадач: микрозадачи
обм: обмена
библиотек: библиотеки
ид: идеи ид
путаниц: путаницы
опира: опирается
ин: ином
наш: нашу
лайфхак: лайфхаки лайфхак
корутин: корутины
ит: ит
пользовател: пользователя пользователи пользователей
мног: многие
ядр: ядра
полюб: полюбил
люб: любого
тки: тки
плат: платы
язык: языков языках языка
большинств: большинства большинство
план: плане
несложн: несложный
сервис: сервиса сервис сервисов
фактор: факторов
разъ: разъ
зафинал: зафиналим
перенасыща: перенасыщается
свич: свичах
информац: информация информации
застрахова: застрахованы
утомля: утомляло
станисла: станислав
разн: разных
анализ: анализу анализ
замет: заметили
всевозможн: всевозможных
интегрир: интегрируется
люд: людей
отосла: отослан
недосмотр: недосмотр
производител: производителями производители производителей
английск: английскую
год: годом
отталкива: отталкивали
предварительн: предварительное
пакет: пакет
конкретн: конкретно конкретные
интерв: интервью
подсказок: подсказок
ко: ко
обработк: обработка
поговор: поговорим
применен: применения
создан: создания создание
хуж: хуже
собра: собрано
сцеплен: сцепленность
совест: совесть
дворов: дворовый
порожда: порождает
производств: производство
центов: центовую
например: например
любимц: любимцы
финтех: финтех
знает: знает
подготовк: подготовка
инсайт: инсайты
одн: одна
отклонен: отклонения
неизведа: неизведанных
мам: мамы
игнат: игнатьев
ляп: ляпы
широк: широкий
коллег: коллегам
отчаст: отчасти
реклам: реклама
разбер: разбер разберу
презентац: презентациях
вставк: вставки
корпоративн: корпоративного корпоративных корпоративный
рекомендац: рекомендации
тов: тов
потребн: потребностью потребность потребности
запуск: запуска
нативн: нативные
одинаков: одинаково
действова: действовать
инструмент: инструментами
вош: вош
буфер: буфер
огромн: огромные
итак: итак
локализац: локализация
верхнеуровнев: верхнеуровневый
сообществ: сообществах
типаж: типаж типажами
познаком: познакомить
заметок: заметок
заслужен: заслуженно
врод: вроде
уникальн: уникальной
электрон: электронных электронной
микроконтроллер: микроконтроллеров
использован: использование использования использовании
свет: свет
платформ: платформа платформах
запрос: запрос
поскольк: поскольку
потрат: потратить
фиас: фиас
сист: систем
войт: войти
исходн: исходного
октот: октото
ноутбук: ноутбук ноутбуки ноутбуке
качеств: качестве качество
существова: существовало
распредел: распределена
аккаунт: аккаунт
модератор: модератора
марк: маркиев
состав: составить
наскольк: насколько
благодарн: благодарны
онлайн: онлайн
проблем: проблемы проблемами проблема
поспрашива: поспрашивала
сект: секте
поставщик: поставщиков
раздел: разделы
намн: намного
половин: половина
маркировк: маркировки
подростк: подростки
всяческ: всяческие
продума: продуман
склонен: склонение
яндекс: яндекс
новост: новости
лучш: лучшие лучших
заголовк: заголовков
существ: существует
владимир: владимир
перв: первой первую первом
нес: нес
формат: формат
нет: нету
дума: думаю
проведен: проведению
написа: написано
гайд: гайда
поиск: поиск
возможн: возможность возможностей возможных
проброс: проброс
интересн: интересных
оп: опыт
изменен: изменений
молод: молодые
кида: кидаться
прочн: прочно
основ: основе
воспоминан: воспоминаний
обещан: обещаний обещания
голов: голове
образовательн: образовательные
хочет: хочет
как: какие
определ: определ
крупн: крупных крупные
поначал: поначалу
неполн: неполных
канул: канули
голос: голосов
бенчмаркинг: бенчмаркинга бенчмаркинг
роботрон: роботрон
взгляд: взгляд
встреча: встречаются
кошечк: кошечках кошечки
прошл: прошли прошлой прошло
отрицательн: отрицательном
высок: высокая высокой высоких
род: роду
поведен: поведение
респондент: респондентов
реальн: реальным
гаджет: гаджеты
взглян: взгляните
распиновк: распиновка
втор: вторую втором
рол: роль
сфер: сфера
откр: открыть
способ: способен способы способ способом
форм: форме форм
низкоскоростн: низкоскоростных
браузер: браузере браузеры
наход: находятся
компьютерн: компьютерное
опенсорсн: опенсорсных
продукт: продуктов продуктах продукт продукта
рп: рп
kamushken: kamushken
sourc: source
ruvd: ruvds
twitter: twitter
promis: promise
numpad: numpad
altmod: altmode
english: english
mastodon: mastodon
api: api
catch: catch
allsettl: allsettled
vip: vip
python: python
javascript: javascript
node: node
ar: ar
badlittleduck: badlittleduck
experi: experience
habr: habr
jvetrau: jvetrau
object: object
miniwar: miniware
pine: pine
thunderbolt: thunderbolt
bright: bright
js: js
requestanimationfram: requestanimationframe
roadmap: roadmap
youtub: youtube
rss: rss
web: web
markdown: markdown
typescript: typescript
power: power
everest: everest
antora: antora
alizar: alizar
facebook: facebook
virtuallink: virtuallink
gfk: gfk
sharp: sharp
pinecil: pinecil
framework: framework
leono: leono
displayport: displayport
gbiz: gbiz
open: open
usb: usb
dii: diy
dlab: dlabs
newlang: newlang
dmitrysatin: dmitrysatin
lab: labs
dadata: dadata
reactj: reactjs
usbchardwar: usbchardware
dan: dan
mode: mode
cloud: cloud
redcollar: redcollar
ui: ui
forgotten: forgotten
smthels: smthelse
digit: digital
group: group
tech: tech
obsidian: obsidian
thenabl: thenable
ux: ux
requestidlecallback: requestidlecallback
vovalanz: vovalanz
alt: alt
hdmi: hdmi
usabl: usability
translat: translate
arcanum: arcanum
vk: vk
altern: alternate
grokru: grokru
vr: vr
milfgard: milfgard
lanait: lanaite
cad: cad
busi: business
timeweb: timeweb
cam: cam
dialog: dialog
grolribasi: grolribasi
shotmeow: shotmeow
hous: house
linux: linux
await: await
recoveri: recovery
melnikov: melnikov
race: race
telegram: telegram
zoom: zoom
tesnovski: tesnovsky
async: async
deliveri: delivery
ipso: ipsos
pd: pd
wedmashka: wedmashka
bash: bash
rsashka: rsashka
user: user
frontend: frontend
