криптограф: криптография
понима: понимать
расскаж: расскажем
копирайт: копирайт
стат: стать статьи статей приветствую описан
стар: исправляет заменив анализ
мыслен: поговорим
стал: стали
мнен: мнение
се: сей
нелишн: горами
став: ставили
последств: софт
реализова: интерфейсы
работ: механизмов упрощаем отраслях
показыва: показывать
дополнительн: огромное
инфраструктур: производительность
учебн: учебный учебного
основан: сентября
человек: решается
критическ: критических
менеджмент: менеджмент
припоминан: припоминания
каса: публике
топик: топике топика
местоположен: численность
разговор: разговор
то: достигая
тр: выведено
мобильн: браузера
банальн: стиллера
знакомств: анатомия
публикац: предыдущей
скопирова: скопировать
карт: маршрут
устанавлив: заражения
крякнут: сайты
скоординирова: скоординировано
назван: энергоэффективный
котор: исследование
биотехнолог: зал
эксперимент: мысленном
моделирован: информационном
ум: ум
связа: связаны
прав: правами правом
раскро: раскроем
регенеративн: приблизиться
либ: какого
проект: проекты функциях
ушл: неизбежно
при: прием
появля: массово
тревожн: тревожные
избавл: избавляя
упроща: возможностей
профил: профиль
дела: делаем работает
приветств: интернете
постулирова: теории
дипфейк: дипфейк дипфейках дипфейки дипфейков
дискусс: размышлений
вывед: орбиту
читальн: живого
верс: вернуться точнее
позитивн: планете
невооружен: земли
защ: защите
маркетинг: маркетинг
книг: книги
вирусн: простого арсенале
разобра: разобраться
прост: простой значительных старого
врем: древнейших
позвол: ресурсов
зал: читальный
бенефит: бенефиты
лиц: лице лица
скульптинг: биочернила
уровен: уровень
нов: нового новую новые новых сво
придума: злоумышленники
медийн: корпоративный
част: часть
цифров: цифровыми расточительные ушла
опубликова: опубликованы
пригодн: органы
сдела: сделать сделаете
особен: остановимся
сложн: научимся задача
любител: сервисов
примен: применить
выучен: выученное
активн: активности библиотеки
персонал: персоналом
динамичн: фишинг
строительств: архитектуры
невероятн: невероятно
узна: хотим
загадок: загадок
персональн: персональных
труд: трудом
арсенал: инструменте
ресурс: вычислительных ресурса ресурсах
метод: методы метод
машин: вариантов машинное машинного
процесс: процесс
аппарат: одобрения
групп: группа
свойств: свойства
техник: техники
медицин: регенеративная фронтиру
постепен: постепенно
масштабирован: масштабирования
разоблач: разоблачить
актуальн: актуальной днем
продолжа: продолжали
обраща: обращаем
материа: материала
помощ: планеты
эйчар: эйчары
парадоксальн: дискуссий
приложен: мобильного
разработчик: разработчиков разработчики
здоров: здоровье
вычислен: вычисления
опасн: опасности
генеративн: генеративных генеративный генеративного
текст: текст
будущ: будущее
фейнма: фейнмана
мигрирова: мигрировала
разум: тело
выделен: выделенные
аудиокассет: винила
портал: веб
эволюционирова: плоскость
пожал: классических
придумыва: придумывать
положительн: наполненным
рост: рост
мисс: запуск
росс: местоположение
регистрац: дата войти
несанкционирова: несанкционированное
росл: росли
тестирова: тестировали
газ: газа
имеет: сталкиваемся
числен: декабря
мастерств: дощечек
гипотез: гипотеза
цикл: завершаем
гигант: технологические
эффект: эффект
возбужден: возбуждение
кажд: появляться сети
лекарств: лекарство
катаклизм: катаклизм
дзен: мегапроекты
создава: создавать
искусствен: искусственный крупномасштабные
серьезн: привели
загрузчик: взялся
использова: использовать
достаточн: органов
примерн: примерно
сюд: жертвой
настоя: настоящее
список: список
затронул: затронуло
заражен: вероятность методологии
тематик: тематику
след: запуска
напомн: нелишним
дизайн: дизайн
производительн: высокая
изощрен: становится
концепц: фреймворке
отслежива: самостоятельно
оптическ: либо
бэкенд: работу
так: такими вопросами
нашумевш: произведем
уязвим: уязвимостях используют
угна: угнать
техническ: службе языка
хран: хранят
наполн: наполнить
фев: фев
назва: назвать назвали
заметк: заметками
приспособ: приспособиться
собира: собираемой
привлекательн: привлекательной
откуд: мся
извлека: извлекают
некотор: некоторые гиганты
потенциальн: потенциальные потенциальным
пират: пиратов пиратам
зно: зной
количеств: количество
служб: мастерства
соглашен: документы
древн: самых
проектировщик: инженеров
кратчайш: прокладываем
добав: добавить
просмотр: просмотров
стиллер: собрата
услов: дополнительных
объем: объемы
звон: звонит
интеллект: интеллект искусственного
представля: представляет
дирижабл: дирижаблей
анатом: телескопов
виртуальн: виртуальные
друг: другими другого
аппаратн: аппаратного
поня: разум
компан: компанией января компанию компании авторов
рассказыва: инструментария
ограничен: ограничений
программ: первыми образовательные
главн: главной главным
разбира: разбирали
кислород: кислород
воздух: воздуха
соответствен: соответственно
углекисл: углекислого
велик: велик
привел: являются
видеозвонк: видеозвонка видеозвонков
использ: устройство интерфейса
ран: ранее
нын: эксперименте
зарплат: зарплат
гик: гиков
прорывн: прорывным
интернет: интернета плацдарма
зловред: никакой
игров: игровой игровые игровых
тел: влияния
тем: тему
телекоммуникацион: партию
астроном: любителей астрономии
полн: полным
администрирован: администрирование
пользовательск: соответствующее
десят: десяти
питан: питания
знан: базовые
комментар: комментарии
сотрудник: сотрудники сотрудникам
компьютер: цифровые компьютеров вашего
работа: работать загрузчик
детал: деталей рассмотрели
песочниц: авторы
услуг: услуг конфиденциальность
подписчик: подписчики
произвед: зловред
блог: блог
биолог: биотехнологии
фреймворк: знания нескольких
интерфейс: программного погоды пользовательские
чист: чистую
дроппер: вирусный всплеск
сложност: сложности
вниман: внимания
исправля: названием
одобр: составить
маршрут: кратчайший
видн: редко
автор: автор сайта автором хабы
чита: читать
виде: видео
быстр: быстрее
гильберт: парадокс
принима: принимать
предмет: старых
внедрен: преимущества
распространен: распространение пожалуй
печа: медицины
реч: речь
отрасл: внедрения офиса отрасли
общ: общем тр
объ: объем
защища: защищают
возросл: возросли
включ: включая
пропуст: пропустив
повод: поводу
вариац: сложных
продвига: продвигают
лайфхак: лайфхаки
редактор: знакомство
мног: математика
разнообразн: устанавливая
гранд: гильберта
язык: настройка
останов: фреймворков прошлый
натуралистичн: натуралистичности
крупномасштабн: запускать
выдох: выдохов
злоумышленник: изощреннее
гор: следующие
взял: откуда
планет: спутники пребывание
люд: людей
год: годах каждым последние
целев: целевая
лагер: лагеря
конкретн: конкретным конкретную
законодательств: законодательство
физическ: физической
неизбежн: доме
создан: создание
потеря: потерявшая
вывод: вывода
привод: приводило
философск: постулированы
производств: инфраструктура
телескоп: наподобие
одн: прослеживается особенностях деталях
продаж: эпохи
мар: мар
реклам: медийная
разбер: разбер
настольк: настолько
корпоративн: услуги
прив: прив
избалова: избалованная
дощечек: аудиокассет
расширя: чип
инструмент: инструменты инструментов появившемся
распространя: вирусов
издател: издателей
всасыв: всасывая
врод: вроде
десятк: десятки
использован: реализованы
платформ: платформ популярных
запрос: использующим
союзн: бывших
сентябр: регистрации
войт: аккаунт
массов: музыки
процессор: электроники
аккаунт: представитель
эмоц: положительными эмоции
марк: биопринтер
состав: группировки
глаз: невооруженным
деятельн: деятельности
накаплива: накапливается
смартфон: компьютера
подробн: угроз
бот: ботом
вполн: достичь
выража: выражается
яндекс: вызывает
новост: новости
существ: существуют
перв: первые возникла
пиратств: пиратство пиратства
приня: принять
поиск: поиск
изменен: переходить
запомн: запомнить
основ: основе
ритм: ритмы
пиратск: отеле
образовательн: нативные
как: какую какие смартфона
участник: участников
определ: котором
голос: голосов
содерж: крякнутым
расточительн: точности
тся: тся
прошл: прошлого редактором
высок: расширяет
реальн: определим реальными глазом реальном
обход: обхода
точн: отношение
точк: точки
сфер: задач
мертв: мертвы
способ: способы
мер: меры
браузер: интерфейс
компьютерн: компьютерные компьютерных
ретроспектив: ретроспектива
продукт: продуктам
жертв: делать
посчастлив: посчастливится
влиян: принципы
информацион: информационная рассказываем
образ: образами
заверша: й
конц: конце
предлага: предлагать
обзор: обзор
электроник: производство
появ: моделировании появились
наподоб: оборудования
запуска: позволяя
доступ: доступе
мозг: мозг мозга
вернут: поддержка
бесконечн: эмоциями
предел: известно бесконечность
принос: развита
рюкзак: рюкзаках рюкзаке
бригад: большим
вообщ: вообще
и: ии
приблиз: вполне
й: звук
л: л
изменя: изменять
ожида: одобрено
зазвенел: зазвенели
х: х
навея: навеянные
техподдержк: техподдержки
логическ: статья
поэт: места
зафиксирова: миру
мин: мин
диагноз: диагноз
вариант: простейших
памят: памяти
мир: мир августе
чересчур: чересчур
исследован: небольшое
безопасн: безопасность
орга: сложные
резк: зафиксировали
классическ: классической актуальными
вдох: вдохов
провед: порталы
получ: миссия
разгадыва: исследователи
публик: видна
перевод: перевод
декабр: основания
час: часа
чат: чат
задачк: задачки
сбрасыва: сбрасывают
индустр: индустрии
отел: гранд история
парадокс: известном
уместн: уместные
больш: большие больших большой строительства
софт: пиратский статье
миллиард: миллиарда
повторен: повторение
потенциа: свой
мест: хватило
счет: обозначение
карьер: карьера
инженер: инженера архитекторов
офис: крыльце
игр: игры игр играх разнообразить
полезн: полезную
накоп: времен
причудлив: причудливую
пуга: пугающей
эффективн: эффективно эффективные
редк: планы
генерац: генерации
ост: оста
дешифровк: дешифровки
методолог: развитии
лиценз: покупку
пыта: пытается
момент: потенциал момента
органичн: органично
основн: распознавание
лестниц: ступеньки
синапс: синапсах
сможет: сможет
математик: отеля
основа: основанную
решен: решения
мгновен: мгновенно
высококлассн: работа
средн: средний
устаревш: устаревших
меня: меняется
далек: ещ
хаб: разделы
добив: добиваясь
востребова: распространенных
результат: результате ощутимые
вызыва: карты приложения
наполнен: позитивным
обозначен: получила
настройк: дзен
дал: далее
пониман: пониманием
последовательн: последовательное
документ: компаний
прочтен: прочтение
ссылк: ссылку
интервальн: интервальное
взрывн: взрывное
дан: данные данных
дат: аппаратов сайт
состоя: состоялся
подменя: подменять
хват: банально
технологическ: технологических активно
функц: расширенных
биочерн: компьютеры
мся: дроппера
вирус: нашумевших
предлож: предложены
достиг: устройствах
звук: музыку
возника: возникают
незакон: незаконное
зараз: придумают
разбор: дроппер
покупа: покупала
чип: новый
достич: пределов
жив: живых скульптинг
обнов: обновить
объект: космические
несет: несет
разработк: разработка
закладк: закладки
увидет: машинами
продолжен: логическим
занимательн: занимательные
программн: версиям программное
поколен: поколения
спутник: спутников телекоммуникационных объекты
плоскост: цифровую
совершенств: совершенства далека
преимуществ: проектирования
укладыва: республик
стольк: столько
вопрос: вопросу парадоксальными вопросом таких
трансплантац: пригодные
устройств: небольших заразить
размер: размер
переход: настала
энергоэффективн: процессоры
ваш: помощью ваших
двигател: двигателем
размещ: размещу
ответ: ответ
москв: москве
усил: усилия
несмотр: несмотря
сталкива: туториал сталкиваются
покупк: требующими
проектирован: концепция
антипиратск: антипиратское
копирован: копирование
измен: измениться трансплантации
предсказыва: предсказывали
алгоритм: алгоритмы алгоритмов
разнообраз: остановились
август: разбор
расширен: некоторых
смех: смех
материал: цикл материалом
мегапроект: стартапам
хабр: хабре хабр
пишут: пишут
обучен: обучения обучение
отношен: отношении имеет
куп: купить
наста: предмета
квалифицирова: квалифицированных
собрат: подробного
практик: практике
последн: ним одну
хил: хилых
клеток: клеток
фишинг: уязвимости
сам: самые вопросов
дыхан: дыхание дыхания
стартап: программы
туториа: программирование
инач: иначе
задава: задаваться
подобн: подобные
вероятн: реальную
гост: бригады
управлен: управление управления
точност: той
стресс: стресс
распознаван: распознавания сферы
орбит: счету
заключа: заключалось основная
раскроет: медицина
начина: начинают начинали
очередн: запустила
популярн: одним популярное популярнее популярные
вс: результаты
прогноз: узнать
биопринтер: биология
научн: серьезным научно многие
лазейк: одна
сво: кряки раскроет
веб: распространялись
программирован: бэкендом
нача: начали
частот: частота
реша: легко
специалист: специалистов
станов: становилось годом технического
перспектив: перспективам
замеча: замечаем
значительн: требует
кряк: разнообразные
парт: очередную
возникл: лазейка
явля: является условий
появлен: появлением появлению
зарожден: зарождения
ощутим: приносить
развит: достаточно динамичном развитие
сайт: лицензии информация песочница
обеспечен: обеспечения обеспечение
оборудован: оптического
научпоп: научпоп
продолж: продолжим
технолог: технологию марки технологиям технологий технология
задач: задачами задачей задачу задаче задачи востребованных заключается
обществен: общественность
происход: происходит
дц: дц
неочевидн: изменениям
посвящ: посвящен
базов: проектах
треб: человеком программами
вин: продаж
инструментар: касается
метаболизм: метаболизма
истор: краткая
зрен: зрения
ход: ходе
пробл: проблем старую
факт: факт
ещ: вс
гибк: гибкое
сер: серь
легк: вариациях
вид: видами
сет: софта
представител: россия
конфиденциальн: соглашение
чтен: чтение
защит: защиты
навсегд: навсегда
всплеск: резкий
доход: доходов
чуд: чудо
теор: научные
науч: момент
нескольк: использованием
одобрен: ожидает
влия: влияют
хот: запросы
позволя: позволяют позволяющие
памя: память
эпох: эволюционировало
конск: конских
рейтинг: рейтинг
дом: каждом
способн: способных
известн: совершенству ныне
поток: потоки
кратк: предел
поддержк: техническая
глубок: глубоких
принцип: работы
библиотек: платформой
пуст: пусть
дож: дожить
организм: организм
предыдущ: анализа
наш: нашего наших
возьм: возьм
днем: становятся
республик: союзных
ит: ит
биопринтинг: технологии
разрабатыва: проектировщиков
план: разрабатывающих
сервис: реально
информац: информацию сюда информации
описа: поэтому
подделок: подделок
облачн: облачные
группировк: общий
земл: увидеть
выгляд: выглядит
анализ: последствия продолжением
берег: берега
замен: игру
погод: прогноз
требова: требовало
обработк: обработки обработка
поговор: открытиям
запоминан: запоминания
крыльц: лестницы
самостоятельн: напомнить
увеличен: увеличение
запуст: компания
запуск: спутника дате
соответств: вызывают
нативн: реклама
масштаб: масштабах
физиологическ: физиологическое
надежн: надежное
огромн: накопилось
музык: материалов изменившие музыка
рассмотрел: публикации
архитектор: высококлассных
вод: воду
ступеньк: укладывающие
обнаружива: обнаруживали
пищ: пищи
январ: астрономия
мо: моем
консол: консолей консоли
сист: систем
прокладыва: яндекс
вычислительн: нехватки
нехватк: проблему
онлайн: онлайн
размышлен: философских
прослежива: заражений
проблем: проблемы проблемой проблемами проблема
обнаружен: последних
сервер: серверы
поставщик: поставщики
раздел: регистрация
автоматическ: автоматически
звоночк: звоночки
исследовател: годы
угроз: обнаруженных
видеоконтент: видеоконтента
лучш: лучшие
механизм: разгадывать
космическ: отслеживать
орган: печать
небольш: интеллекта проведем
желательн: желательной
относ: биопринтинга
облегч: облегчили
пойдет: пойдет
возможн: возможности неочевидных возможно
интересн: интереснее интересную
открыт: научным
пребыван: поняли
крупн: крупнейших
фронтир: относят
затеря: затеряться
круз: круз
бывш: гостей
архитектур: отрасль
прежн: прежнему
изображен: изображений изображения
контент: контента
откр: открыть
криптографическ: криптографических
потер: потере
плацдарм: вирусного
никак: содержится
big: big
truebot: truebot
data: data
hilbert: hilbert
usb: usb
bim: bim
skyrim: skyrim
microsoft: microsoft
gov: gov
twitter: twitter
deepfacelab: deepfacelab
gtd: gtd
api: api
drm: drm
gismeteo: gismeteo
python: python
evid: evidence
stealer: stealer
inbioreactor: inbioreactor
deepfak: deepfake deepfakes
magichappen: magichappens
real: real
itu: itu
uprightman: uprightman
vidar: vidar
starlink: starlink
vk: vk
envisiontec: envisiontec
uelk: uelkes
http: http
habr: habr
firstvd: firstvds
explor: explorer
engin: engineering
virtual: virtual
ru: ru
netflix: netflix
firstjohn: firstjohn
uber: uber
youtub: youtube
rss: rss
peter: peter
web: web
kit: kit
faceswap: faceswap
sigaba: sigaba
steam: steam
chatgpt: chatgpt
live: live
creation: creation
phanerostroi: phanerostroi
mysterytwist: mysterytwister
neurram: neurram
facebook: facebook
klimenski: klimensky
telegram: telegram
jack: jacking
raccoon: raccoon
fastapi: fastapi
time: time
