максимальн: описывается
сдает: песен
ру: учи
оценк: шкала
банк: кредитный
расскаж: расскажу
рассказ: частью начинаем
образ: комфортного иным
стат: стать серии статье статьи интересную равнодушны
стар: вернуться
конц: конце
св: интерфейса
найд: разработчику
мнен: сбермаркет
карямин: михаил
маленьк: подсказки
обзор: обзор
см: воркера
появ: впервые
случа: фронтенд краевые
реализова: ресурсов
повторя: раза
един: согласны
работ: работа выстроить работе работы
запуска: образом
показыва: показывают показывать
дополнительн: прогресс подключаться
доступ: токена
арт: реактивного
наряд: наряду
вернут: поддержка
парадигм: гибкой
сч: труднее
сто: результатов стоит
приятн: приятные
критическ: кэширования
наставничеств: наставничеством
д: пользовательского
янв: детали
менеджмент: менеджмент
интеграц: интеграции
докат: рассказать
вкратц: вкратце
личност: сильной
привлек: внимание
публикац: разделы
скопирова: скопировать
дава: чуваки
означа: улучшения
краев: любые
поэт: поэтому
котор: апи которыми
времен: сократить
переподписок: условных
мин: мин
вариант: вариантов различным привлек
памят: утечке
приложеньк: зно
мир: влияет
писа: устали
отписк: потоках
прав: правило
этап: принимаем
мкб: собеседовались
уч: нужны
либ: переиспользованием
скор: место
проект: подходов проект маленьких проектами нативные
лид: лидия
вперв: версии
упроща: функции
профил: профиль
ооп: ооп
дела: простота
столкнут: столкнуться
кэширован: посредством
получ: получит используя повода
документац: официальной
режим: данным
устоя: нашем
публик: публикую
перевод: микрофронтенды перевод
затрудн: надежного
фронт: многих
верс: старую ру
важн: критически
шкал: разработана
маркетинг: маркетинг
книг: книги книге
списк: списке
комфорт: ним
рук: руки
прост: простое реализации простой разработку
прием: приемов
индустр: карьера
занима: занимается
каталог: приложенька
могл: комфортом
подписк: управление
движен: движением
уровен: уровень
очевидн: почитать
нов: пилили статей появление новые компонентов
внешн: внешних
медийн: корпоративный
мест: третье
част: части программирование частей руководство
иде: идеями
ждат: ждать
устро: безумия
карьер: банк
слов: подписками вдохновлялись
микрофронтенд: номер рассказа заблуждений
поудобн: усаживайтесь
полезн: полезных полезные
мультиязычн: мультиязычных
модифицирова: ответы
сдела: упростить сделано
определен: д
эффективн: самую
видет: привыкли
устанавлива: компания
доставля: устроены
сложн: сложный простых
дают: справляется
представлен: представленных
капот: крутятся
любител: фреймворком
совет: советы
примен: применить
пут: пути докатились
работодател: среди
жизн: образа
идт: ужасно
подключа: которое
переиспользуем: рассматривается
хранилищ: хранилищ
аутентификац: реализовать
куск: экзамены
лиценз: лицензии
отклик: отклик
лишн: убрав
труд: рынок
основн: основном
трудн: вс
сможет: подумал
ресурс: важных
миха: дефолтных
скрыва: скрывается
утечк: отписках
решен: решение проекта
требован: устанавливает
нных: влюбл
написан: выбором
провод: проводит
арутюня: арт
средн: средний
личн: личные конкуренция
комфортн: зарплат
живет: следующее
нужн: пригодится
ужасн: знаю
номер: интересное
обраща: обращался
влюбл: получим
подряд: подряд
хаб: публикации
материа: материал
повыс: факт
помощ: помощи помощью
современ: современный современная
кредитн: московский
востребова: стимул
приложен: серверных сервере приложения
интернационализац: интернационализации
разработчик: разработчикам облегчают выросли очевидно разработчик
результат: удивительных
вызыва: тема
чувак: техлид
опыт: наших
программирова: требуют
вычислен: зависимых
рынок: факторов
реализу: реализуем
ваканс: лучших вакансий
настройк: дзен
вклад: сюда
дал: далее
текст: текста
контекст: отдельном
богат: богатые
пониман: капотом
последовательн: последовательно
сортировк: сортировки
документ: компаний
прочтен: прочтение
фронтэнд: фронтэнде
ссылк: ссылка ссылку
наоборот: ситуация
серверн: фреймворке
зата: давайте
задел: реактивное
затащ: затащить
навык: перенасыщается требования
спокойн: ознакомиться
экзам: сдает
выросл: специалистов
грамотн: наблюдения
прочита: днях
интерес: интересует интересуется
конкуренц: повысилась
прокс: рода
дан: данный данными хранимым
программист: хочет оценки
фильтрац: фильтрации
пагинац: пагинацией
наслуша: наслушавшись
положительн: положительный
подавля: вычислений
код: код коде куски
паттерн: паттерны паттернов
осман: османи
ладн: второе
задумыва: поскольку
найдет: слову
регистрац: аккаунт
сократ: этапе
ситуац: ситуациях считаю
имеет: имеете потоке
найден: главное
генератор: фреймворк
счита: считается лично
отсутств: функциональным
функц: появились
упрост: максимально
внесен: хранение
привяза: остаемся
загрузк: увеличения
цел: мир
изуча: арутюнян
кажд: навыкам должен единого
техлид: пришел
асинхрон: мощная
амбиц: жизни
пройд: найдете путь
настро: настроить
дзен: яндекс
остров: архитектуры
множеств: множестве
любовн: статья
коммерческ: коммерческими
преподавател: преподаватель
создава: создавать
микровселен: состояния
кажущ: кажущейся
обнов: обновить
разработк: разработкой разработке сфере разработка затраты
серьезн: серьезность
закладк: закладки
использова: использовать
разработа: третьей мегапроект
прекрасн: одним
грейд: прикинуть
логик: писать либо
желез: копаться
программн: программного
поколен: нового
заня: недавняя
достаточн: достаточно
руководств: полное пройдемся моим
пройт: мкб
почита: архитектурах
добавля: добавлять
стимул: дополнительный
заблужден: распростран
сюд: руководством
настоя: островов
список: список
пост: посте
итог: работодателей
замечательн: замечательной
минут: минут
след: следующие означает следующей
слышн: нейросеть
строк: строк
дизайн: дизайн
рассказа: рассказано развеять
производительн: производительности
бюджет: трат
заверш: сможет
устройств: информация
пришел: утром
клиент: хранения посредник имеет
ваш: вашему
распростра: одно
так: такую такими отображения задумывался
изучен: изучении
ответ: запросы
поменя: опыта
недавн: задела
проектирован: проектирования
сталкива: сталкивается
собствен: собрал
адаптирова: адаптированный
техническ: технический языка
манипулирован: манипулирования
условн: случаи
мощн: является
алгоритм: найденный
фев: фев
заметк: заметка
товар: заказом
мегапроект: стартапам индустрии
описыва: редакторы
хабр: хабр
некотор: некоторый
вебсайт: вебсайтов
рассмотр: подробно
подума: кода подумайте
утечек: работу
зно: серь
удивительн: добился
количеств: количество
воркер: сервис использованием
соглашен: документы
полез: полезен
ап: уместив
храним: клиент
добав: добавить
просмотр: просмотров
последн: последнее
умест: сто
покрыва: фундаментально
друз: друзья
зна: программировать
услов: условиях
сам: самое написал самых
представля: представляю
настраива: гибко
друг: другими
стартап: программы
туториа: нспк
инач: иначе
рендеринг: обеспечивать рендеринга
реактивн: реализацию эффективную изучаю
называ: разрабатывать
менеджер: менеджер
компан: компании итоге сайта
программ: железе образовательные
управлен: сервера асинхронного
главн: адаптеров
компьютерщик: праздник
фундаментальн: алгоритм
глитч: дают
сфокусирова: фичи
обеспечива: статических
фич: лишние
смысл: идти
элемент: загрузки
предполага: предполагается
начина: поудобнее
привет: привет
поможет: тест
состоян: написания реактивных управления
айнур: айнур
популярн: популярных
вс: становится
покаж: покажу
начн: начнем
использ: используется библиотеки используются использую
простот: простотой состоянием сфокусировавшись
раз: логику
созда: создаю
поэкспериментирова: простоте
сво: свой
веб: веб
кейс: воркере
программирован: переводили
отдельн: запускается
влюблен: празднует
зарплат: высоких
специалист: навыках потребности востребованным
порог: порог
станов: войти
предоставля: возможности
тест: уровне
хранен: вариантам основе удобным
московск: найди
реализац: написать усложнения
явля: инструментов
появлен: видеть
колоссальн: элементов
туториал: туториале
тем: тему несложная
официальн: руководствам
полн: решить
администрирован: администрирование
консультант: консультант
пользовательск: отсутствии конкретной
дефолтн: экосистеме
сайт: янв устройство сайтов
агностическ: получили
обеспечен: обеспечения
выстро: грамотно
научпоп: научпоп
технолог: технологию
комментар: комментарии
файл: файлах
посредник: св
праздн: мнение
тренинг: тренинги
трех: трех
различн: различных посвященную
трет: заняла предоставляемые
нейросет: написанный
прош: прошу
компьютер: нных
работа: работают работаю работает могли библиотеку работаем работающий
сильн: специалистом
песочниц: хабы песочницы
сегодняшн: сегодняшний
долж: хранением
подсказк: всплывающие
услуг: конфиденциальность
переиспользован: компонентами
треб: требует разработчиков
усложнен: затруднить
блог: блог
фреймворк: новом языкам работающую новых агностический
зовут: зовут
истор: истории
автоматизац: автоматизация
интерфейс: интерфейсов интерфейсы применения
праздник: профессиональный
модел: модель
пробл: проблем
сложност: сложности
ещ: ещ
факт: нету
вниман: вниманию мое
гибк: использования переиспользуемого
перехватыва: позволяет
офлайн: режиме
посредств: офлайн
автор: авторы авторов автором
функционал: функционалом
сер: часть пиццу
чита: читать
легк: легким
убра: состояний
конфиденциальн: соглашение
локальн: локальную
подход: парадигмы см
сбермаркет: любим
экосистем: экосистемы логики
оста: приложение разработки
обеща: фреймворков
благосклон: наоборот
влия: благосклонно
прогресс: порождает
принима: решения
позволя: позволяющей сервер
неоднократн: неоднократно
рейтинг: рейтинг рейтинга
статическ: генератор
реч: речь
реш: повторяется ладно решила
общ: пройти
сторон: рендеринг
поток: контексте слов потоки
поддержк: встроенной техническая
вдохновля: разработчики
остальн: любителям
глубок: глубокой
одностраничн: называемые
доб: поэкспериментировав
предназнач: предназначены
профессиональн: влюбленных
библиотек: библиотеках фреймворкам взял библиотека библиотек пишет библиотеке
повод: совместить
удобн: сделать
сред: уровня
комплексн: комплексную
учебник: учебника
ин: модифицировать
наш: новый определения
лайфхак: лайфхаками
редактор: контент
мног: вызывает
посвящен: статью
уста: поколения
люб: затащим компьютеры покрывает
зависим: переподписок
компонент: настраиваемого создание упрощают
язык: письмо настройка
большинств: подавляющее
заказ: каталогом
затрат: временные
разрабатыва: поддержкой
несложн: взгляда
таблиц: таблицы таблицами
сервис: доступа
фактор: программистом
перенасыща: труда
информац: песочница
фронтенд: карямин
совмест: компьютерщика
безум: микровселенная
продакш: продакшен
письм: любовное
взял: основу
прогрессивн: одностраничные
трат: колоссальных
собеседова: грейд
год: каждым
использу: поменялась
пакет: пакет
пес: слышно
нюанс: общие
конкретн: привязанными
сборк: сборку
равнодушн: использует
подсказок: всплывающих
обработк: обработки
применен: способе
создан: создания личностью
встроен: точнее
собра: катом
хук: хуке хуком хуков хуки
адаптер: дополнительных
развея: постараюсь
идет: идет
прикинут: поможет
порожда: целом
знает: знает
постара: доросли
одн: одна товара стеке
мар: мар
целик: сайт
согласн: программистов
наблюден: собственные
увеличен: утечек
реклам: медийная
корпоративн: услуги
штатн: штатный
потребн: амбиций
соответств: соответствующий
нативн: реклама
усажива: пройден
шаблон: шаблоны
распространя: распространяется
инструмент: сложных
доклад: докладов доклады
огромн: огромное
ток: внесение
надежн: простого
команд: команды команда
произвест: обещают
ознаком: микрофронтендах
стек: устоявшемся
всплыва: рассказ таких
использован: вариант использовании подход нюансы
уровн: каждом каждого
мо: завершить клиенте
нспк: памяти
запрос: перехватывать
поскольк: использование
включа: включает
облегча: случаях
войт: годом
сидел: спокойно
пригод: возможно
пил: сидели
аккаунт: вакансии
табличн: табличными
глаз: глазу
дета: интересны
выбор: выбора желанным
эдд: эдди
проблем: проблемы
репозитор: репозиторий
подробн: пользовательский документации
сервер: стороне прокси клиентом живет
раздел: регистрация
пицц: доставляет
пишет: программах
жела: делает
яндекс: мегапроекты
новост: новости
лучш: вклад лучшие
перв: первой туториал
холл: холли
нет: смысла
написа: подсказок решил целиком
поиск: поиск
изменен: изменений
возможн: рассмотрим остальных возможностью
интересн: глитчи интересно интересной прочитал разработаем
оп: опыт
дальн: дальнейшей
доросл: микрофронтендов
основ: аутентификации бюджета
ленив: ленивый
привыкл: настоящее
отображен: компонента
утр: прекрасным
образовательн: проекты
хочет: специалистах
как: каких какие
функциональн: остается
опублик: опубликую
голос: голосов
крут: библиотекам
содерж: содержится содержит
кат: кат фронте
рассматрива: проектов
взгляд: взгляд первого
прежд: прежде
днях: кейс
род: сервером
высок: сч
копа: любит
втор: скорее
добавл: добавлен
архитектур: понимание подробнее
точн: приложений
контент: работать
улучша: улучшаю
сфер: революцию
откр: открыть
способ: таком
насмотревш: насмотревшись
революц: произвести
справля: большинство
улучшен: прогрессивного
источник: источник
big: big
css: css
ruvd: ruvds
rikki: rikki
ssg: ssg
tooltip: tooltips
react: react
comerc: comerc
jarvi: jarvis
enhanc: enhancement
twitter: twitter
hook: hooks hook
ssr: ssr
dev: dev
alexeyk: alexeyk
friend: friends
api: api
plat: plat
lighthous: lighthouse
worker: worker
jqweri: jqwery
boumrz: boumrz
app: apps
modul: module
artalar: artalar
kashei: kashey
manag: managers
javascript: javascript
benchmark: benchmark
junior: junior
noncommerci: noncommercial
senior: senior
davidaganov: davidaganov
node: node
insight: insights
otu: otus
angular: angular
openai: openai
useinsertioneffect: useinsertioneffect
spectrum: spectrum
nativ: native
experi: experience
creativ: creative
singl: single
habr: habr
traine: trainee
programm: programm
feder: federation
remix: remix
ji: ji
tabl: table
engin: engineering
reatom: reatom
librari: libraries library
access: access
dom: dom
ru: ru
simbirsoft: simbirsoft
aio: aio
pattern: patterns
js: js
roadmap: roadmap
youtub: youtube
rss: rss
vite: vite
pahan: pahan
web: web
kb: kb
typescript: typescript
graphql: graphql
cc: cc
sbermarket: sbermarket
intern: international
difuk: difuks
facebook: facebook
viktor: viktor
systemj: systemjs
gzip: gzip
store: store
lead: lead
token: token
googl: google
report: report
progress: progressive
dodo: dodo
redux: redux
cooki: cookie
vue: vue
extern: external
reactj: reactjs
cloud: cloud
mode: mode
vuej: vuejs
webpack: webpack
mf: mf
html: html
vitest: vitest
tech: tech
ef: efs
pagespe: pagespeed
ux: ux
varanio: varanio
chrome: chrome
rail: rails
vd: vds
translat: translate
felix: felix
servic: service
astro: astro
nc: nc
vk: vk
singlespa: singlespa
http: http https
fe: fe
timeweb: timeweb
jsonwebtoken: jsonwebtoken
common: commons
shotmeow: shotmeow
pespa: pespa
queri: query
json: json
recoveri: recovery
mrcheater: mrcheater
tikki: tikki
svelt: svelte
middl: middle
usesyncexternalstor: usesyncexternalstore
rxj: rxjs
gmtd: gmtd
attribut: attribution
telegram: telegram
npm: npm
qmzik: qmzik
jest: jest
form: form
maxfars: maxfarseer
user: user
frontend: frontend
rubi: ruby
