максимальн: максимальной максимально
готов: готовится готово
найт: найти
провер: проверить
отформатирова: отформатировал
криптограф: криптографии криптография криптографию криптограф
информацион: информационная
расскаж: расскажем
оттуд: оттуда
мерчант: мерчанты
рассказ: рассказ
значен: значение
стат: стать статью статье статьи статей
стар: старая старую старые
вводн: вводная
федеральн: федерального
рабоч: рабочая рабочие
учет: учетом
дорог: дорогой
стал: стали
мнен: мнение
подписант: подписанта
таргетирова: таргетированной
появ: появиться появилась
случа: случаев случаю
реализова: реализована реализовать
работ: работе
частичн: частичные
показыва: показывать
дополнительн: дополнительный
доступ: доступа
мозг: мозг
вернут: вернуться
парадигм: парадигме
сетев: сетевых
прошлогодн: прошлогоднего
рюкзак: рюкзаках рюкзаке
сто: стоит
сошл: сошлась
обновлен: обновление
пробеж: пробежимся
приятн: приятно
гкост: гкость
тд: тд
критическ: критически
послед: последующего
децентрализова: децентрализованного децентрализованные
д: д
схем: схема схемы
янв: янв
вообщ: вообще
менеджмент: менеджмент
ветр: ветра
л: л
топик: топике топика
арм: армии
госорга: госоргана
н: н
тр: тр
п: п
банальн: банальную
централизова: централизованные
публикац: публикации
скопирова: скопировать
дава: давал
означа: означает
ненужн: ненужно
х: х
навея: навеянные
беспокойств: беспокойства
поэт: поэтому
котор: которое которым
выгрузк: выгрузка
мин: мин мина
вариант: вариант
мир: мир
мальчик: мальчик
осен: осенью
съемн: съемный
миф: миф
ящик: ящика
свят: святым
шаг: шаг
совершен: совершенно
идеальн: идеальным
участвова: участвовал
доста: достался достать
нестандартн: нестандартного
связа: связано
безопасн: безопасных безопасностью безопасность безопасны безопасности
проверя: проверяем проверял
подписыва: подписывают
диск: диск диске
проект: проекты проекте проектами
связ: связи
заб: забыть
приватн: приватного
классическ: классической классические
относительн: относительно
опас: опасен опасаясь
профил: профиль
дела: делаю
сообщен: сообщения сообщений
приветств: приветствую
фз: фз
получ: получить
документац: документация
подтвержда: подтверждающие
объявлен: объявление
перевод: перевод
верс: версии версию версия
важн: важного важную важных
маркетинг: маркетинг
авторизова: авторизоваться
книг: книгу книги книге
маршрутизац: маршрутизации
декабр: декабре
национальн: национальный национальным
час: час часа
нност: нности
прост: простой простые
трафик: трафика
нно: нной
задачк: задачки
десктопн: десктопный
псал: псалом
занима: занимаюсь
постквантов: постквантовые постквантовых
удержа: удержать
уместн: уместные
встрет: встретить
уровен: уровень
нов: новые новый
обошл: обошла
умеет: умеет
нод: ноду
больш: большие
софт: софт
медийн: медийная
мест: место
дилетантантск: дилетантантский
файлов: файловые
планомерн: планомерно
част: часть
игрушечн: игрушечный
подделк: подделки
опубликова: опубликовал опубликованы
устро: устроено устроены
йен: йеном
слов: словах
шифрован: шифрованием шифрования шифрование
портирова: портировал
энд: энди
двоичн: двоичной
постоя: постоянно
нны: нные нный
определен: определенной определенные
гомоморфн: гомоморфное гомоморфным гомоморфного
сдела: сделать
отда: отдал отдали
досуг: досуге
сложн: сложный сложно
восхища: восхищает
генерац: генерация
примен: применить применили
ост: оста
жизн: жизни
пример: примере пример
дешифровк: дешифровки
квантов: квантовые квантовых квантовым квантовой
хранилищ: хранилищ хранилища
бернхардт: бернхардт
аутентификац: аутентификация
сформирова: сформированные
систем: системы
процедур: процедуры
интегриру: интегрируем
мог: могу
упрощен: упрощениями
трудов: трудового
расшифровк: расшифровки
узна: узнать
пропуска: пропускайте
государствен: государственного
загадок: загадок
момент: момент
формулировк: формулировке
лишн: лишним
трудн: трудно
основн: основному
вышл: вышло
обрабатыва: обрабатывать
категор: категории
ресурс: ресурса
математик: математика математиков
сша: сша
метод: методы метод
процесс: процессе процесс
основа: основанную
свойств: свойство
хеллма: хеллмана
почт: почты почта
окружа: окружает
решен: решения
доказательств: доказательства доказательство
требован: требованиям требованиями
постепен: постепенно
нных: нных
хотел: хотелось хотел
передава: передавали
средн: средний
личн: личные
домашн: домашней
случайн: случайных случайно случайности
подряд: подряд
бесплатн: бесплатно
хаб: хабы
бэкап: бэкапов
нрав: нравится
современ: современный современные
помощ: помощи помощью
мемпул: мемпула
востребова: востребованы
любл: люблю
приложен: приложение
неравенств: неравенство неравенства
разработчик: разработчики
вычислен: вычисления вычислений
попытк: попытки
настройк: настройка
опасн: опасно
вклад: вклад
дал: далее
текст: текст
крис: крис
документ: документы
прочтен: прочтение
увер: уверены
ссылк: ссылка ссылку
крив: кривых кривой
рассчитыв: рассчитывая
выделен: выделенного
спокойн: спокойно
криптоанализ: криптоанализ
выросл: выросло
ключ: ключи ключа
интерес: интересов интерес
средств: средство
дан: данными данных данные данный
посторон: посторонний посторонних
битн: битные
биометр: биометрия
раскрыт: раскрытия
состоя: состоящие
закон: закону законная законное закона
изложен: изложение
станет: станет
код: код
помогл: помогли
росс: россии
регистрац: регистрация
объяснен: объяснение
раскрыв: раскрывая
слив: сливах
коп: копии
киберкриминалистик: киберкриминалистикой
ситуац: ситуации ситуацию
генератор: генератором генератор
функц: функции
заменя: заменять
цел: целом целей
белл: белла
цен: ценой
отменя: отменял
изуча: изучать
граал: граалем
самописн: самописных
увид: увидит
головоломк: головоломками
рядов: рядовых
незакон: незаконная
компрометир: компрометирующего
эп: эп
дзен: дзен
сохран: сохранить
канал: каналы
множеств: множество
взаимодейств: взаимодействия
рассчита: рассчитан
минимум: минимум
вмест: вместо
финансов: финансовой
параллельн: параллельно параллельное
обнов: обновить
раздава: раздавать
разработк: разработку разработка
закладк: закладки
частност: частности
использова: использовать использовали
разработа: разработать разработаны
логик: логики
имуществ: имущество
роадмэп: роадмэп
кафедр: кафедры
стара: стараются
занимательн: занимательные
многочислен: многочисленных
установл: установлена
загрузочн: загрузочную
достаточн: достаточно
кулер: кулера
почита: почитать
резервн: резервное резервные
изнутр: изнутри
сюд: сюда
список: список
пост: посте
сказа: сказано
паразитическ: паразитическим
рекомендова: рекомендованные
неопредел: неопредел
кладовк: кладовку
обеспеч: обеспечить
институт: институт институтом
дел: дела
вопрос: вопрос вопросу
концепт: концепт
дизайн: дизайн
взлом: взлому
рассказа: рассказать
производительн: производительность
пошагов: пошаговую
неформальн: неформальный
развенча: развенчать
устройств: устройство
попробова: попробовать
размер: размеры
обфускац: обфускации
текстов: текстовые
обезопас: обезопасить
подгрупп: подгруппы
клиент: клиентов клиент
неудачн: неудачные
ваш: вашу
так: таких таки
размещ: размещу
никт: никто
москв: москве
нормальн: нормальную
полност: полностью
несмотр: несмотря
уязвим: уязвимость уязвимости
угна: угнать
недавн: недавних
событ: событиями
собствен: собственных собственная собственный собственного
копирован: копирования копирование
расч: расч
баз: базе
техническ: техническая
хран: храните хранят
оплат: оплату
контролирует: контролируете
уда: удал
стойк: стойкой
алгоритм: алгоритмах алгоритм алгоритмы алгоритмов алгоритма
фев: фев
заметк: заметки
поднима: поднимается
мегапроект: мегапроекты
целостн: целостность
хабр: хабре хабр
передов: передовой
формул: формул
смел: смело
некотор: некоторыми некоторые
отношен: отношениям отношениях
оберега: оберегаем
рассмотр: рассмотрим
иска: искать
потенциальн: потенциально
обща: общаться
флешк: флешку
разглашен: разглашением
количеств: количество
соглашен: соглашение
умерш: умершего
разлага: разлагаться
добав: добавить
посмотрет: посмотреть
постановлен: постановлении
просмотр: просмотров
мысл: мысль
обсто: обстоят
ряд: ряда ряд ряде
посмотрел: посмотрел
последн: последнее последние
дополня: дополняем
искрен: искренне
сам: самый самое самые самым
сквозн: сквозное
представля: представляет
синтез: синтез
друг: другом друг друга
дыхан: дыхание
стартап: стартапам
туториа: туториал
приход: приходу
подключен: подключения
правильн: правильно
тайн: тайные
погрешн: погрешность
поня: понять
подобн: подобной
абсолютн: абсолютно
краж: кражу кражи
называ: называемые называются
компан: компаний компании
рассказыва: рассказывает
выполнен: выполнения
программ: программы
коммуникац: коммуникаций
точност: точностью
действ: действия
ноут: ноут
соответствен: соответственно
руковод: руководил
нетрадицион: нетрадиционно
смысл: смысл смысле
жно: жной жное
уязв: уязвим
предполага: предполагается
начина: начинает
привет: привет
стандарт: стандарты стандартом стандартов
рубеж: рубеж
состоян: состояния
расстоян: расстояния
передав: передавая
вс: вс
популярн: популярные популярное
прогноз: прогнозам
област: областях области
использ: использует используются
научн: научно
поворот: поворотами
учетк: учетка
секстическ: секстическими
пересыла: пересылать
ран: ранее
сво: свой
веб: веб
кейс: кейс
программирован: программирование
нача: начать начали
отдельн: отдельная
частот: частота
специалист: специалисты специалистов
порог: порог
сохранен: сохранение
передач: передаче
станов: становиться становится
выполн: выполним
интернет: интернете
атак: атакам атака атак
реализац: реализации реализация
хранен: хранение
явля: является
появлен: появление
чисел: чисел
тел: телу
тем: тема тему темы
основател: основателем
привычн: привычные
пришл: пришло
полн: полной полные
администрирован: администрирование
развит: развития
криптомат: криптоматы
почтов: почтового
представ: представить
компилятор: компилятор компиляторы
взглянут: взглянуть
сайт: сайта сайтов
знан: знания
контрол: контроля
знал: знал
кошельк: кошельку
научпоп: научпоп
продолж: продолжим
привлека: привлекают
технолог: технологий технологии
задач: задачу задаче задачами задачах задачи задач
комментар: комментарии
файл: файлы
происход: происходило
клиентск: клиентское
рамк: рамках
папк: папки
различн: различные различными различных
физик: физики
проч: прочими
компьютер: компьютеров компьютерах
сертификат: сертификате
воплот: воплотить
работа: работает
смогут: смогут
песочниц: песочницы песочница
ценност: ценности
сегодняшн: сегодняшний
коснут: коснуться
кубит: кубиты
пар: пару
услуг: услуги
переориентирова: переориентировал
заинтересова: заинтересовало
треб: требует требуется
телефон: телефон
платежн: платежные
блог: блог
нног: нного
истор: истории
числ: числе
зовут: зовут
гражда: граждан
увлекательн: увлекательная
мышлен: мышления
гонк: гонки
шум: шум
исследова: исследовать
сложност: сложности
факт: факт
ещ: ещ
посредств: посредством
автор: авторы автор автором авторов
чита: читать читаете
опор: опоры
сет: сети
конфиденциальн: конфиденциальная конфиденциальность конфиденциальные
вид: вид
виде: видео
защит: защита защиту защиты
явн: явно
кошк: кошки
посоветова: посоветовали
мяукан: мяуканья
вплот: вплоть
кодекс: кодекса
быстр: быстро
пользу: пользуемся
договор: договорились
спрос: спросила
цепля: цепляю
бизнес: бизнесе
наук: науки
принима: принимает
криптообменник: криптообменники
хот: хотят хотите
тип: типах
позволя: позволяют позволяет позволяющий
памя: память
пережива: переживал
хоч: хочу
рейтинг: рейтинг рейтинга
удобств: удобства
реч: речь
преждевремен: преждевременное
реш: решила
способн: способных способны
пгш: пгш
известн: известно известный
сторон: стороной стороны
поток: потоки
защища: защищать
поддержк: поддержкой поддержка
состо: состоит
любов: любовь
набор: набор
федор: федор
дуновен: дуновение
родственник: родственники родственникам
хорош: хороших
иб: иб
классификац: классификация
библиотек: библиотеку
повод: поводу повод
анонимн: анонимного анонимной
пуст: пусть
защищ: защищ
зашифрова: зашифрованные зашифрованными
социальн: социальные
наш: нашем
возьм: возьм
устойчив: устойчивого
может: можете
нулев: нулевым
пользовател: пользователю пользователей
мног: многими многие
транзакц: транзакции транзакциям транзакцию
люб: любые любой
язык: языка
криптовалют: криптовалюта криптовалюты
фон: фоне
приятел: приятеля
несложн: несложных
фот: фото
сервис: сервисов сервисами сервисы сервисах
эллиптическ: эллиптической эллиптических
информац: информацию информацией информация информации
описа: описал
облачн: облачных облачные
биткоин: биткоин биткоине
разн: разной
приказ: приказ приказе
удален: удаления
создав: создавая
ровн: ровно
спуст: спустя
замен: заменить
противостоя: противостоять
ковырян: ковыряния
предварительн: предварительным
пакет: пакет
владен: владения
конкретн: конкретную
интуиц: интуиции
открыва: открывает
толик: толику
парол: паролями пароль паролем
мессенджер: мессенджера мессенджер мессенджеры мессенджеров
бессерверн: бессерверной
поговор: поговорим
применен: применений применение
создан: создания созданием
особ: особый особо особой
ходьб: ходьбу
потеря: потерять
подп: подпись
знает: знает
например: например
одн: одним
отправля: отправлять
нанометр: нанометра
мар: мар
реиспользован: реиспользования
согласн: согласно
минтруд: минтруд
реклам: реклама рекламы
разбер: разбер разберемся
настольк: настолько
рассылк: рассылке
вставк: вставки
корпоративн: корпоративный
нативн: нативный нативные
соответств: соответствия соответствии
попрос: попросили
инструмент: инструменты инструмента
надежн: надежную
шифр: шифры шифров
команд: команда команд
маскировк: маскировки
польз: пользуются
ма: мае
познаком: познакомились
апрел: апреля
врод: вроде
электрон: электронная электронной
аренд: аренда
инструкц: инструкцию
смотрет: смотреть
десятк: десятка
использован: использование использованию использования использованием
уровн: уровне
мо: моем моих
поскольк: поскольку
сист: систем
горазд: гораздо
специфичн: специфичный
углублен: углубленно
войт: войти
ноутбук: ноутбук ноутбука ноутбуке
сидел: сидел
массов: массовая
лаз: лазил
аккаунт: аккаунт
исходник: исходники
сомнен: сомнений
подпис: подписи подписью
неподтвержден: неподтвержденные неподтвержденным
протокол: протокола протоколы протоколов
наскольк: насколько
сраз: сразу
производ: производить
отложен: отложенной
проблем: проблемы проблема
подробн: подробности подробнее
репозитор: репозиторий
сервер: серверу сервер сервере сервера
раздел: разделы
болезн: болезни
параноик: параноика
исследовател: исследователи
нек: некий некая
замедлен: замедленного
яндекс: яндекс
новост: новостей новости
лучш: лучшее лучшие лучших
чувствительн: чувствительных
перв: первой первых первым
формат: формат
дума: думать думала
сконча: скончался
посет: посетила
близк: близких
операц: операций
разворачива: разворачивал
написа: написать
сейф: сейфе
поиск: поиск
возможн: возможность возможности
интересн: интересно интересное интересные
допустим: допустимой
равн: равно
распродава: распродавать
пересказа: пересказать
планшет: планшет
взлома: взломали
исполнен: исполнении
файлохостинг: файлохостингах
голов: голову
противореч: противоречить
образовательн: образовательные
хочет: хочет
как: какое
определ: определить
голос: голосов
кат: катом
рассматрива: рассматриваться
взгляд: взгляд
тся: тся
раскрыва: раскрывает
поведен: поведения
реальн: реальных реальной
тянут: тянуть
лома: ломает
точк: точку точки
сфер: сфере
преимуществен: преимущественно
стандартн: стандартные стандартных
компилирова: компилировать
откр: открыть
способ: способ
июл: июле
мер: мерах
криптографическ: криптографической криптографических криптографические криптографическая
браузер: браузера
доказа: доказать
опенсорсн: опенсорсный
компьютерн: компьютерные
помног: помногу
дифф: диффи
минцифр: минцифры
размина: разминать
sourc: source
bajlepa: bajlepa
hl: hls
devop: devops
protonmail: protonmail
secp: secp
bit: bit
number: number
password: password
twitter: twitter
braonl: braonle
ctf: ctf
pluggabl: pluggable
honyaki: honyaki
ellipt: elliptic
nix: nix
proton: proton
github: github
jeditob: jeditobe
scratch: scratch
secur: secure
javascript: javascript
ispmanag: ispmanager
miran: miran
rbf: rbf
openssl: openssl
uelk: uelkes
habr: habr
firstvd: firstvds
globalsign: globalsign
rsa: rsa
firstjohn: firstjohn
youtub: youtube
rss: rss
cve: cve
peter: peter
encrypt: encryption
attack: attack
rko: rko
tracerout: traceroute
adminvp: adminvps
fscrypt: fscrypt
acer: acer
alizar: alizar
mysterytwist: mysterytwister
facebook: facebook
rtm: rtm
sextic: sextic
fulli: fully
itguevara: itguevara
nist: nist
zepar: zepars
apocalyps: apocalypse
martybug: martybug
googl: google
tl: tls
open: open
sivchenko: sivchenko
ecc: ecc
data: data
fee: fee
remot: remote
project: project
dn: dns
mode: mode
neverwalkalon: neverwalkaloner
replac: replace
group: group
ubuntu: ubuntu
homomorph: homomorphic
translat: translate
crypto: crypto
core: core
vk: vk
bolshoyfedya: bolshoyfedya
happygroundhog: happygroundhog
twist: twists twist
skillfactori: skillfactory
admin: admin
eppi: eppie
denul: denull
linux: linux
htb: htb
sigaba: sigaba
recoveri: recovery
ol: ols
tcp: tcp
fhe: fhe
shifttsta: shifttstas
center: center
ecdsa: ecdsa
telegram: telegram
transport: transports
srp: srp
hlt: hlt
cyber: cyber
bitcoin: bitcoin
