найт: найти
случ: случая
максимальн: максимально
готов: готовое готовый
сдает: сдает
оценк: оценки
подискутирова: подискутировать
информацион: информационная
быстрот: быстроты
значен: значение
образ: образы
стат: стать статью статье статьи статья
стар: старую
ждет: ждет
окн: окна окно
конц: конце
найд: найдено
мнен: мнением мнение мнению
аспект: аспект
гибкост: гибкости
обзор: обзор
случа: случае
един: единое
работ: работа работе работы работой
показыва: показывают показывать
дополнительн: дополнительной
практическ: практически
вернут: вернуться
жаргон: жаргонный
сто: стоит
представьт: представьте
приятн: приятное
критическ: критически
янв: янв
вообщ: вообще
менеджмент: менеджмент
интеграц: интеграции
й: й
л: л
вкратц: вкратце
о: ой
давн: давних
свернут: свернутый свернутых свернутой
парсинг: парсингу парсинг
присутств: присутствует
должн: должны
публикац: публикаций публикации
скопирова: скопировать
дава: давайте
график: графикой
логическ: логически
показа: показать
поэт: поэтому
назван: названии названий
котор: которую которыми
мин: мин
мир: мир
аккордеон: аккордеон
исследован: исследования
связа: связанных связаны
безопасн: безопасная безопасной безопасность
проверя: проверяют
двига: двигается
либ: либо
проект: проектах проекте проекты проект проекта
связ: связи связь
появля: появляется
конец: конец
зав: зав
адресат: адресатов
профил: профиль
дела: делает делал делать делаем
столкнут: столкнуться
провед: проведу
получ: получит получить
перевод: перевод
хост: хосты
верс: версии версию
важн: важного
маркетинг: маркетинг
сосредоточ: сосредоточимся
столкнул: столкнулся
прост: простой простого
внутр: внутри
столбчат: столбчатых столбчатые
движк: движках
врем: времен
фидбек: фидбек
измеря: измеряемый
свободн: свободно
постро: построена
перемеща: перемещаться
эксплуатац: эксплуатации
повышен: повышенной
уровен: уровень
нов: новый новые новым новое новая
преамбул: преамбула
медийн: медийная
задержек: задержек
мест: мест
анимац: анимация
част: часть части
техничес: техничесий
иде: идея
ждат: ждать
перегрузок: перегрузок
аналогичн: аналогичные
игр: игры
полезн: полезное
сдела: сделать сделано
эффективн: эффективными
доставля: доставлять
сложн: сложный
нетерпелив: нетерпеливых
опенсорснут: опенсорснуть
представлен: представление
лайк: лайки
генерац: генерации
примен: применить
пут: пути
активн: активно
жизн: жизни
пример: пример примере примеров примеру примером
штук: штуки
вербальн: вербально
куск: куски
мог: могу
узна: узнаете
затрон: затронем
момент: момент
развива: развивается
основн: основного основной основная
текущ: текущий
сможет: сможет
ресурс: ресурса
скрыва: скрывается
отзывчив: отзывчивых отзывчивые отзывчивость отзывчивого отзывчивый
техник: техник
привест: привести
решен: решение решения
нных: нных
хотел: хотелось хотел
владельц: владельцы
передава: передавать
средн: средний
личн: личного личном личным
разметк: разметки
букв: буква
подряд: подряд
помога: помогают
хаб: хабы
вечер: вечер
рисова: рисовать
помощ: помощью помощи
современ: современных современные современный
выш: выше
приложен: приложений приложение
обменя: обменяемся обменяться
лож: ложится
выполня: выполнять
разработчик: разработчику разработчики
результат: результата
красив: красивые красиво красивая
опыт: опытом опыта
попытк: попыткам
настройк: настройки настройка
вклад: вклад
дал: далее
ссыла: ссылаться
произнос: произносит
текст: текст текста
разброса: разбросанных
показател: показателей показатель
сигнал: сигналам
документ: документы
прочтен: прочтение
египтян: египтяне
ссылк: ссылка ссылки ссылку
затащ: затащить
выделен: выделенном
экзам: экзамены
прокручива: прокручиваются
транспортн: транспортный транспортных транспортного
нацел: нацелены
задержк: задержкой
иероглиф: иероглифы
восприят: восприятия
дан: данных данные данными данной
охват: охвата
векторн: векторной
наслуша: наслушавшись
изложен: изложенное
код: кода
перевед: переведя
подверга: подвергается
паттерн: паттерн
модул: модуль
регистрац: регистрация
ситуац: ситуациях
имеет: имеет
соединен: соединении соединения соединение
поисков: поисковых
функц: функция функциях функций функции функциям
причин: причиной
используем: используемых используемыми
цел: целом цель целью целого
построен: построение
изуча: изучаю
чих: чих
нарабатыва: нарабатываю
доступн: доступны доступным
заран: заранее
настро: настроить
дзен: дзен
множеств: множество
вмест: вместо вместе
взаимодейств: взаимодействия
создава: создавать
кажущ: кажущейся
жив: жив
обнов: обновить
разработк: разработке разработка разработки
серьезн: серьезность серьезнее
закладк: закладки
ведет: ведется
использова: использовать использовали
графическ: графически графический
разработа: разработан разработаем
прекрасн: прекрасное
фрагмент: фрагмента фрагменты
заня: заняться
руководств: руководство руководством
достаточн: достаточно
контейнер: контейнер
повседневн: повседневной
предположен: предположений
метрик: метрики метрик
учитыва: учитывать
сюд: сюда
список: список
наглядн: наглядно
знаком: знакомые
ориентирова: ориентированного ориентирован
коллекц: коллекцию
иконок: иконок
контрольн: контрольных
отраж: отражено
замечательн: замечательной
минут: минут
след: следующих следует
пыт: пытаясь
совпаден: совпадение
слышн: слышно
дел: дело делиться делюсь
дем: демо
дизайн: дизайна дизайн
рассказа: рассказано
взлом: взлома
производительн: производительностью производительность производительности
невозможн: невозможным
макет: макетов макеты
встраиван: встраивания
устройств: устройствах устройствам устройство устройства
заверш: завершить
попробова: попробовать
размер: размера
текстов: текстовые текстовых
переход: переходов
бэкенд: бэкенде
ваш: вашем вашему вашего
распростра: распростран
так: такую таком таких таким
письмен: письменности
публикова: публиковать
пространств: пространству
уязвим: уязвимостей уязвимостях уязвимости
событ: событие
собствен: собственный
техническ: техническая
модальн: модальное модального
измен: изменилась
фев: фев
слыша: слышали
символ: символами
собира: собираю собирать
мегапроект: мегапроекты
хабр: хабре хабр
некотор: некоторое
отобраз: отобразить
авторизац: авторизации
рассмотр: рассмотрим
иска: искать
ширин: шириной
подума: подумал
заопенсорнут: заопенсорнуть
претенд: претендует
количеств: количество
полев: полевых
соглашен: соглашение
древн: древние
куч: куча
добав: добавить
просмотр: просмотра просмотров
практик: практик
последн: последнее последние
друз: друзья
месяц: месяцев
услов: условиях
сам: самых
сквозн: сквозном
представля: представляет представляю представляющей представлять
цветов: цветовых цветовые цветовым
настраива: настраивать
виртуальн: виртуального
нынч: нынче
друг: другими
стартап: стартапам
туториа: туториал
роутер: роутеры
переда: передать
наступ: наступит
поня: понял понять
реактивн: реактивную
подобн: подобные
посмотр: посмотрим
называ: называемые называемом
компан: компанией компаний компании
программ: программы
коммуникац: коммуникации
выглядел: выглядело
получа: получающий
принят: принята
предназначен: предназначенный
главн: главное
действ: действия
соответствен: соответственно
обеспечива: обеспечивают
браузерн: браузерных браузерные
низк: низкой
достигл: достигли
элемент: элементов элемента
волну: волнуясь
привет: привет
очередн: очередную очередной
инициатив: инициатива
интерактивн: интерактивные
обязан: обязанностью
вс: вс
прогноз: прогнозы
покаж: покажу
начн: начнем
использ: используется используют
област: области
визуальн: визуально
исчеза: исчезает
вручн: вручную
простот: простотой
цвет: цветами цвета цветов
созда: создать созданного
сво: своему своими свой
веб: веб вебе
кейс: кейс
программирован: программирование
исход: исходя
отдельн: отдельный
порог: порог
передач: передачи
забыва: забывать
станов: становится
интернет: интернет интернете
предоставля: предоставляет
сформир: сформирует
реализац: реализацию реализации
парс: парсим
истин: истину
тег: теги
явля: является являются
вещ: вещей вещи
узк: узких
включен: включенных
тем: тему
пришл: пришла пришло
администрирован: администрирование
пользовательск: пользовательские пользовательского
начальн: начальных
сайт: сайта сайты сайте сайтом сайтов сайт
контрол: контролем контроля
обеспечен: обеспечения
научпоп: научпоп
технолог: технологию технология
комментар: комментарии
задач: задачу задача
происход: происходит
рамк: рамках
различн: различных различным
задан: задания
нейросет: нейросеть
прош: прошу
компьютер: компьютеры
работа: работают работающие работать работает
песочниц: песочницы песочница
пересобира: пересобирать
пар: пару
услуг: услуги
блог: блога блог
необходим: необходимости необходимым
поистин: поистине
истор: истории
двум: двумя
интерфейс: интерфейса
чист: чистом
пробл: проблем
сложност: сложности
ещ: ещ
гитхаб: гитхабе гитхаб
вниман: вниманию
видн: видна
автор: авторы автором авторов автора
очеред: очередь
чита: читать
лонгрид: лонгрид
легк: легко
сет: сети
вид: виде
конфиденциальн: конфиденциальность
локальн: локальную
подход: подходы подходит
защит: защитой защита защиту
быстр: быстро
типичн: типичная
тип: типа типе
позволя: позволяете позволяет
бумаг: бумагу
набра: набрался
рейтинг: рейтинг рейтинга
распространен: распространенным
удобств: удобства
реч: речь
реш: решил решился решить решила
визуализац: визуализации визуализация
недостатк: недостатки
сторон: сторона
поток: потоки
поддержк: поддержка поддержки
предостав: предоставить
остальн: остальных
недел: недель
модульн: модульные
хорош: хорошего хороший
ид: идем
удобн: удобно
сред: среди
наш: нашу
зациклен: зацикленного
редактор: редактор
пользовател: пользователя пользователям пользователем пользователю
мног: многое
титр: титрах
посвящен: посвященных
люб: любого любой
сущност: сущностями
компонент: компонентов компонента
язык: язык языка
робот: роботов
таблиц: таблице
сервис: сервис сервисе
стил: стилей
информац: информацию информация информации
фронтенд: фронтенд
основыва: основывается
табл: табло
продакш: продакшен
анализ: анализа анализ
скрыт: скрытый скрытой скрытых скрытого
математическ: математических
философ: философию
использу: используя
целев: целевой
пес: песен
упорядоч: упорядочить
открыва: открывать
добавлен: добавлении
сборк: сборку
отража: отражает отражающий
обработк: обработка
поговор: поговорим
диаграмм: диаграммы диаграмм
шага: шагать
парочк: парочкой
аудитор: аудитории
создан: создании создание
идет: идет
знает: знает
потест: потестим
сворачива: сворачивающиеся
мар: мар
широк: широко
целик: целиком
светлот: светлоту
реклам: реклама
разбер: разберемся
корпоративн: корпоративный
понятн: понятно
рекомендац: рекомендаций
нагрузк: нагрузки
соответств: соответствии
нативн: нативные
шаблон: шаблоном
инструмент: инструменты инструментах
доклад: докладов доклады
огромн: огромное
наработк: наработками
команд: команды команда
итак: итак
иконк: иконка иконках иконки
стран: странно
инструкц: инструкцией
атрибут: атрибут
удивлен: удивлению
использован: использования
мо: моей моего моим
запрос: запросы запросов
му: му
сист: систем
сшивател: сшиватель
войт: войти
нечт: нечто
качеств: качества качестве
тон: тон
конечн: конечными
аккаунт: аккаунт
топ: топ
протокол: протокол протоколов протоколы протоколом протокола
сраз: сразу
насыщен: насыщенность
пиш: пишу пишем
проблем: проблемы проблемам проблема
репозитор: репозиторий
обнаружен: обнаруженного
ужас: ужас
бот: ботов
раздел: разделах разделы раздел
автоматическ: автоматическому
похож: похожие
фиксирова: фиксированной
пишет: пишет
яндекс: яндекс
новост: новости
лучш: лучшая лучшее лучшие лучших
механизм: механизм
перв: первой первом
небольш: небольшой
достижен: достижению
дума: думать
желательн: желательно
облегч: облегчить
крайн: крайне
добр: добрый
написа: написанное написанный
поиск: поиска поиск
возможн: возможность возможности возможно
изменен: изменения
оп: опыт
интересн: интересно
автоматизирова: автоматизировать
основ: основе
ленив: ленивый
открыт: открытые
выбра: выбрал
мед: медиа
буквальн: буквально
демонстрац: демонстрации
образовательн: образовательные
семантик: семантики
как: какую каком каких какие
переполн: переполнен
голос: голосов
крут: круто
страниц: страниц странице
смешива: смешивать
ориентир: ориентирующиеся
кат: кат
фигн: фигн
встреча: встречаю встречается
высок: высокая высокий
реальн: реальные реальная
портфол: портфолио
обход: обхода
стабильн: стабильной
добавл: добавляя
выступа: выступать
непрозрачн: непрозрачность
риск: риски
контент: контентом контента контент
точк: точках
стандартн: стандартный
откр: открыть
способ: способ способами
насмотревш: насмотревшись
браузер: браузера браузеры браузеру
революц: революции
отправител: отправителей
напрям: напрямую
продукт: продукт
кнопк: кнопку
признак: признаки
улучшен: улучшения
термин: термин
источник: источник
css: css
ruvd: ruvds
textarea: textarea
quic: quic
wysiwyg: wysiwyg
devrel: devrel
twitter: twitter
java: java
api: api
lighthous: lighthouse
boumrz: boumrz
python: python
kichik: kichik
modul: module
javascript: javascript
ipv: ipv
davidaganov: davidaganov
otu: otus
openai: openai
size: size
light: lightness
habr: habr
style: style
feder: federation
ru: ru
aio: aio
bright: bright
js: js
youtub: youtube
search: search
ton: ton
rss: rss
web: web
rko: rko
connect: connections
contain: container
alizar: alizar
svg: svg
transmiss: transmission
max: max
facebook: facebook
unicod: unicode
breakpoint: breakpoints
todo: todo
pyxru: pyxru
googl: google
width: width
php: php
fitter: fitter
paul: paul
satur: saturation
kolayandr: kolayandr
quick: quick
razoomnick: razoomnick
alexzfort: alexzfort
mihailgok: mihailgok
dersmol: dersmoll
reactj: reactjs
cloud: cloud
protocol: protocol
view: view
function: functions
mf: mf
html: html
perfbuddi: perfbuddy
iskorkin: iskorkin
andrei: andrey
net: net
maksimilliano: maksimilliano
swift: swift
wisywig: wisywig
chrome: chrome
setinterv: setinterval
king: king
vd: vds
translat: translate
core: core
unit: units
vk: vk
transit: transition
sergeevich: sergeevich
vital: vitals
skate: skate
internet: internet
theshock: theshock
udp: udp
biryukov: biryukov
color: color
websit: website
hidden: hidden
session: session
timeweb: timeweb
wc: wc
krovatti: krovatti
devtool: devtools
strokoff: strokoff
git: git
queri: queries query
linux: linux
backend: backend
beforematch: beforematch
hahavenn: hahavenn
tcp: tcp
mvp: mvp
telegram: telegram
control: control
qmzik: qmzik
textcont: textcontent
ilusha: ilusha
opac: opacity
hue: hue
frontend: frontend
