готов: готовых
фактическ: фактическим
экспериментальн: экспериментально
образ: образом образов образа
значен: значения значений значение
независим: независимыми независимые независимо
стат: стать
леж: лежит
стар: старую
повторн: повторного
вызов: вызова вызове
кусочк: кусочки
мнен: мнение
аспект: аспект аспекты
указан: указания
предлага: предлагает
гибкост: гибкость гибкостью
см: см
реализова: реализована реализовать
работ: работа работы работу
дополнительн: дополнительные
практическ: практически
доступ: доступа доступ
вернут: вернуться
сч: сч
гарантирова: гарантировать
абстракц: абстракции абстракций
получен: полученного
достигнет: достигнет
инфраструктур: инфраструктуры инфраструктуру
пол: поля поле
сто: стоит
обновлен: обновление
схем: схемы
менеджмент: менеджмент
то: той
концептуальн: концептуальной
н: н
пробел: пробелов
должн: должны
ошибок: ошибок
централизова: централизованно
коэффициент: коэффициент коэффициентами
структур: структура структур структуре структуры
публикац: публикации
неизменя: неизменяемые
логическ: логической
отправ: отправить
наилучш: наилучшим
иерарх: иерархии
модификатор: модификаторов модификаторах
взаимосвяза: взаимосвязанных
джоб: джоб
котор: которую котором
карм: карма
откат: откат
мин: мин
отнест: отнести
минимализм: минимализма
секретн: секретное секретного
эксперимент: экспериментов
вкрапл: вкраплены
связа: связано связанные связанных
манифест: манифестам манифестов манифесты манифестами манифеста манифесте
отмет: отметить
внезапн: внезапно
либ: либо
уч: уч
проект: проекты проектов проект
связ: связи связь связями
формирова: формировать
строков: строковых строковое
автомасштабирован: автомасштабирование
зад: зада
относительн: относительно
профил: профиль
получ: получили получить
синхронизац: синхронизации
документац: документации
функционирова: функционировала
подстановк: подстановка
хост: хоста
верс: версии версий версиям версиями версию
важн: важных
исключен: исключения
маркетинг: маркетинг
побочн: побочных
аргумент: аргументы аргументом
списк: списке
шаблонизатор: шаблонизатора
именова: именованные именованных
час: час
внутр: внутри
прост: простой
метк: метке метки метка меткой
альтернатив: альтернативами
позвол: позволят
занима: занимающегося занимает
справедлив: справедливости
совместим: совместимость совместимы
эксплуатац: эксплуатации
уровен: уровень
нов: нового новых новые новая
внешн: внешние внешних
больш: большим
медийн: медийная
част: части частью частей
модифицир: модифицирующие модифицирующий
динамическ: динамической
вход: вход
инженер: инженер
неисчерпа: неисчерпаемым
отказ: отказам
системн: системный
существен: существенные
меток: меток
видет: видеть
развернут: развернуть
сложн: сложных сложной сложная
редк: редко
исправлен: исправления исправлений
представлен: представление
генерац: генерации генерация
пут: путь пут
исправ: исправить
окружен: окружения окружениях окружений
пример: пример
подсистем: подсистемы подсистемам подсистеме подсистемами
итогов: итоговом
систем: система системы
полноцен: полноценным
генерирова: генерировать
мож: можем
неизмен: неизменном
сожален: сожалению
обрабатыва: обрабатывать
текущ: текущей
облада: обладать обладает
ресурс: ресурса ресурсы ресурсов ресурсах
охарактеризова: охарактеризовать
процесс: процесс
основа: основанные основан
свойств: свойствами свойство свойства свойств
перемен: переменной
привест: привести
требован: требования
решен: решений решения
хотел: хотелось
надсистем: надсистемы
передава: передавать
масштабирован: масштабированию масштабирование масштабирования
стким: сткими
нным: нными
комментирова: комментировать
средн: средний
предметн: предметной
номер: номер
случайн: случайных
секрет: секрета
первоклассн: первоклассные
меня: меняется
хаб: хабы
описан: описания
купирован: купирования
герметичн: герметичный
помощ: помощью
гугл: гугл
приложен: приложение приложения приложениях приложений
вызыва: вызываются
командн: командной
секунд: секунду
вычислен: вычислениями вычисление
ортогональн: ортогонального
суффикс: суффиксов
ваканс: вакансии
настройк: настройка
дал: дал
генеративн: генеративный
текст: текст
последовательн: последовательности
документ: документы документе
прочтен: прочтение
вспомогательн: вспомогательных
корректн: корректно корректной корректную
значк: значки
поверх: поверх
инкапсуляц: инкапсуляция
задержк: задержкам
средств: средствами
дан: данных данные данный
сравнен: сравнении
откладыва: откладывается
охват: охват
дат: дать
имен: имени именем
указа: указанных указать указаны
протестирова: протестированные
состоя: состоящей состоящими
осуществля: осуществлять осуществляется
код: кода коде
декларируем: декларируемую
соотнест: соотнести
модул: модуль модуле модулей
регистрац: регистрация
отсутствова: отсутствовала
эфемерн: эфемерные эфемерных
убед: убедиться
имеет: имеется
генератор: генератором генераторах генераторы
эффект: эффектов
формирован: формирование формирования
отсутств: отсутствие
функц: функция функцию функций функции функцией
причин: причиной
внесен: внесения
используем: используемая
цел: целом целое
трансформатор: трансформатор
отлича: отличающиеся отличающихся отличается
версионирован: версионирование
экзотическ: экзотическая
доступн: доступны
кажд: каждого каждому
заран: заранее
следован: следование следования
дзен: дзен
сохран: сохранить
множеств: множества
создава: создаваемых
ошибк: ошибке
перезаписа: перезаписать
синтаксис: синтаксисе
обнов: обновить
донастройк: донастройка
объект: объекта объект объекты
разработк: разработкой разработка
частност: частности
закладк: закладки
использова: использоваться использовать
безусловн: безусловно
программн: программных программные программной программного
вычисл: вычислить
достаточн: достаточно достаточной
совершенств: совершенства
булев: булевый
нефункциональн: нефункциональными
гарантир: гарантируется
список: список
импорт: импорта
литера: литерал
выдел: выделить
строг: строгой
обеспеч: обеспечить
след: следующими следующего следует
строк: строкой строки строка строк
вопрос: вопрос
организац: организаций организации
дизайн: дизайн дизайном
невозможн: невозможно
производительн: производительностью производительность
концепц: концепции концепцию
игра: играющий
сохраня: сохранять
устройств: устройство
переход: переход
записыва: записываются
коротк: короткий
так: таком таким
генерир: генерируется генерируются
порт: порт
усил: усилить
полност: полностью
несмотр: несмотря
баг: багов
семейств: семейство
срок: срок
проектирован: проектирования
собствен: собственно
копирован: копирования
баз: баз базы базой базе
оптимальн: оптимальный оптимального
техническ: техническая
констант: константы
измен: изменить
заметк: заметки заметке
отслеживан: отслеживания
внест: внести
мегапроект: мегапроекты
описыва: описывающих описывается описывающего описывающий описываются
хабр: хабре хабр
некотор: некоторое
рассмотр: рассмотрим
потенциальн: потенциальный
жижел: жижелев
ртыван: ртывание ртыванием ртывании ртывания
количеств: количество
введен: введение
многокомпонентн: многокомпонентных
соглашен: соглашение
родительск: родительской родительскую
логичн: логичным логично
добав: добавить
просмотр: просмотров
специальн: специальные специальное
ряд: ряд
конфигурац: конфигурацию конфигурация конфигурации конфигураций
сам: самым
представля: представляет представляют представляется представлять
манипулирова: манипулировать
стро: строить
бд: бд
друг: другими другому
сутк: сутки
стартап: стартапам
возвраща: возвращающей
патч: патчей патчи
подключен: подключение
правильн: правильные
организова: организовать
оказыва: оказывается
поня: понять
кластер: кластере
менеджер: менеджер менеджера
степен: степени
компан: компаний компании
программ: программе программы
предназначен: предназначенного
цепочк: цепочке
регресион: регресионных
предъяв: предъявить
сфокусирова: сфокусироваться
представл: представлена
страда: страдает
обеспечива: обеспечивается обеспечивающим
фич: фича фич
созд: созда
элемент: элементов элементы
заключа: заключаются
умолчан: умолчанию
массив: массивов массивы
стандарт: стандартом
состоян: состоянием состояние
популярн: популярными
высокоуровнев: высокоуровневые
параметризац: параметризация
рад: ради
использ: используются
имеют: имеются
област: области
префикс: префикса префиксов
магазин: магазин
сво: своими
программирован: программирование программирования
исход: исходя
отдельн: отдельная отдельном отдельный отдельно
конструкц: конструкций конструкции
станов: становятся становится
предоставля: предоставляющий
тест: тестов
значительн: значительной
реализац: реализации
тег: теги
явля: является являются
позиционир: позиционируется
включен: включение
применя: применяются применяет
полн: полной полный
администрирован: администрирование
де: де
представ: представить
разграничен: разграничение
легковесн: легковесного
предусмотр: предусмотрены
перед: переда
определя: определяется определяет
непредсказуем: непредсказуемой
сайт: сайта
сгенерирова: сгенерированные
громоздк: громоздкость
обеспечен: обеспечения
научпоп: научпоп
технолог: технологии
задач: задачи задач
файл: файлов файле файл
происход: происходит
комментар: комментарии
придержива: придерживается
позицион: позиционные
рамк: рамках
пользова: пользоваться
различн: различные различных
папк: папке
неочевидн: неочевидными
адрес: адрес
типизац: типизации типизацией
работа: работающее
песочниц: песочница
долж: должен
блок: блоков
услуг: услуги
директив: директивы
треб: требуется
необходим: необходимости необходимого необходимо
блог: блог
накладыва: накладывается
числ: числа число
истор: истории
модификац: модификации
зрен: зрения
верхн: верхнего
интерфейс: интерфейс
веществен: вещественное
чист: чистый чисто
наследован: наследование
требуем: требуемая требуемых требуемой требуемым
сложност: сложности
факт: факто
ещ: ещ
параметр: параметрах параметры параметров параметра параметром
гибк: гибкими
надсист: надсистем
привед: привед
автор: авторы автором авторов автора
очеред: очередь
легк: легко
вид: виде
конфиденциальн: конфиденциальность
локальн: локальных локальный локальной
подход: подходах подхода подход
положен: положением
подставля: подставлять
диапазон: диапазон
разумн: разумно
естествен: естественно
нескольк: нескольких
быстр: быстрое
заключен: заключение
вышеперечислен: вышеперечисленных
пользу: пользуясь
влия: влияющие влиять
принима: принимает
тип: типа тип типы типу типов
позволя: позволяют позволяет
разреш: разрешены
рейтинг: рейтинг
упоминан: упоминании
удобств: удобства
реш: решить
известн: известна
недостатк: недостатков недостатки
сторон: стороны
поток: потоки
кратк: краткое
указыва: указывается
поддержк: поддержкой поддержки поддержка
компонен: компоненам
зада: заданными
состо: состоит
набор: набор
реж: реже
поддержива: поддерживается поддерживаются поддерживает
глубок: глубоко
включ: включая
принцип: принципу принципа
предназнач: предназначен
удобн: удобной удобно удобном удобная удобными
оператор: операторы
тестов: тестовых
предыдущ: предыдущим
им: имена
ин: иные иной
пользовател: пользователя пользователь
мног: многих
люб: любые
излюблен: излюбленного
зависим: зависимости зависимостей
именован: именование именования
компонент: компонент компонентами компонентов компонента компоненты компоненту
язык: язык языка языке языку
потреб: потребуются
согласова: согласованных согласованный согласованные
содержа: содержащие содержащего
абстрагирован: абстрагирование
сервис: сервисов
стил: стиле
регулярн: регулярно
фактор: фактором
соответствова: соответствовать
генетическ: генетический
описа: описать
информац: информация
разн: разных разного
ключев: ключевым
выгляд: выглядит
видим: видимости видимому
удален: удаление
содержим: содержимое
соседн: соседними
разв: разв
ровн: ровно
замен: заменить
отвеча: отвечает
объяв: объявить
пакет: пакетов
добавлен: добавления
парол: пароль пароля
сборк: сборке
обработк: обработка обработки обработку
создан: создания создание
клонирован: клонирования
храня: хранящихся
прич: прич
привод: приводятся
порожда: порождать порождающая
например: например
идентифицир: идентифицирующие
трудноуловим: трудноуловимых
одн: одном одним одно
отклонен: отклонений
широк: широкий широко
целик: целиком
реклам: реклама
тны: тные
корпоративн: корпоративный
нагрузк: нагрузки нагрузкой
потребн: потребности
соответств: соответствующая соответствующее
запуск: запуска
нативн: нативные
одинаков: одинаковых
масштаб: масштаб масштаба
шаблон: шаблоны шаблона шаблонов
инструмент: инструментов
ток: токена
команд: команды командой команд
ознаком: ознакомиться
ма: ма
экземпляр: экземпляров экземпляре
ответствен: ответственности
находя: находящееся
оверл: оверлей
уникальн: уникальность
использован: использование использования использованием использовании
отлич: отличия
уровн: уровне уровня
запрос: запросов
включа: включаемых включает
сист: систему систем
войт: войти
исходн: исходная исходной
соедин: соединить
качеств: качестве
аккаунт: аккаунт
разделен: разделения
состав: состава составом составе
дета: детали
генерируем: генерируемом
совокупн: совокупность
выбор: выбор
арсен: арсений
сраз: сразу
производ: производится
репозитор: репозитория репозитории
подробн: подробно подробнее
излага: излагается
исключ: исключить
порожден: порождение
сервер: сервер
раздел: разделы разделена
автоматическ: автоматическое автоматического автоматически
похож: похожие
выражен: выраженные выражение
пишет: пишется
фиксирова: фиксированные
нетривиальн: нетривиальные
яндекс: яндекс
унифицирова: унифицированно
ов: ов
новост: новости
существ: существующей существующего
лучш: лучшие
механизм: механизма механизм
перв: первую
небольш: небольшого
формат: формате
желательн: желательными
относ: относится
операц: операций
проведен: проведения
переключен: переключению переключения
поиск: поиск
возможн: возможности возможность возможностями
изменен: изменение изменения изменении
автоматизирова: автоматизировать
допустим: допустимо
неудобн: неудобно
основ: основе основы
детерминирова: детерминированное
ленив: ленивыми
выбра: выбранных
образовательн: образовательные
подсист: подсистем подсистему
как: какое каком какие каких каким
определ: определ
функциональн: функционального функциональное функциональном функциональный функциональными
крупн: крупных
непосредствен: непосредственно
все: всей
сконфигурирова: сконфигурированных
содерж: содержит
меша: мешает
рассматрива: рассматривается
упомянут: упомянуть
тся: тся
взгляд: взгляд
встреча: встречаются
пакетн: пакетного
род: рода
стабильн: стабильно
лома: ломаются
изначальн: изначально
архитектур: архитектуры
рол: роли
точк: точке точки
выкат: выкатить
установлен: установления
дублирован: дублирование
стандартн: стандартная
откр: открыть
способ: способ
наход: находиться
напрям: напрямую
продукт: продукт
конструирова: конструировать
никак: никакой
термин: терминах
источник: источником
metadata: metadata
bad: bad
devop: devops
argocd: argocd
systemlabel: systemlabels
helm: helm
concern: concerns
apivers: apiversion
patch: patch patches
compon: component
path: path
password: password
twitter: twitter
statefulset: statefulset
api: api
join: join
app: app apps
ourcompon: ourcomponent
std: std
past: paste
io: io
tanka: tanka
manag: manager
databas: database
bundler: bundler
habr: habr
schema: schema
valu: values
librari: library
pod: pod
repo: repo
secret: secret
copi: copy
horizontalpodautoscal: horizontalpodautoscaler
articl: articles
local: local
youtub: youtube
file: file
jsonnet: jsonnet
kustom: kustomize kustomization
releas: release
packag: package
qbec: qbec
cd: cd
set: set
ci: ci
facebook: facebook
url: url
txt: txt
esc: esc
aka: aka
libsonnet: libsonnet
imag: image
chart: chart charts
instal: install
data: data
replica: replicas
lib: lib
whitespac: whitespace
subsystem: subsystem
main: main
separ: separation
good: good
spec: spec
deploy: deployment
host: host
html: html
replac: replacements
yaml: yaml
add: add
partof: partof
rollout: rollout
kind: kind
lisp: lisp
alic: alice
dry: dry
servic: service
overlai: overlay
null: null
bob: bob
port: port
vk: vk
person: person
http: https
ugli: ugly
gitlab: gitlab
myvalu: myvalue
primetalk: primetalk
indent: indent
continu: continuous
kubernet: kubernetes
git: git
postgresql: postgresql
configmap: configmap
design: design
json: json
org: org
ini: ini
custom: customization
telegram: telegram
label: label
gitop: gitops
bitnami: bitnami
postgr: postgres
user: user
importstr: importstr
base: bases base
