случ: случилось
говор: говорят говорить
рф: рф
понима: понимали понимал понимать
расскаж: расскажу расскажем
стат: стать статье статей статьи
европейск: европейских
оказа: оказалось
обычн: обычного
стар: старую
инвестор: инвесторы инвесторов
рабоч: рабочего рабочее
стал: стала стало
ангел: ангелов
мнен: мнение
вуз: вузов
работ: работа работе работы работу
общепринят: общепринятым
зумер: зумеров
показыва: показывает показывать
арт: арт
йорк: йорк
экономик: экономику
впечатлен: впечатлениями
получен: полученные
учебн: учебный
сто: стоит
основан: основания
приятн: приятнее приятного
тв: тв
критическ: критически
те: тесь
лен: лениться
менеджмент: менеджменте менеджмент
интеграц: интеграции интеграция
местоположен: местоположение
мобильн: мобильных
выкуп: выкупить
публикац: публикации
скопирова: скопировать
готовн: готовность готовности
подел: поделиться
дэвид: дэвида
человеческ: человеческим
назван: название
котор: которую которое которому которыми
провест: провести
осозна: осознали
пор: порой
бурн: бурного
вест: вести
прав: правило
отмет: отметить
уч: учиться
либ: либо
проект: проектов проекте проекты проект проектами проекта
совместн: совместно
упроща: упрощают
профил: профиль
дела: делать
проектн: проектная
часов: часовых
дискусс: дискуссии
продела: проделанной
верс: версию
нна: нная
маркетинг: маркетинг маркетинге
книг: книги книга книге
увеличива: увеличивается
прост: простой
сделк: сделках
убедительн: убедительно
позвол: позволили
справ: справиться
заявля: заявляет
светл: светлые
профессионал: профессионалами
преследова: преследовали
планирова: планировалось
заработа: заработать
отпугнут: отпугнуть
уровен: уровень
очевидн: очевидно
нов: новые новых новому
семинар: семинаре
медийн: медийная
част: часть частая
предсказан: предсказание
цифров: цифровые
традицион: традиционно
слож: сложилось
слов: слова
литератур: литературе
постоя: постоянно
сдела: сделать сделали
рожден: рожденными рождения
особен: особенности
сложн: сложных сложного
примен: применить
свыш: свыше
персонал: персоналом
природ: природу
выход: выходит выходят
тимбилдинг: тимбилдинг
узна: узнать узнаете
отступа: отступать
выж: выжить
труд: труда
курс: курсах
читател: читателей читателя
сша: сша
лидер: лидеров
машин: машинное
метод: методами
процесс: процесс
групп: группе группа
отток: оттока
молодеж: молодежи
сакральн: сакральный сакрального
произошедш: произошедшие
помогут: помогут
техник: техники
напрот: напротив
окружа: окружают
требован: требования
хотел: хотелось
нных: нных
написан: написанием
граффит: граффити
актуальн: актуальным
продолжа: продолжаем
йип: йип
помога: помогает
рынк: рынка
рисова: рисовать
насторожен: настороженно
ненавидет: ненавидеть
современ: современными
помощ: помощью
взаимодейству: взаимодействуем
приложен: приложений приложения
разработчик: разработчиками разработчиков разработчики
довольн: довольного
текст: текстов
показател: показателей
желан: желание
открытк: открытку открытки
стейкхолдер: стейкхолдеры
навык: навыкам
эволюционирова: эволюционировала
стенфордск: стенфордского
грустн: грустного
инвестиц: инвестиции
многообраз: многообразие
закон: законы
рост: рост
росс: россии россия
задумыва: задумываемся
регистрац: регистрация регистрации
автомобил: автомобилей
зим: зимой
закра: закралась
имеет: имеете имеет
числен: численность
словосочетан: словосочетания
каза: казалось
счита: считается считалось считать
причин: причину причиной
поднебесн: поднебесной
завист: зависть
противоположн: противоположных
цел: целый цели
отлича: отличаются
сериал: сериалов
изуча: изучали
кажд: каждом каждого каждому
человечеств: человечество
руководител: руководители
лекарств: лекарство
почтен: почтенным
выходн: выходные
российск: российский российских российском
дзен: дзен
множеств: множество множества
золот: золотой
искусствен: искусственного искусственный
мотивац: мотивации
довод: доводов
использова: использовать использовали
достаточн: достаточно
сюд: сюда
професс: профессии
настоя: настоящее настоящие
список: список
кадр: кадрах кадры
институт: институтом
нашел: нашел
организац: организации
дизайн: дизайн дизайне
невозможн: невозможно
яр: ярый
попыта: попытались попытался
попробова: попробовать
клиент: клиентов
так: таких таки таким
общен: общении
нормальн: нормального
видеотехник: видеотехника
течен: течение
редакц: редакцией
техническ: техническое техническая технический
фев: фев
разниц: разницу
головн: головной
товар: товары
описыва: описывает
порта: портала
аналитик: аналитику аналитики аналитика
рутин: рутинных
предпочита: предпочитает
монитор: мониторы
рассмотр: рассмотрим
нужност: нужности
подума: подумали
удивительн: удивительные
количеств: количество
служб: службы
соглашен: соглашений соглашение
попа: попались
добав: добавить
просмотр: просмотров
специальн: специальный специальной
покоря: покоряет
сквозн: сквозную сквозной
интеллект: интеллект интеллекта
стереотип: стереотипов
вдохновен: вдохновение
приход: приходит
правильн: правильные
поня: понять
менеджер: менеджером
компан: компаниям компаниях компания компаний компании
рассказыва: рассказывают
джордж: джордж
программ: программы
коммуникац: коммуникаций
ежедневн: ежедневно
главн: главная главный
размах: размахом
венчурн: венчурные
фич: фича
взросл: взрослых
октябр: октября
игрок: игроков
использ: использует
созда: создать
проявлен: проявление
кейс: кейс
исход: исходя
распознава: распознавали
отдельн: отдельным
иглм: иглмена
интернет: интернет
нью: нью
осознан: осознание
оригинальн: оригинальный оригинально оригинальное
тем: темы теме
применя: применяют
пришл: пришли пришло
полн: полный
уделя: уделяют
администрирован: администрирование
дилерск: дилерской
знат: знать
знан: знаний
реформ: реформы
комментар: комментарии
рамк: рамках
сотрудник: сотрудники сотрудника сотрудников сотрудниками
приступ: приступы
работа: работающего работать работаешь работаю работает
сильн: сильной
долг: долгу
песочниц: песочница
долж: должен
услуг: услуг услуги
эталон: эталонных
подписчик: подписчики
капита: капитал
телефон: телефоны
блог: блога блог блоге
руководя: руководящих
необходим: необходимости необходимо
биолог: биология
норб: норбит
модел: модели
сложност: сложность сложности
сотруднича: сотрудничать
вниман: внимание внимания
перевезт: перевезти
привед: приведем
экономист: экономисты
автор: авторы авторов автором
чита: читать читается
отсвечива: отсвечивают
некуд: некуда
подход: подходы подходов подход
межрегиональн: межрегиональным
пойд: пойд
самореализац: самореализации
тестирован: тестирование тестирования
нынешн: нынешних
оста: остается остаются
эксперт: экспертами
бизнес: бизнеса бизнесе бизнес
выраст: вырасти вырастить
бумаг: бумаге
реч: речь
реш: решила решили
отрасл: отрасли
международн: международных
остав: оставит
общ: общий
жизнеспособн: жизнеспособным
подгоня: подгонять
первопроходц: первопроходцем
вдохновля: вдохновляющих
состо: состоит
реж: реже
автопроизводител: автопроизводителя
профессиональн: профессиональным профессиональной
догада: догадаться
фербер: фербер
фантастик: фантастика
налаживан: налаживания
мног: многие
люб: любить
сущност: сущностей
биш: бишь
язык: язык языка
останов: остановимся
обязательн: обязательно
стил: стиле
разветвлен: разветвленной
фронтенд: фронтенд
правд: правда
разн: разных
взял: взялись
письм: письмом
хакатон: хакатон
люд: людям людей
производител: производителей
год: годах годов годы
целев: целевой
лагер: лагеря
применен: применении
аудитор: аудитория аудитории
вывод: выводам выводах
привод: приводят
перспективн: перспективную перспективным
знает: знает
отклонен: отклонений
одн: одном
ман: манн
наблюден: наблюдений
реклам: реклама
разбер: разбер
корпоративн: корпоративные корпоративный корпоративных
неповторим: неповторимую
потребн: потребности
одинаков: одинаково
подборк: подборку подборка
инструмент: инструмент инструментов инструменты
полиста: полистать
ведущ: ведущая
команд: команда команды команду команд
сообществ: сообществом
таймтрекинг: таймтрекинга
электрон: электронных
десятк: десятка
смотрет: смотреть
использован: использования
платформ: платформы
поскольк: поскольку
отмечен: отмеченным
войт: войти
массов: массово
аккаунт: аккаунт
топ: топ
марк: марк
состав: составили
деятельн: деятельности
сраз: сразу
смартфон: смартфона
подробн: подробно подробнее
вечн: вечному
нейробиолог: нейробиолога
бот: ботах бот ботов
всяческ: всячески
яндекс: яндекс
университет: университета
новост: новости
существ: существует
перв: первое первых
результативн: результативных
бол: боли
поиск: поисках поиск
заказчик: заказчиков заказчиками
прибыльн: прибыльный
привыкл: привыкли
голов: головы
календар: календаре
знайт: знайте
противореч: противоречие
боя: бояться
образовательн: образовательные
участник: участники
как: какие какого
детств: детства
голос: голосов
содерж: содержит
индикатор: индикатор
переговор: переговоров
подкрепля: подкрепляли
род: родившиеся рода
реальн: реальном реально
втор: вторых
рол: роль
сбав: сбавил
точн: точно точнее
дням: дням
партнер: партнеров
установлен: установленным
мер: мере
признак: признак
продукт: продукт
обрат: обратились обратить
готов: готовых
найт: найти
образ: образ
пояс: поясах
учет: учет учета
дорог: дорогим
предлага: предлагаю предлагаем предлагают
окт: окт
маленьк: маленьких
обзор: обзора обзор
электроник: электронику
успех: успеха
случа: случае случаев
трудозатрат: трудозатраты
практическ: практически
мозг: мозг мозга
вернут: вернуться
рейтингов: рейтинговые
принос: приносит
отста: отстающую
янв: янв
вообщ: вообще
референс: референсах референсов
преврат: превратили
показа: показать
поэт: поэтому
мин: мин
мир: мире мир миру
писа: писать писал
миф: мифы мифов
исследован: исследование исследования
вывеск: вывески
обсужда: обсуждаемые обсуждались
нестандартн: нестандартно
элп: элп
конец: конец
томат: томатов
тренд: трендах
аналог: аналогов
провед: проведено
получ: получили получил получить
подтвержда: подтверждают
важн: важно важным
дистрибутив: дистрибутивов
именова: именованных
экономическ: экономическим
национальн: национальных
час: часы
столкнул: столкнулась
ежегодн: ежегодном
уникал: уникален
индустр: индустрии
могл: могли
ярк: ярких
повышен: повышение
выделя: выделять
больш: большие большая
миллиард: миллиарда
китайск: китайским китайских китайский
мест: место
иде: идеях
карьер: карьера
офис: офисы офисов офис
пристальн: пристального
наибольш: наибольший
полезн: полезны
исполнител: исполнители
существен: существенно
эффективн: эффективную
испытыва: испытывала
представлен: представление
страшн: страшных
департамент: департамента
пыта: пытаются
сотн: сотнях
отклик: отклик
авторитет: авторитетам
развива: развивается
основн: основные
бренд: бренд бренды
основа: основанное
подготов: подготовивших
рыцар: рыцаря
решен: решение решением
провод: проводили
личн: личных
нужн: нужны
сослуживц: сослуживцами
поздн: поздно
секрет: секреты
хаб: хабы
повыс: повысились
ничегонеделан: ничегонеделанием
результат: результатах результаты
вызыва: вызывает
опыт: опыта опытом
наполнен: наполнения
трудоемк: трудоемкость
рынок: рынок
ваканс: вакансии
настройк: настройка
дантист: дантист
дал: далее
пониман: понимании
документ: документы
прочтен: прочтение
ссылк: ссылку
рациональн: рациональное
рисунк: рисунке
реал: реалиях
выросл: выросла
преддвер: преддверии
закодирова: закодированных
рафинирова: рафинированном рафинированным
дан: данными
имел: имел
весьм: весьма
дат: дать дата
имен: именем
джед: джедая
дизайнер: дизайнером дизайнера дизайнер дизайнеры
разделя: разделяет
код: кода коды
медицинск: медицинских
технологическ: технологическим
вряд: вряд
многоуважа: многоуважаемого
деньг: деньги
построен: построение
предлож: предложено
старш: старшие
конверс: конверсии
галер: галерею
сохран: сохранить
открыток: открыток
тезис: тезисы
уход: уходишь уходит
ошибк: ошибка
достич: достичь
жив: живой
обнов: обновить
покажет: покажется
разработк: разработкой разработку разработка
закладк: закладки
жил: жилой
вал: валя
уверен: уверенность
программн: программного
поколен: поколении поколений
важност: важность
пост: постов
ориентирова: ориентированы
итог: итоге
обеспеч: обеспечить
дек: дек
дел: делу дело
вопрос: вопрос вопросы
ближайш: ближайшего
рассказа: рассказать
устройств: устройство устройств
ваш: вашей
изучен: изучения
москв: москва
многопрофильн: многопрофильная
пространств: пространство
несмотр: несмотря
творческ: творческая творческих
срок: срок
покупк: покупках
сталкива: сталкивается сталкиваются
собствен: собственными собственных собственный
поздрав: поздравили
измен: изменилась
понрав: понравилось
уда: удал удалось
позад: позади
алгоритм: алгоритмы
материал: материале
телемедицин: телемедицины
мегапроект: мегапроекты
превращен: превращении
хабр: хабре хабр хабра
угл: углы
смен: сменить
обучен: обучение
продолжительн: продолжительность
аж: аж
кита: китай
посмотрет: посмотреть
практик: практику
мысл: мысль мыслит
последн: последнее последние
сам: самая самых самые
мультимедийн: мультимедийными
стартап: стартапах стартапам стартапы стартап стартапа
туториа: туториал
выполнен: выполнение выполнения
управлен: управление управления
влож: вложиться вложить
принят: принято
нашл: нашли
распознаван: распознавания
допуска: допускаемая
начина: начиналось начинающих
формир: формирует
обязан: обязанности
вс: вс
популярн: популярность популярное
прогноз: прогнозы
област: области
научн: научно научная
вэ: вэй
сво: своими своему свой
веб: веб
программирован: программирование
распределен: распределенных
нача: начать начали
специалист: специалисты специалистов
слаб: слабую
профессор: профессора
гк: гк
значительн: значительно
явля: является
нейропластичн: нейропластичности
вещ: вещах
законч: закончили
развит: развития развитие
тимлид: тимлида
бутилирова: бутилированную
сайт: сайта сайт
обеспечен: обеспечения
многомиллион: многомиллионных
колледж: колледжей
научпоп: научпоп
технолог: технологий технологиями технологии
задач: задач задача задачи задачей
пользова: пользоваться
выясн: выяснить
неочевидн: неочевидных
пар: пару
посвящ: посвящ
зерн: зерно
искусств: искусству
базов: базовые
треб: требует
истор: истории история
мышлен: мышления мышление
лондон: лондон
разъясня: разъясняет
праздник: праздник праздникам праздников
пробл: проблем
ещ: ещ
факт: факты
легк: легко легкую
сет: сетью сети
представител: представитель
конфиденциальн: конфиденциальность
умен: умение
чтен: чтения
днк: днк
выживаем: выживаемости
поздравительн: поздравительную
красн: красным
чуд: чудом
корпорац: корпораций
ищут: ищут
краск: красках
нескольк: нескольких
реальност: реальность
договор: договориться
неэффективн: неэффективность
прогресс: прогресс
хот: хотим хотите
инновац: инноваций
позволя: позволяет
эволюц: эволюция эволюции
хоч: хочу
отчитыва: отчитываться
рейтинг: рейтинг
дом: домах
специализац: специализации
исполн: исполнилось
поток: потоки
указыва: указывают
смотр: смотрите
поддержк: поддержка
призна: признать признайтесь
тысяч: тысячах тысячу
глубок: глубокое
доб: добился
принцип: принципе
пуст: пусть
ид: идеи идею
предыдущ: предыдущих
оборот: обороты
наш: нашей нашими наших нашу
ит: ит
пользовател: пользователь
выращиван: выращивания
успешн: успешных
компонент: компонентом
доллар: долларов
публичн: публичной
сервис: сервисов
информац: информация
уня: унять
оперет: опереться
ключев: ключевых
анализ: анализ
экран: экране
объедин: объединили объединившись
понят: понятия понятий понятиях
равнодушн: равнодушным
мессенджер: мессенджеры
отнош: отношусь
поговор: поговорила
собра: собрать
рецензент: рецензентам
сглажива: сглаживать
например: например
подготовл: подготовлен
правил: правилам
коллег: коллегам коллеги
миров: мировых
запуст: запустить
рекомендац: рекомендации
нативн: нативные
осужда: осуждают
польз: пользы пользу
учат: учат
вод: водится воду
иван: иванов
стран: странах стране
рассмотрет: рассмотреть
январ: января
мо: моим
четк: четко
портрет: портрет
сист: систем
новатор: новаторов новаторы
пригод: пригодятся пригодиться
комплекс: комплекс
предпринимател: предпринимателей
лан: ланит
выбор: выбору
контрактн: контрактного
онлайн: онлайн
проблем: проблемы
но: ноя
айтишник: айтишники
раздел: разделилась разделы
нетривиальн: нетривиальный
единообразн: единообразном
воврем: вовремя
лучш: лучшие лучших
управля: управляющего
относ: относятся относилась
ок: ок
возможн: возможными возможностях
оп: опыт
интересн: интересного
молод: молодые молодых молодыми
ленив: ленивый
увелич: увеличить
дает: дает
сердц: сердцу
хочет: хочется хочет
крупн: крупному крупном
функциональн: функциональные
кошелек: кошелек
грив: гривен
растет: растет
коварн: коварные
диспл: дисплей
прежн: прежнему
откр: открыть
наход: находиться
баллад: баллада
термин: терминов
big: big
aimfirst: aimfirst
data: data
cooki: cookies
galina: galina
hr: hr
led: led
pioneer: pioneers
plai: play
twitter: twitter
ner: ner
changemak: changemakers
lanit: lanit
app: app
underdog: underdogs
work: work
ai: ai
lesson: lessons
artezio: artezio
javascript: javascript
cdp: cdp
ar: ar
vk: vk
habr: habr
cleverdata: cleverdata
vr: vr
champion: champions
scienc: science
whatsapp: whatsapp
shurkaeva: shurkaeva
ru: ru
lilia: lilia
hidden: hidden
appl: apple
anastasia: anastasia
jshabolin: jshabolin
apsandakov: apsandakov
gkasatkin: gkasatkin
durex: durex
life: life
youtub: youtube
tadvis: tadviser
rss: rss
okoloweb: okoloweb
anastasiya: anastasiya
linux: linux
katjevl: katjevl
sami: samy
amamish: amamish
facebook: facebook
telegram: telegram
team: team
innov: innovators
store: store
calltouch: calltouch
balanc: balance
dairok: dairok
googl: google
china: china
sidneyxp: sidneyxp
