говор: говоря говорят говорить
банк: банке
криптограф: криптография
фактическ: фактическим
расскаж: расскажем
рассказ: рассказ
значен: значение
стат: стать статье статьях статьи статей статья
имитир: имитирующих
стар: старую старых
стан: стану
сдерж: сдержим
мнен: мнение
таргетирова: таргетированной
един: единая
последств: последствия
работ: работа работе работы работой работу
завис: зависит
показыва: показывает показывать
дополнительн: дополнительные дополнительный
сценар: сценарии
закупок: закупок
получен: получения
каст: кастом
инфраструктур: инфраструктуры инфраструктуре инфраструктура
сто: стоит
приятн: приятно
лен: лень
специализирова: специализированное
менеджмент: менеджментом менеджмент
интеграц: интеграции
каса: касается
экра: экраны
топик: топика
мобильн: мобильной
привлек: привлекая
должн: должны
публикац: публикации
скопирова: скопировать
график: графикой
моддинг: моддинга
котор: которое котором которым
времен: временем
пор: порой
эксперимент: экспериментов
ум: ум ума
свят: святым
вест: вести
связа: связанные
обратн: обратной
манифест: манифестам манифестов манифесты манифестами манифеста
либ: либо
уч: уч
проект: проектах проектов проекты проектами
связ: связи
совместн: совместной совместный
строков: строковых
зад: зада
относительн: относительно
профил: профиль профилях
приветств: приветствую
ребят: ребята
документац: документации документацией
дискусс: дискуссию
продела: проделали
верс: версий версию
член: членов
устраива: устраивал
маркетинг: маркетинг
разобра: разобраться разобрали
прост: простой простых
занима: занимается занимающегося занимаются занимаемся
свободн: свободно
криминалистическ: криминалистической
зап: запись
совместим: совместимости
умудря: умудряются
встрет: встретить
эксплуатац: эксплуатации
уровен: уровень
нов: новые новых новое
внешн: внешней
медийн: медийная
част: части частью частей часть
отбор: отбора
слож: сложилась
устро: устроено
флагма: флагманы
слов: слова
выжимк: выжимка
постоя: постоянно
отказ: отказов
нны: нные нный
системн: системного системное
сдела: сделать сделай сделаю
определен: определении
сложн: сложным сложных сложный сложнее
совет: советы советов
примен: применить
пут: путь пут путем
активн: активно
пример: пример примеров примеры примеру примера
штук: штуках
русск: русском
подключа: подключаются
расположен: расположенном
хранилищ: хранилищ хранилища
систем: системы система системах системами
узна: узнать узнаем
государствен: государственным
летн: летней летнем
частн: частная частной
курс: курсы
читател: читатель читатели
ресурс: ресурсов ресурса ресурсы
метод: методы методов
процесс: процесс процессом процесса процессов
свойств: свойства
помогут: помогут
перемен: переменных
издержк: издержки
неудач: неудачи
нси: нси
требован: требования
нных: нных
размест: разместить
актуальн: актуальным
продолжа: продолжающие
помест: поместью
подряд: подряд
помога: помогает
бесплатн: бесплатная
рынк: рынке
помощ: помощью
современ: современный современном
вых: вых
ростелек: ростелеком
приложен: приложение приложенной приложениях приложений
напряжен: напряжения
разработчик: разработчикам разработчики
выступ: выступит
командн: командной командная
здоров: здорового
заключ: заключен
довольн: довольна
промышлен: промышленной
серверн: серверное серверным
заманчив: заманчивые
нул: нуля
задержк: задержки
интерес: интересов
средств: средства
прокс: прокси
дисциплин: дисциплина
охват: охват
фаз: фазу
конкурентн: конкурентной
регистрац: регистрация
имеет: имеет
цикл: цикла
отладк: отладки
счита: считается
отсутств: отсутствие
цел: целом целое целей целью цели
цен: ценой
бунин: бунина
завел: завел
граал: граалем
кажд: каждого
настро: настроить
дзен: дзен
канал: каналы
множеств: множество множества множеством
взаимодейств: взаимодействия взаимодействию
коммерческ: коммерческом
идут: идут
сегмент: сегмента сегментах
донастройк: донастройка
пятер: пятеро
использова: использоваться использовать использовали
желез: железом железо железе
стратег: стратегий
установк: установки установке
добавля: добавляет
сюд: сюда
коробочн: коробочный коробочного
список: список
затронул: затронули
паразитическ: паразитическим
энерг: энергия
наглядн: наглядно
выдел: выделю
меньш: меньшей
след: следующее
абонент: абонентов
строк: строки
организац: организации
дизайн: дизайна дизайн
производительн: производительность производительности
концепц: концепции концепцию
попыта: попытаюсь
триллиард: триллиарды
виджет: виджете
клиент: клиентов
оптическ: оптическом
пустяков: пустяковое
так: таки такого таком таких
поменя: поменялись
течен: течение
техническ: технической техническая
оптимальн: оптимальным оптимального
баз: баз база базы базах
стойк: стойки
заметк: заметке
контролируем: контролируемых
предпочита: предпочитает
некотор: некоторые
рассмотр: рассмотрим
оберега: оберегаем
потенциальн: потенциальный потенциальные
зно: зной
количеств: количество
соглашен: соглашение
остава: оставаться
добав: добавить
просмотр: просмотров
специальн: специальное
методик: методика
дополня: дополняем
конфигурац: конфигурация конфигураций
услов: условие условиях
представля: представляет
синтез: синтез
справочник: справочников справочник справочниками
виртуальн: виртуальная
друг: друг друга
фотофиксац: фотофиксации фотофиксация
кабел: кабеля кабеле
правильн: правильное
наступ: наступило
тайн: тайные
сбор: сбора сбор сбору
дракон: дракона
конфигуриру: конфигурируем
кластер: кластере
менеджер: менеджера
компан: компанией компаниям компания компаний компании
программ: программами программы
зны: зные
ограничен: ограничений
коммуникац: коммуникаций
вчер: вчера
разбира: разбираем разбираемся
действ: действует действие
фундаментальн: фундаментальной
предъяв: предъявить
пят: пяти
созд: созда
элемент: элементы
методическ: методический
привет: привет
состоян: состоянием состояние
поможет: поможет
отдел: отдела отделе
использ: используется используются
имеют: имеются
магазин: магазин
созда: создали создать
имеющ: имеющего
помн: помнить
кейс: кейс
отдельн: отдельное
выполн: выполнить
оптимизац: оптимизация
тем: теме
применя: применяются
пришл: пришла
администрирован: администрирования администрирование
легковесн: легковесного
определя: определяет
питан: питания
знан: знаний
комментар: комментарии комментарий
поставлен: поставленных
поставк: поставки
рамк: рамках
физик: физика
сотрудник: сотрудники сотрудникам
проч: прочих
увольня: увольняются
зря: зря
компьютер: компьютером компьютерами
работа: работал работающее работаю работалось
детал: деталями
песочниц: песочницы песочница
долг: долгую
блок: блока
услуг: услуги
подписчик: подписчиками
оптик: оптика
блог: блог
необходим: необходимо
автоматизац: автоматизации
интерфейс: интерфейс
требуем: требуемой
сложност: сложности
сотруднича: сотрудничать
исправля: исправлять
привед: приведем
девайс: девайсов девайсах
автор: авторы автор автором авторов автора
футпринтинг: футпринтингом
нагружен: нагруженных
чита: читать
новинк: новинками
виде: видео
локальн: локальной
подход: подходах подходов подхода подход
попада: попадалась
тестирован: тестирование
оста: остался
заключен: заключении
пользу: пользуемся
эксперт: экспертом эксперта
спрос: спросить
типичн: типичных
тип: типов
популяризац: популяризации
аутентифицир: аутентифицирует
внедрен: внедрения
реч: речь
реш: решили решить
лаборатор: лаборатория лаборатории
олег: олега
общ: общую
накат: накатим
зада: заданным задают задает
набор: набор
поддержива: поддерживаются
включ: включились
устарева: устаревать
обм: обмен
оператор: операторов
социальн: социальные
лицензирован: лицензирования
может: можете
мног: многом многих многие
нулев: нулевые
посвящен: посвященное
люб: любого любых любой любят
снят: снятие
язык: языку языка
согласова: согласованных
планирован: планированием
содержа: содержащие
злоумышленник: злоумышленник
разн: разными разных разному
письм: письмо письма
содержим: содержимого
разв: разв
выявлен: выявление
производител: производителям
год: годы
целев: целевая
экспертиз: экспертизы экспертиз
ожидан: ожидания ожиданиям
критер: критериям
интерв: интервью
применен: применение
админ: админа админу админом
аудитор: аудитория
создан: создания
храня: хранящихся
прич: прич
вскрыт: вскрытия
привод: приводятся приводить
запис: записи
производств: производстве производства
широк: широко
мар: мар
целик: целиком
реклам: реклама рекламы
онтик: онтико
разбер: разбер
перенасыщ: перенасыщен
корпоративн: корпоративный
потребн: потребности потребность
функциона: функционала
шаблон: шаблонов
инструмент: инструменты инструмент инструментов
доклад: доклада
команд: команды команде команд
ведущ: ведущим
итак: итак
плюс: плюс плюсы
объединя: объединяют
огранич: ограничены
находя: находящихся
электрон: электронные электронная
смотрет: смотреть
устран: устранить
десятк: десятков
использован: использования использованием использовании
платформ: платформа платформы
запрос: запроса
облегча: облегчающих
войт: войти
массов: массовом
своевремен: своевременного своевременный
ценов: ценовых
аккаунт: аккаунт
состав: составе
распараллеливан: распараллеливания
глаз: глаза
смартфон: смартфоны смартфонов смартфон
репозитор: репозитории
подробн: подробно
излага: излагается
именуем: именуемую
яндекс: яндекс
новост: новости
существ: существующей существующего
перв: первую первое первая
проведен: проведение проведения
приня: принять
написа: написано написал
добр: добро
поиск: поиск
изменен: изменений
неудобн: неудобной неудобно
основ: основе
санитар: санитаров
образовательн: образовательные
как: какими каком какие каких каким
определ: определ
участник: участниками участников
голос: голосов
кат: кат
тся: тся
прошл: прошлых
высок: высокая высокой
реальн: реальные реальном
гаджет: гаджеты
точк: точка
разведк: разведки
способ: способен способ способы
дачник: дачника
продукц: продукции
компьютерн: компьютерных компьютерное
продукт: продукта продукт
конференц: конференции
бюджетн: бюджетный
готов: готовых
найт: найти
компромисс: компромиссы
влиян: влияние
информацион: информационных информационная
туннел: туннель
образ: образом
говн: говна
дорог: дорогой
линейк: линейкой
обзор: обзор
появ: появиться появились
случа: случае случаев
успех: успеха
поспособствова: поспособствовали
доступ: доступа доступы доступ
вернут: вернуться
парадигм: парадигме
выяв: выявить
сетев: сетевые
предел: пределы
сокраща: сокращаем
обновлен: обновления обновлений
гкост: гкость
децентрализова: децентрализованные
схем: схемы
субд: субд
л: л
ожида: ожидали ожидал ожидаем
п: п
хакинг: хакинг
аномальн: аномальных
р: р
централизова: централизованные
дава: давайте
ч: ч
логическ: логическое
показа: показать
поэт: поэтому
ничт: ничто
модификатор: модификаторах
зафиксирова: зафиксировать
мин: мин
вариант: вариант вариантах
мир: мир мире миру
предприят: предприятия
исследован: исследования
приручен: приручение
безопасн: безопасность безопасности
повезл: повезло
феврал: феврале
сообщен: сообщения
боев: боевой
получ: получила получу
синхронизац: синхронизации
модн: модное
приобрел: приобрела
вложен: вложения
мультитерабайтн: мультитерабайтные
перевод: перевод
компенсир: компенсируют
важн: важной важно
провел: провели
радиотехническ: радиотехнических
аргумент: аргументы
час: час часа
сосредоточ: сосредоточимся
чат: чате
внутр: внутри
измеря: измеряем измерять
индустр: индустрии
могл: могли
администрирова: администрировать
повышен: повышение повышению
больш: большие большой
мест: место
файлов: файловые
планомерн: планомерно
начин: начиная
иде: идея
карьер: карьера
инженер: инженера инженеров инженерам
вход: входа
направлен: направление направленная
игр: игра игр
существен: существенные существенное
эффективн: эффективной
развернут: развернутую развернутым
отказоустойчив: отказоустойчивость отказоустойчивости
мягк: мягко
исправлен: исправлений
вспомн: вспомним
генерац: генерации генерация
ост: оста
сетап: сетапа
жизн: жизни
эфир: эфира
подопытн: подопытного
сокращен: сокращению
момент: моменты
лишн: лишняя
пообща: пообщаться
упаковк: упаковки упаковке
основн: основные
сможет: сможет
основа: основанные основан
привест: привести
почт: почта
решен: решений решение решения решением
входн: входных
самура: самурай
личк: личку
продуктивн: продуктивного
провод: проводить проводит
средн: средний среднего
васил: василий
домашн: домашних
нужн: нужным
носител: носители
хаб: хабы
описан: описания
повыс: повысить
послуша: послушать
результат: результаты
опыт: опыте
ростелеком: ростелекома
ваканс: вакансиях
настройк: настройка
дал: далее
накопител: накопителя накопителей накопитель
документ: документы
прочтен: прочтение
пересел: пересел
ссылк: ссылку
оправдыва: оправдывает
дан: данный данном данная данными данных данной данную
следовател: следователь
дач: дача
код: кода
паттерн: паттерны
сократ: сократить
пожалова: пожаловать
генератор: генераторах генераторы
митап: митапы митап митапа
владеющ: владеющий
формирован: формирования
функц: функций
внесен: внесения
построен: построения
асек: асек
доступн: доступность доступна
заран: заранее
продемонстрирова: продемонстрировать
политик: политики
тезис: тезисах
уход: уходят
позабот: позаботиться
обнов: обновить
объект: объекта объекте объектом
разработк: разработкой разработке разработка разработки
закладк: закладки
разработа: разработали
постановк: постановка
продолжен: продолжение
программн: программных программные программного программный программное
изнутр: изнутри
учитыва: учитывают
справочн: справочную
преимуществ: преимущества
пост: пост посте
коллекц: коллекций
корпус: корпуса
вспомина: вспоминаем
дел: дело деле дела
вопрос: вопроса вопрос вопросы вопросов
рассказа: рассказали рассказать
внутрен: внутреннего
устройств: устройствами устройство устройством
размер: размеры
ваш: вашего
договарива: договариваться
ответ: ответить ответы ответом
полност: полностью
запакова: запакованном
несмотр: несмотря
проектирован: проектирования проектирование
сталкива: сталкиваемся
срок: срокам сроков сроки
собствен: собственных собственно собственный собственного
измер: измерить
уда: удал
неотъемлем: неотъемлемая
деш: деш
минус: минусы
мегапроект: мегапроекты
целостн: целостности
хабр: хабр
заканчив: заканчивая
восстановлен: восстановление
отношен: отношениям отношении
механическ: механические
ртыван: ртывание ртыванием ртывания
палок: палок
разлага: разлагаться
практик: практик практике
последн: последние
заблаговремен: заблаговременно
сам: самое самых
манипулирова: манипулировать
настраива: настраиваете
стартап: стартапам
туториа: туториал
бз: бз
выпендр: выпендриться
подключен: подключение подключении
организова: организовать
оказыва: оказывает
подобн: подобной
посмотр: посмотрите
выполнен: выполнения
длин: длина
касперск: касперского
управлен: управление управления
предназначен: предназначенного
сбо: сбоям
жутк: жуткой
вед: вед
руковод: руководят
начина: начинается начинающие
стандарт: стандартом
внедр: внедрить
расстоян: расстояний
вс: вс
сопровожден: сопровождения
сотрудничеств: сотрудничество
начн: начну
достига: достигать
сво: своему свой
веб: веб
программирован: программирование
распределен: распределенных
первостепен: первостепенное
реша: решающее решают решаю
специалист: специалистом
порог: порог
просто: простоя
станов: становится
атак: атаки
значительн: значительными значительным
хранен: хранению
явля: являющая являлся являются является
появлен: появлении
уголовн: уголовного
развит: развитии развития
де: де
первичн: первичный
представ: представить
сайт: сайта
обеспечен: обеспечения
многомиллион: многомиллионные
оборудован: оборудованием оборудование
научпоп: научпоп
технолог: технологию технологии
терп: терпим
задач: задачи задач задачах задача
происход: происходит
ускорен: ускорения
тренинг: тренинги
пользова: пользовался
различн: различные различных
хвата: хватало
инженерн: инженерные инженерных
техпис: техписов техписа
посвящ: посвящена
треб: требуют
истор: историю истории история
зовут: зовут
посвят: посвятить
пробл: проблему
факт: факто
ещ: ещ
насущн: насущными
гибк: гибким
сем: семи
сер: серии серь
сет: сетью сети сеть
конфиденциальн: конфиденциальная конфиденциальность
вид: вид виде
обслужива: обслуживать обслуживающих
разумн: разумно
прошивк: прошивкой
розетк: розеткой
нескольк: нескольких
вышеперечислен: вышеперечисленных
реальност: реальность
биллингов: биллинговых
аномал: аномалии аномалиях
договор: договор
обеща: обещали
позволя: позволяют позволяет
платн: платный
хоч: хочу
предоставлен: предоставление
рейтинг: рейтинга рейтинг
скорост: скорость скорости
дом: дом
способн: способны
известн: известно известные известными
сторон: стороны
поток: потоки потока
кратк: краткая
поддержк: поддержкой поддержка поддержку
предостав: предоставить
тысяч: тысяча
хорош: хороший
стоимост: стоимости
ид: ид
зашифрова: зашифрованный
предыдущ: предыдущей предыдущих
ин: иной
наш: нашей наших
пользовател: пользователем пользователей
успешн: успешная успешной
компонент: компонентов
большинств: большинство
умн: умная умный
издел: изделии изделий
план: плана плане
доллар: долларов
сервис: сервисов сервисам сервис сервисами сервисы
соответствова: соответствовала
информац: информацию информацией информация информации
облачн: облачные
ключев: ключевых
анализ: анализ
способств: способствующей
удален: удаленной удаленного
ровн: ровно
спуст: спустя
высоконагружен: высоконагруженных
мессенджер: мессенджеры
поговор: поговорим
хуж: хуже
черн: черного
собра: собрать
контрагент: контрагентов
например: например
производствен: производственным
подготовк: подготовка
отправля: отправлять
кастомн: кастомной
коллег: коллег коллеги
классн: классной
нагрузк: нагрузкой нагрузки
соответств: соответствующее
нативн: нативные
надежн: надежность надежности
огромн: огромную
интуитивн: интуитивно
польз: пользуются
рассмотрел: рассмотрели
познаком: познакомиться
ответствен: ответственных
нормативн: нормативно
отлич: отличия
свет: света
импортозамещен: импортозамещение импортозамещенного импортозамещения
стекл: стекле
включа: включаем
сист: систем
специфичн: специфичный
углублен: углубленно
душ: душа
свеж: свежий
качеств: качестве
распредел: распредел
прошел: прошел
комплекс: комплекса
выбор: выбора
проблем: проблемы проблемой проблемами проблема
давност: давности
сервер: сервер серверов
поближ: поближе
поставщик: поставщиков
раздел: разделы
автоматическ: автоматически
фиксирова: фиксированной
нетривиальн: нетривиальных
аббревиатур: аббревиатура
нек: некий
унифицирова: унифицированно унифицировать
лучш: лучшие
борот: бороться
дума: думаю
формат: формате
возможн: возможности
интересн: интересно интересные
дальн: дальнейшем
этичн: этичный
ос: ос
биржев: биржевой
сотов: сотовой
открыт: открытых
выбра: выбрал
отображен: отображения
обещан: обещание
хочет: хочет
функциональн: функционального функциональное
сот: сотен
крупн: крупных
непосредствен: непосредственная
сконфигурирова: сконфигурированных
крут: крутыми
пк: пк
меша: мешает
обобщ: обобщу
взгляд: взгляд
бывш: бывшие
контент: контентом
прежн: прежним
откр: открыть
видеокамер: видеокамеры
подбор: подбор
термин: терминах
источник: источников источниками
big: big
sourc: source
dml: dml
polina: polina
extens: extensible
devop: devops
argocd: argocd
intellig: intelligence
ssh: ssh
marshmallow: marshmallow
helm: helm
highload: highload
number: number
twitter: twitter
statefulset: statefulset
teamview: teamviewer
api: api
nix: nix
jump: jump
profession: professional
python: python
edeshina: edeshina
manag: manager management
senior: senior
otu: otus
hft: hft
habr: habr
rl: rl
engin: engineering
server: server
pod: pod
optim: optimizer
sdy: sdy
secret: secret
anydesk: anydesk
galaxi: galaxy
youtub: youtube
sd: sd
rss: rss
bodyawm: bodyawm
jsonnet: jsonnet
kustom: kustomize
southbridg: southbridge
packag: package
man: man
power: power
kali: kali
dimitryabramov: dimitryabramov
ci: ci
facebook: facebook
googl: google
mahahaxep: mahahaxep
reliabl: reliability
chao: chaos
open: open
data: data
dii: diy
lab: lab
deploy: deployment
atd: atd
cloud: cloud
oracl: oracle
hiper: hiper
yaml: yaml
golovind: golovinds
mizhka: mizhka
dba: dba
averina: averina
bercut: bercut
itzm: itzme
servic: service
na: nas
vk: vk
alexand: alexander
mdm: mdm
gitlab: gitlab
squid: squid
primetalk: primetalk
android: android
cad: cad
timeweb: timeweb
kasperski: kaspersky
kubernet: kubernetes
cam: cam
docker: docker
samsung: samsung
git: git
postgresql: postgresql
linux: linux
debian: debian
json: json
osint: osint
kiv: kiv
ora: ora
openvpn: openvpn
dannyk: dannyk
gm: gms
custom: customization
sre: sre
telegram: telegram
ddl: ddl
gitop: gitops
master: master
footprint: footprinting
micro: micro
vpn: vpn
postgr: postgres
cadbas: cadbase
