готов: готовы
дорос: дорос
криптограф: криптография
информацион: информационные информационных информационная
понима: понимаете
расскаж: расскажу
значен: значение
образ: образом
стат: стать статье статьи
имитир: имитирующих
ввод: ввода вводом ввод
стар: старую
окн: окнами окно
рабоч: рабочих
конц: концов конце
стал: стало
мнен: мнение
спрайт: спрайтов
обзор: обзор
таргетирова: таргетированной
появ: появиться появились
реализова: реализовать
един: единой
работ: работа работе работы работ
показыва: показывать
дополнительн: дополнительный
практическ: практическое практически
сценар: сценарии сценариев
доступ: доступа
вернут: вернуться
парадигм: парадигме
выяв: выявить
терминал: терминалы
принос: приносит
четверт: четверть
пол: поле
комбинац: комбинацией
сто: стоило
представьт: представьте
гкост: гкость
децентрализова: децентрализованные
слома: сломать
менеджмент: менеджмент
тк: тк
интеграц: интеграции
экра: экран
л: л
мобильн: мобильных
неприятн: неприятной
п: п
привлек: привлекая
снижен: снижения
должн: должны
централизова: централизованные
публикац: публикации
структур: структуру
скопирова: скопировать
интегратор: интеграторов
график: графикой
ч: ч
готофоб: готофобия готофобией
логическ: логически
подел: поделиться поделюсь
показа: показать
поэт: поэтому
благодар: благодаря
котор: которому которыми
времен: временах временем
провест: провести
мин: мин
мир: мир мире
эксперимент: экспериментов
писа: писать
назначен: назначения
свят: святым
совершен: совершенный совершенно
прав: правил править правах
связа: связанных
бур: бурю
безопасн: безопасность
проверя: проверять
проект: проекты проекте проекта
связ: связи
версион: версионная версионной
относительн: относительно
упроща: упрощаем
профил: профиль
бекграунд: бекграунд
дела: делает
нажа: нажать
проектн: проектной проектно проектных
получ: получился получилось получим
приобрел: приобрела
документац: документации
полага: полагается
перевод: перевода перевод
верс: версиями версию версией
читальн: читальный
кроссплатформен: кроссплатформенных
маркетинг: маркетинг
ищет: ищет
час: час часов
дружелюбн: дружелюбными
столкнул: столкнулись
чат: чат
прост: простой простейших
зациклива: зацикливаются
ауд: аудио
зал: зал
сосед: соседей
здравств: здравствуй
индустр: индустрии индустрия
справ: справится
вред: вреде
свободн: свободно
влива: вливаются
могл: могли
перемеща: перемещаться
повышен: повышение
уровен: уровень
очевидн: очевидно
нов: новые новое
птд: птд
умеет: умеет
сверх: сверху
больш: большие большая большом
софт: софт
медийн: медийная
мест: место
анимац: анимация
част: часть частью части
файлов: файловые
планомерн: планомерно
карьер: карьера карьеры
направлен: направленная
аналогичн: аналогичные
игр: игр игре
постоя: постоянно
отказ: отказов
нны: нные
телегр: телеграм
рожден: рождения
сложн: сложный сложных сложно
отказоустойчив: отказоустойчивость отказоустойчивости
представлен: представление
примен: применим применить
пут: путь путем
символическ: символическую
жизн: жизни
пример: примерами примеры
упорн: упорной
раскладк: раскладки
хранилищ: хранилищ хранилища
систем: система системы системах
персонаж: персонажей
самолет: самолет
должност: должности
класс: класса
провал: провалу
рефакторинг: рефакторинг
узна: узнайте
обсужден: обсуждений
смож: сможем
дополн: дополним
труд: трудов
микросервис: микросервисы
сожален: сожалению
вышл: вышло
текущ: текущей
сможет: сможет
ресурс: ресурсов
машин: машинное машин
процесс: процессов процесс процессе
аппарат: аппаратов
класт: класть
одномоментн: одномоментно
привест: привести
почт: почта
решен: решения
требован: требование
хотел: хотел
высококлассн: высококлассными
средн: средний
номер: номер
удачн: удачным
подряд: подряд
помога: помогает
меня: меняли
хаб: хабы
рисова: рисовать
нрав: нравится
материа: материал
повыс: повысить
современ: современных современный современном современными
помощ: помощь помощью
выбира: выбирали
приложен: приложениями приложение приложения приложений приложением
выполня: выполняемых выполняться выполнять выполняется
разработчик: разработчик разработчикам разработчики
результат: результате результатами результаты
спойлер: спойлер
красив: красивые красиво красивого красивости
оживля: оживляет
трудоемк: трудоемкая
склад: складами
настройк: настройка
вклад: вклад
дал: далее
текст: тексты тексте
контекст: контексте контекста
разброса: разбросанных
товарн: товарными
документ: документы документов
прочтен: прочтение
входя: входящий
корректн: корректно
ссылк: ссылку ссылкой
выросл: выросла
помножен: помноженная
интерес: интересов интересам интересы
агент: агентом
жертвова: жертвовать
дан: данный данная данными данных данные данную данной
дисциплин: дисциплина
сравнен: сравнению
программист: программистов
дат: дату
весьм: весьма
векторн: векторной
закон: закону
код: код кодов коде кода коды
регистрац: регистрация
сократ: сократить
ситуац: ситуации
пчел: пчела
соединен: соединения
мрак: мрак
функц: функции
причин: причина
внесен: внесением
упрост: упростить
архитектурн: архитектурный архитектурного архитектурному
цел: целью целую
изолирова: изолированные
граал: граалем
звуч: звучит
поступательн: поступательным
доступн: доступность
кажд: каждом
возника: возникает возникающей
асинхрон: асинхронность асинхронное
миграц: миграции миграция
продемонстрирова: продемонстрированы
российск: российских
дзен: дзен
канал: каналы
конвертер: конвертера
множеств: множество
взаимодейств: взаимодействия
вмест: вместо
форматирова: форматированную
искусствен: искусственный
ошибк: ошибки
обнов: обновить
разработк: разработке разработку разработка разработки
закладк: закладки
серьезн: серьезным
использова: использовать
графическ: графическими
разработа: разработать
синхрон: синхронное
поколен: поколениями поколения
коммьюнит: коммьюнити
перемест: переместить
отечествен: отечественном
изнутр: изнутри
учитыва: учитывают
сюд: сюда
настоя: настоящих
преимуществ: преимущества
список: список
паразитическ: паразитическим
наглядн: наглядно
ввест: ввести
ориентирова: ориентированному
итог: итоге итоги
минут: минут
след: следующие следующая следующим
пыт: пытаясь
клетк: клетки
напомн: напомню
строк: строки
дел: дела
вопрос: вопрос
дизайн: дизайн
антишаблон: антишаблон
производительн: производительность
концепц: концепция
устройств: устройство устройств
статус: статус
пришел: пришел
размер: размеры размером
клиент: клиентов клиент
ваш: вашем
так: таких
ответ: ответ ответа
изучен: изучение
зрелищн: зрелищных
башнипинефт: башнипинефть
пространств: пространству
проектирован: проектирование
сталкива: сталкивался
собствен: собственных
течен: течением
ручн: ручным
оптимальн: оптимальную
техническ: техническая технические
измен: изменился
суток: суток
нефтянк: нефтянке
уда: удалось
алгоритм: алгоритмы
внушительн: внушительный
контролируем: контролируемых
собира: собирались
подошл: подошли
мегапроект: мегапроекты
описыва: описываемому
хабр: хабр
смен: сменил
рутин: рутинная
обучен: обучение
отношен: отношениям
авторизац: авторизации
оберега: оберегаем
рассмотр: рассмотрим рассмотрены
потенциальн: потенциальные
иска: искать
удовлетворя: удовлетворяет
подума: подумайте
количеств: количество количестве
введен: введение
соглашен: соглашение
полез: полезен
куч: куча
добав: добавим добавить
разлага: разлагаться
просмотр: просмотров
практик: практике
ах: ах
посмотрел: посмотрели
дополня: дополняем
зна: знаем
автомат: автоматов
сам: самый самым
представля: представляет
синтез: синтез
интеллект: интеллект
штрихкод: штрихкодов
друг: друг друга
куплен: купленная
стартап: стартапам
туториа: туториал
приход: приходится приходить приходит
выглядет: выглядеть
тайн: тайные
сбор: сбора
смежн: смежных
подобн: подобный подобных подобной
называ: называется
компан: компаний компании
выполнен: выполнения
рассказыва: рассказывал рассказывали рассказываем
программ: программ программы
коммуникац: коммуникаций
управлен: управление управления
вчер: вчера
предназначен: предназначению
полет: полета
неожида: неожиданно
фундаментальн: фундаментальной
уважа: уважаемое
соответствен: соответственно
удобочитаем: удобочитаемостью
сбо: сбоям
ненормальн: ненормальное
страда: страдающие
пят: пятая
элемент: элементов элемент
недорог: недорогих
век: века
начина: начинали начинался начинать
привет: привет
месторожден: месторождений
вс: вс
популярн: популярное
покаж: покажу покажите
ускор: ускорить
начн: начн
визуальн: визуальное
имеют: имеют
использ: используют
научн: научно
раз: раза
созда: создают создать
колдовск: колдовской
учетн: учетными
плагин: плагин
сво: свой
веб: веб
помн: помнить
скольк: скольких
кейс: кейсом кейс
программирован: программирование программировании программирования
распределен: распределенных
первостепен: первостепенное
нача: начать
отдельн: отдельные
непониман: непонимания
реша: решать
специалист: специалисты
порог: порог
просто: простоя
станов: становится
интернет: интернете
значительн: значительным
тест: тестов
хранен: хранения
реализац: реализацию
явля: является являющегося
игров: игровой
колоссальн: колоссальный
дорогостоя: дорогостоящих
тем: тема темы
спроектирова: спроектировать
привычн: привычный
архимейт: архимейт
полн: полному
администрирован: администрирование
развит: развития развитием
представ: представить
сайт: сайта сайтов
рстку: рстку
контрол: контроля
знак: знаком
научпоп: научпоп
технолог: технологий технологию технологии
комментар: комментарии
задач: задачу задачах задача задачи задач задачей
пользова: пользоваться
сотрудник: сотрудникам сотрудники
оповест: оповестить
нейросет: нейросети
компьютер: компьютеры компьютерами
работа: работаю работает работать
закидыва: закидываем
сильн: сильно
песочниц: песочницы песочница
лоскутн: лоскутный
долж: должен
вызва: вызвал
услуг: услуги
искусств: искусство
следовательн: следовательно
треб: требуется
высококачествен: высококачественными
блог: блог
необходим: необходимых
нефтян: нефтяные
истор: историй истории история
зовут: зовут
зрен: зрения
ход: ходе
интерфейс: интерфейсами интерфейс
двум: двумя
летательн: летательных
модел: моделях модели
пробл: проблем
сложност: сложности сложностью
рстка: рстка
ещ: ещ
комнат: комнату
привед: приведем
сем: семи
автор: авторы авторов автором
реакц: реакции
чита: читать
сет: сети сеть
конфиденциальн: конфиденциальная конфиденциальность
вид: вид
неузнаваем: неузнаваемости
подход: подходов подхода подход подходу
попада: попадают
сканер: сканер сканера сканеры
науч: научимся научить
тестирован: тестирование
историческ: исторические
естествен: естественный
нескольк: нескольких
ущерб: ущерб
пользу: пользуемся
бизнес: бизнеса бизнес
эмулятор: эмуляторе
контролирова: контролировать
позволя: позволяющее позволяющую позволяет
дойд: дойд
характеристик: характеристики
сумм: сумму
хоч: хочу
внедрен: внедрению
рейтинг: рейтинг рейтинга
скорост: скорость
реш: решили
способн: способны
известн: известных известные
общ: общего общую
фоб: фобии
объ: объем
исполн: исполнится
поток: поток потоки
поддержк: поддержка
недел: неделе
принцип: принципы принципов
серг: сергей
профессиональн: профессиональный
ид: идеи
социальн: социальные
предыдущ: предыдущей предыдущая
наш: нашего нашей нашу
ин: иное
редактор: редакторе
реферат: рефераты
пользовател: пользователя пользователю
мног: многие
наблюда: наблюдать
успешн: успешности
люб: любая любой
язык: языке языками языка
заказ: заказов
затрат: затраты
сканирова: сканировать
минималистичн: минималистично
сервис: сервиса сервисов сервисами сервисы
информац: информация информации
описа: описать описанное
фронтенд: фронтенда
боязн: боязнь
разн: разные разных
незапамятн: незапамятных
анализ: анализ
видим: видимый
посещен: посещения
создад: создадим
лоскуток: лоскуток
велосипедостроен: велосипедостроении
ровн: ровно
удовольств: удовольствие
экран: экране
отталкива: отталкивались
цикломатическ: цикломатической
упорядоч: упорядочить
трудност: трудностями
ожидан: ожиданием ожидание ожидания
зачаст: зачастую
крошечн: крошечное
сборк: сборки
мессенджер: мессенджеры
применен: применение
футуристическ: футуристическими
создан: создания создании создание
размещен: размещения
клеточн: клеточных
прич: причем
приш: приш
звонок: звонок
дожда: дождаться
фолд: фолды фолдами
запис: записями
предстоя: предстояло
например: например
одн: одна одном одну
правил: правилам
мар: мар
коллег: коллеги
согласн: согласно
реклам: реклама рекламы
прид: прид прида
корпоративн: корпоративного корпоративный
потребн: потребности
нативн: нативные
помощник: помощника
шаблон: шаблону шаблона шаблон
надежн: надежность
огромн: огромный
команд: команда команду команды командой команд
ведущ: ведущих
польз: пользуются
экземпляр: экземпляр
любопытн: любопытно
архитектор: архитектора
врод: вроде
электрон: электронная
инструкц: инструкции
смотрет: смотреть
устран: устранить
десятк: десятки
использован: использование использования
платформ: платформ платформы платформах платформу
мо: моей
запрос: запроса запрос
вследств: вследствие
сист: систему систем
специфичн: специфичный
углублен: углубленно
песн: песни
зацикл: зациклится
войт: войти
исходн: исходные исходный
распредел: распредел
выживан: выживания
аккаунт: аккаунт
комплекс: комплексов
участк: участков
выбор: выбору
автоматизир: автоматизируй
наскольк: насколько
смартфон: смартфоны смартфоне
порядк: порядку
проблем: проблемы проблемой проблемам проблема
сервер: сервера
ужас: ужас
бот: бот бота
раздел: разделы
располага: располагает
нек: некий
яндекс: яндекс
новост: новости
лучш: лучшие лучших
существ: существуют
незнан: незнания
перв: первое первой
умнож: умножим
проведен: проведения
операц: операция операции
приня: принять
добр: доброе
написа: написать
поиск: поиск поиске
интересн: интересно интересным
изменен: изменения
заказчик: заказчикам
тсд: тсд
кодирован: кодирования
блокиру: блокируя блокируем
коробк: коробки
валя: валяется
выбра: выбранного
образовательн: образовательные
как: какими какого
крупн: крупными
функциональн: функциональность
голос: голосов
покрыт: покрытием
неуспешн: неуспешности
рассматрива: рассматривали рассматривать
взгляд: взгляд
прибега: прибегать
применим: применимо
прошл: прошлого прошлой прошла прошли
реальн: реальные реальном
лома: ломается
точн: точно
рол: ролей
сфер: сфера сфере
установлен: установленным
платформоспецифичн: платформоспецифичным
откр: открыть
способ: способен способов способ способами
справля: справляется
компьютерн: компьютерных
ретроспектив: ретроспектива
продукт: продукта
кнопк: кнопки кнопку
рн: рн
studio: studio
bin: bin
pv: pvs
sfml: sfml
haqreu: haqreu
callkit: callkit
mangooffic: mangooffice
number: number
twitter: twitter
java: java
rip: rip
troyi: troyy
hex: hex
vim: vim
surf: surf
python: python
vmihaylov: vmihaylov
frp: frp
io: ios
javascript: javascript
ispmanag: ispmanager
bashnipineft: bashnipineft
otu: otus
angular: angular
rostbutaev: rostbutaev
habr: habr
anim: animator
engin: engineering
tlhe: tlhe
ru: ru
simbirsoft: simbirsoft
appl: apple
youtub: youtube
valid: validator
raspberri: raspberry
dart: dart
rss: rss
goto: goto
prettifi: prettifier
gildedros: gildedrose
alexrussianpyth: alexrussianpyth
chatgpt: chatgpt
timestamp: timestamp
dimitryabramov: dimitryabramov
alizar: alizar
svg: svg
facebook: facebook
dmitryspb: dmitryspb
ssot: ssot
maycod: maycode
chao: chaos
viktorz: viktorz
sivchenko: sivchenko
offic: office
evklidtop: evklidtop
view: view
html: html
iskorkin: iskorkin
textscalefactor: textscalefactor
net: net
swift: swift
mm: mm
massiv: massive
vd: vds
translat: translate
uiviewcontrol: uiviewcontroller
market: market
flutter: flutter
vk: vk
unix: unix
nmivan: nmivan
code: code
maxrokatanski: maxrokatansky
jwt: jwt
android: android
life: life
rust: rust
tagir: tagir
grigoryvp: grigoryvp
linux: linux
combin: combine
json: json
kornerr: kornerr
dto: dto
nvim: nvim
tangro: tangro
telegram: telegram
control: controller
mobilesimbirsoft: mobilesimbirsoft
mango: mango
srp: srp
valeev: valeev
pi: pi
neovim: neovim
time: time
olegchir: olegchir
base: base
