расскаж: расскажем расскажу
экспериментальн: экспериментально
стат: стать статью статье статьи статей статья
оказа: оказалось
обычн: обычных
стар: старую
стал: стало
составлен: составление
мнен: мнение
локац: локациях
объясн: объяснен
изыскан: изысканий
получател: получателей
чья: чья
превыша: превышает
работ: работа работе работу работы
дент: дент
показыва: показывать
поз: позу
новаторск: новаторской
инфраструктур: инфраструктуре инфраструктура
менеджмент: менеджмент
пункт: пункту
лазер: лазер лазеры
мобильн: мобильным мобильных мобильные мобильного
структур: структуры
публикац: публикации
скопирова: скопировать
микромобильн: микромобильности
подел: поделиться
человеческ: человеческим человеческой человеческого
запас: запасов
благодар: благодаря
назван: названием
котор: которое котором которым
времен: временной
эксперимент: эксперименты экспериментов
моделирован: моделированию
реализовыва: реализовывали
связа: связанных
участвова: участвовала
прав: правила
обратн: обратной обратного
проект: проектах проектов проекты проекта
связ: связи связью
вперв: впервые
совместн: совместно
заб: забыв
относительн: относительно
анализирова: анализировать
профил: профиль
верх: верх
сут: сути
сцен: сцен
документац: документации
верс: версию версия
маркетинг: маркетинг
разобра: разобраться
поездок: поездок
прост: простое простейший простой простейшую простые
предобучен: предобученной
альтернатив: альтернатива альтернативу
ауд: аудио
занима: занимаюсь
влива: вливаются
заработа: заработали
позвон: позвонить
уровен: уровень
нов: новый новом нового новые новыми новым
придума: придумали
умеет: умеет
подда: поддаются
медийн: медийная
част: часть части
даркстор: дарксторе
электросамокат: электросамокаты
журна: журнала
слов: слово
самоучк: самоучки
пострада: пострадал
затаска: затасканным
постоя: постоянная
системн: системности
сдела: сделать сделан
определен: определенной определенный
диффузион: диффузионные
риторическ: риторический
сложн: сложный сложное
автотест: автотестов
капот: капот
чб: чб
подчеркн: подчеркну
горлышк: горлышком
совет: советов
примен: применить
пут: путь пути
пример: пример примере примеров примеры
постигл: постигла
противоречив: противоречивыми
природ: природы
систем: система системы
узна: узнать узнал
убежда: убеждают
выд: выда
крейсер: крейсер
сожален: сожалению
курс: курсов
текущ: текущих
облада: обладает
машин: машинном машинное машинного машинным
метод: методу метод
пополнен: пополнения
групп: группа
помогут: помогут
свойств: свойствами
техник: технику
окружа: окружающего
пуска: пускать
доказательств: доказательства
написан: написание написанием
солнечн: солнечной
масштабирован: масштабирование
артур: артур
разметк: разметке разметки разметка
номер: номер номеру
обраща: обращаться
подряд: подряд
помоч: помочь
помога: помогает
бесплатн: бесплатной
онбординг: онбординга онбординг
помощ: помощи помощью
современ: современном современных современные
кайф: кайф
приложен: приложений приложениям приложения
разработчик: разработчике
обобщен: обобщения
вычислен: вычислениями вычисления вычислений
киберпанк: киберпанк
вклад: вклад
генеративн: генеративных
текст: тексты текстов текста
альф: альфа
жител: жителей
маричев: маричевым
универсальн: универсальны
будущ: будущее
наоборот: наоборот
навык: навыки
нуж: нужен
прочита: прочитав
потребова: потребовалось потребовать
борьб: борьбе
многообраз: многообразие
протестирова: протестированы
спецпроект: спецпроектов
протяжен: протяжении
закон: закон
плох: плохо
помогл: помогло
понаслышк: понаслышке
регистрац: регистрация
извест: известен
ситуац: ситуация
поисков: поисковые
эффект: эффект эффекте
отсутств: отсутствует
различ: различие
упрост: упростить
утвержден: утверждения
цел: цель
отлича: отличается
изуча: изучал
котар: котаро
дзен: дзен
множеств: множеством
создава: создавать
искусствен: искусственного искусственный
поездк: поездки
частност: частности
использова: использовать
логик: логика
безусловн: безусловно
юр: юра
достаточн: достаточно
векторизац: векторизация
почащ: почаще
сюд: сюда
список: список
сказа: сказанного
фотореалистичн: фотореалистичных
строг: строгого
пыт: пытаясь
абонент: абоненте
дизайн: дизайн
ветерк: ветерком
жарк: жаркой
бюджет: бюджету
невозможн: невозможно
сконструирова: сконструировали
попыта: попытаюсь
светов: световых
коротк: коротких короткой
так: таки такого таких таким
пыл: пыли
размеча: размечать
перевест: перевести
межгалактическ: межгалактический
баг: багами
событ: события
грабл: граблями грабли
баз: базе
техническ: техническая
мощн: мощнее
фев: фев
заметк: заметки
контролируем: контролируемая
формул: формулами
вредоносн: вредоносные
обсуд: обсудим
некотор: некоторые
рассмотр: рассмотрим
отрицан: отрицание
количеств: количество количестве
служб: служба
введен: введение
соглашен: соглашение
гибок: гибок
добав: добавить
щелкнут: щелкнуть
спорт: спорта
детерминирован: детерминированности
просмотр: просмотров
зна: знаем
интеллект: интеллекта интеллект
друг: другим
теоретическ: теоретических теоретической
наступ: наступить
сбор: сбор
неодинаков: неодинаковый
воображен: воображению
железн: железная
компан: компаний компании
рассказыва: рассказываем
программ: программ программы
ограничен: ограничений
вчер: вчера
главн: главный
фундаментальн: фундаментальных
пят: пяти
привел: привел
элемент: элемент
привет: привет
поможет: поможет
отдел: отделом
использ: использует используют
пионер: пионер
созда: создаем создаете создана создать
кирилл: кирилл
спрогнозирова: спрогнозировать
кейс: кейсов кейс
распознава: распознавать
интернет: интернет интернете
отличительн: отличительная
реализац: реализацию реализации
танахас: танахаси
оптимизац: оптимизация оптимизацию
тем: тема тему темы
привычн: привычный
пришл: пришли пришлось
полн: полными
администрирован: администрирование
пользовательск: пользовательский пользовательского
нескучн: нескучно
знан: знание
бер: бер
комментар: комментарии
физик: физика
адрес: адресов адреса
компьютер: компьютеров
работа: работала работает
сильн: сильного сильнее
долг: долгих долгий
песочниц: песочницы песочница
подсказк: подсказки
вызва: вызвал
услуг: услуги
устал: усталость
телефон: телефона
блог: блог
необходим: необходимость необходимо
модел: моделях модель моделей модели
шум: шумами
сложност: сложности
маршрут: маршрут
привед: приведу
автор: авторы автор автором авторов автора
реакц: реакцией
очеред: очередь
чита: читать
виде: видео
брата: братан
подход: подходы подходят
положен: положение
тестирован: тестирование тестирования
историческ: исторически
двоемысл: двоемыслие
спрос: спрос спроса
бизнес: бизнесе бизнес
распространен: распространения
альтернативн: альтернативное альтернативную
реч: речь
реш: решена решить
недостатк: недостатки
хайп: хайпа
оператор: операторе
фантастик: фантастика
лайфхак: лайфхаками
может: можете
слыш: слышу
мног: многие
абсурдн: абсурдная
ковалев: ковалева
зависим: зависимости
способствова: способствовало
язык: языка
планирован: планирования
заглянут: заглянуть
взят: взять
правд: правдой
разн: разное разной разных
взял: взялась
освоен: освоенным
маг: магии магия магией
люд: людей
отправк: отправка
использу: используя
интерв: интервью
физическ: физическое физических
применен: применению применения применении
создан: создания
потеря: потерянных
красавчик: красавчик
вывод: выводам
облак: облаком
антон: антона
нейросетев: нейросетевые нейросетевых
инсайт: инсайтов
одн: одному одно
прин: прин
парковк: парковке
мар: мар
реклам: реклама
настольк: настолько
корпоративн: корпоративный
улиц: улицах
выпускник: выпускники
инструмент: инструмент
команд: команду
любопытн: любопытное
корабл: корабля корабль
участ: участь
использован: использованию использования использованием
поскольк: поскольку
март: марта
песн: песни
войт: войти
сайнтист: сайнтистом
аккаунт: аккаунт
эмоц: эмоций
неотличим: неотличимые
канср: кансри
бот: ботами бот
половин: половина
кросплатформен: кросплатформенного
вполн: вполне
яндекс: яндекс
новост: новостей новости
перв: первую первому первой первые первых
проведен: проведении
написа: написали
добр: добро
поиск: поиск поисков
основ: основа
образовательн: образовательные
пассажир: пассажиров
как: какими какое каких какие каким
неконтролируем: неконтролируемы
голос: голосов
фильм: фильм
применим: применимы
прошл: прошлого прошли
высок: высокое
днях: днях
реальн: реальные реальных
точн: точную
точк: точки
сфер: сфере
рно: рной
установлен: установленного
способ: способен способа способов способом
форм: форму
браузер: браузеров
компьютерн: компьютерных компьютерным компьютерному компьютерную
улучшен: улучшения
продукт: продуктом продукт продукта
конференц: конференции
нейрон: нейронной нейронные нейронных нейронная
влиян: влиянием
перевоз: перевозя
информацион: информационная
образ: образом
тобол: тобола
самокат: самокаты самокат самокате
конц: конце
оптоэлектрон: оптоэлектронной
аспект: аспект
линейн: линейной
случа: случай
появ: появится
практическ: практический практически
домен: доменными
мозг: мозг мозгом мозга
вернут: вернуть вернуться
общеприменим: общеприменимым
представьт: представьте
датасет: датасет датасетов датасете
д: д
неприменим: неприменима
вообщ: вообще
прототипирован: прототипировании
доминир: доминирует
приблиз: приблизиться
преврат: превратить
вселен: вселенной
ожида: ожидать
основательн: основательно
личност: личность
п: п
впер: впер
коэффициент: коэффициента
дава: давай
ч: ч
логическ: логические
показа: показан показать показано
сезон: сезон сезоне
поэт: поэтому
отправ: отправился отправилось
мин: мин
памят: памяти
мир: мир мире
писа: писать
назначен: назначения
совершен: совершенно
бур: бурю
безопасн: безопасность
проскоч: проскочить
сообщен: сообщения сообщений сообщение
получ: получили получилась
перевод: перевод
важн: важнейший
тестировщик: тестировщикам
город: город города городе
газет: газеты
ищет: ищет
час: часов
чат: чат
столкнул: столкнулся
внутр: внутри
раскр: раскрыть
заодн: заодно
могл: могли
повышен: повышения
софт: софт
мест: месте местах
лайнер: лайнер
счет: счет
андр: андрей
разведочн: разведочный
игр: игры
полезн: полезно
существен: существенная
доставк: доставки
телегр: телеграм
пузыр: пузыре
эффективн: эффективность
извлечен: извлечения
представлен: представлений
генерац: генерации генерация
тьюринг: тьюринг
жизн: жизни
детоксификац: детоксификации
скрывш: скрывшейся
спортивн: спортивные
момент: моменты
обсужден: обсуждений
основн: основном основной основная
сможет: сможет
хамад: хамада
классифицир: классифицирующую
математик: математика математики
неплох: неплохой
решен: решений решения
провод: проводим
средн: средний
личн: личного личную
нужн: нужном нужное
хаб: хабы
аналитическ: аналитическими
выполня: выполнять выполняется
результат: результат
вызыва: вызывающем
опыт: опыте
наполнен: наполненной
трудоемк: трудоемкость
одноимен: одноименный
ваканс: вакансии
настройк: настройка
обнаруж: обнаружил
дал: далее
явлен: явления
матричн: матричными матричные
эмигрант: эмигрантов
контекст: контексте
пониман: пониманию понимании
документ: документы документами
прочтен: прочтение
предложен: предложенных
ссылк: ссылку
захлам: захламить
фокус: фокус
транспортн: транспортную
восприят: восприятие восприятии
имел: имела
дан: данных данными данные данной данный данного
коррекц: коррекции
сподвигл: сподвигло
установ: установить
дат: дата дать
указа: указать
код: кода код коде
технологическ: технологических
пожалова: пожаловать
медлен: медленно
функц: функцией
используем: используемой
наткнул: наткнулся
продюсер: продюсер
понадоб: понадобятся
джеффр: джеффри
предлож: предложу предложил
старш: старший
детищ: детища
доступн: доступны
мур: мура
бутылочн: бутылочным
резервуар: резервуаров
минимум: минимуму
рассчита: рассчитал
вмест: вместе
филип: филип
ошибк: ошибки
обнов: обновить
объект: объекта объектов
разработк: разработка
закладк: закладки
перифер: периферию
постановк: постановка
программн: программное
руководств: руководство
перемест: переместился переместились
полупроводников: полупроводниковый
преимуществ: преимуществами
пост: посте
онборд: онбордил
итог: итоге
загадк: загадки
занижен: занижения
дел: дело
вопрос: вопроса вопрос
внедря: внедряются
устройств: устройство устройства устройств
текстов: текстовых текстовые текстовой
хакер: хакеры
суперлайфхак: суперлайфхаков
ответ: ответ ответы
обывател: обывателя
экзопланет: экзопланетам
пространств: пространство
несмотр: несмотря
сталкива: сталкивались
собствен: собственный
переписа: переписал
измен: изменилась
кенг: кенго
алгоритм: алгоритм алгоритмов алгоритма
расширен: расширения
материал: материалов
ирин: ирина
мегапроект: мегапроект мегапроекты
хабр: хабре хабр
обучен: обученную обучением обученных обучения обучении обучение
иска: искать
центавр: центавру
расстав: расставить
умест: уместен
пространствен: пространственно
месяц: месяца
фантастическ: фантастических
стартап: стартапам стартапа
туториа: туториал
переда: передают
оказыва: оказывается
абсолютн: абсолютно
подобн: подобно
точност: точность точности
управлен: управление
характер: характера
неожида: неожиданного
допуска: допускать
юридическ: юридическими
руковож: руковожу
смысл: смысл
расстоян: расстоянии
вс: вс
популярн: популярное популярность популярна популярности
област: области
научн: научном научно научная
простот: простоты
сво: своем свой
веб: веб
недетерминирова: недетерминированная
пассажирск: пассажирский
программирован: программирование
итм: итмо
реша: решать
порог: порог
соревнован: соревнования
станов: становятся
каршеринг: каршеринге
тест: тест
легион: легион
явля: является являются
появлен: появлению
хобб: хоббит
раздут: раздутом
теря: теряться
развит: развитие
кротов: кротова
спаст: спасти спастись
интенсивн: интенсивностью
непредсказуем: непредсказуемый
сайт: сайта
контрол: контроль
обеспечен: обеспечение
научпоп: научпоп
технолог: технологии
задач: задачу задачи задач задача
зеленск: зеленский
нейросет: нейросети нейросеть нейросетей
трем: трем
поучительн: поучительном
посвящ: посвящена
треб: требует
зовут: зовут
истор: истории история
обуч: обучим
зрен: зрением зрения
мышлен: мышлении
факт: факт факте факта
ещ: ещ
призыва: призывают
психолог: психологии
биологическ: биологической
сер: серии серия
сет: сеть сети сетей
вид: видах
конфиденциальн: конфиденциальность
информатик: информатику
следу: следуя
внов: вновь
науч: научились научиться
естествен: естественного
реальност: реальность
аномал: аномалией
неэффективн: неэффективно
повтор: повториться
хот: хотите
позволя: позволяют позволяет
фотон: фотонными фотонных
хоч: хочу
поврежден: поврежденного
рейтинг: рейтинг рейтинга
материалист: материалистам
способн: способная способности
известн: известный
нестер: нестеров
постав: поставить
сторон: стороны
поток: потоки
поддержк: поддержка
глубок: глубокому
принцип: принцип
хорош: хорош
никит: никита
опира: опираюсь
прогнозирован: прогнозирования
наш: нашей нашем
улучш: улучшить
реферат: рефераты
пользовател: пользователя пользователей
впечатля: впечатляющими
над: надеюсь
ищ: ищем
заказ: заказу
борт: борту
доллар: доллары
сервис: сервисов
регулярн: регулярным
информац: информацию информация информации
основыва: основывается
резервуарн: резервуарными резервуарных резервуарные
выгляд: выглядит
видим: видимому
анализ: анализ
скрыт: скрытых
математическ: математическую математическая
ровн: ровно ровным
сродн: сродни
пет: пет
ребрик: ребрик
сборк: сборки
обработк: обработке
притяжен: притяжения
собра: собрали
черт: черта чертах
порожда: порождать порождают
спам: спама
например: например
подготовк: подготовке
отправля: отправляют
агрегатор: агрегатор
запуст: запустили
промежуток: промежуток
соответств: соответствующей
запуск: запуск запуске
нативн: нативные
огромн: огромные
интуитивн: интуитивных
сло: слоем слоев
познан: познания
неинтерпретируем: неинтерпретируемы
иван: иваном
стран: странных
мо: моей
исходн: исходный
качеств: качества качество
многократн: многократно
вычислительн: вычислительному
онлайн: онлайн
проблем: проблема
обнаружен: обнаружения
хинтон: хинтон
раздел: разделы
автоматическ: автоматической
титаник: титаник
исследовател: исследователь
угроз: угрозу
оцифровк: оцифровке
лучш: лучшее лучшие лучших
космическ: космической
небольш: небольшом
формат: формате
операц: операциями
облегч: облегчить
пойдет: пойдет
крайн: крайней
возможн: возможности возможными возможно
оп: опыт
интересн: интересного
регресс: регрессии регрессия
коробк: коробке коробки
выбра: выбрав
судн: судно
хабрастат: хабрастатья
взгляд: взгляд
потряса: потрясающие
поведен: поведения
опровержен: опровержения
архитектур: архитектурах архитектуры
наверняк: наверняка
изображен: изображений изображении изображения
контент: контент
втб: втб
откр: открыл открыть
наход: находились
справля: справляется
нахож: нахожу
аврамчук: аврамчук
никак: никакой
термин: термина
magic: magic
studio: studio
big: big
exploratori: exploratory
neoflex: neoflex
backpropag: backpropagation
obojealexand: obojealexander
data: data
ruvd: ruvds
superhuman: superhuman
pv: pvs
mephistophei: mephistopheies
bag: bag
analysi: analysis
ds: ds
qa: qa
twitter: twitter
vova: vova
dev: dev
faq: faq
rip: rip
whiteha: whiteha
net: net
nsai: nsays
python: python
hunt: hunt
qt: qt
eda: eda
mt: mts
ai: ai
friflex: friflex
vd: vds
otu: otus
vk: vk
recruit: recruit
nikuson: nikuson
habr: habr
haioshia: haioshia
kera: keras
numpi: numpy
itmo: itmo
neurip: neurips
engin: engineer
deep: deep
ru: ru
maxrokatanski: maxrokatansky
dvideo: dvideo
natur: natural
scientist: scientist
languag: language
trick: tricks
snaker: snakers
youtub: youtube
tensorflow: tensorflow
rss: rss
rebryk: rebryk
sansanychseva: sansanychseva
sim: sim
rko: rko
sm: sms
machin: machine
kap: kapping
chatgpt: chatgpt
yorko: yorko
sam: sam
controlnet: controlnet
takagi: takagi
zlodeiba: zlodeibaal
process: processing
product: product
alizar: alizar
learn: learning
facebook: facebook
telegram: telegram
url: url
nlp: nlp
leono: leono
whoosh: whoosh
mnist: mnist
avanmw: avanmw
newtechaudit: newtechaudit
barakadama: barakadama
