париж: выставке
барахолк: отправился находки
фактическ: система
стат: стать статьях статьи сегодняшней
стар: нашлась платформ кручение числе обо старое видел
оказа: поскольку местной продуктов
обычн: выглядел работать
перееха: понадобится
мнен: принтеров
согрева: утраченного
собственник: чехардой
став: приложения
последств: космические
работ: особенностей
завис: час
показыва: показывать
север: великого
винтажн: исследование пинать ценителей восстанавливал
терминал: часть
нке: кле
поигра: возможность
ти: потребляющий
менеджмент: менеджмент
шнурк: простенькие
то: сберечь
снижен: значительному
публикац: разделы
скопирова: скопировать
карт: машине
график: неплохую
стком: физическом
подел: старым
благодар: вариантов
котор: барахолку благодаря устройстве
времен: интернет
пот: надписью
благ: очередной
реинкарнац: привлекательной
вовс: общедоступными
внезапн: повод
уч: мс
проект: нативные
вперв: зал
аудиотехник: винтажная
профил: профиль
дела: принтеры податься
приветств: приветствую
сут: загублено
пауэрбанк: мощный
верн: повышайкам
читальн: ноутбук
верс: поддержка
антикварн: купили
маркетинг: маркетинг
некогд: поговорим
разобра: предстоит
прост: простой
воскресн: покупки
позвол: начнем
зал: читальный
рубл: купив
зам: ассоциаций
здравств: ладони
преследова: домашние
транзисторн: портативные
уровен: уровень
нов: новые друг
слот: соперник
айфон: старые
медийн: корпоративный
женск: стоптанных
част: стороне отдельное
пораньш: приезжать
наворот: шнурки
сдела: работало мника
особен: некоторых
сложн: сложный
родител: перевод
выставк: представленная
примен: применить
пут: выложена
посеща: которую
штук: странные
чм: укв
подключа: модем
систем: секторе
выход: опытом клавиатурой
кастрюл: эмалированных
узна: работы
окун: десктопы
перебра: дом
нема: попалось
сожален: душу
провайдер: происходит воли
машин: старенькая запущу вычислительную
экзотик: ретро
гомеопат: пылесос
простеньк: технологий
техник: старую компьютерной
выпуска: продолжали
мкост: борту
стким: систему
актуальн: мили
продолжа: поныне мобильников
подряд: подряд
клавиатурн: мар
рынк: глаза блошином
современ: модуляции
приложен: сохранились
тонк: лезвий
попытк: форумы
вклад: сюда
промышлен: использовались электронной
будущ: дал
лазерн: старый
утрачен: взамен
сравнен: дорога
делюксов: большая
радиопр: юность
картинк: истории собрал
музе: краеведческого
минимальн: микросхеме
испанск: побывал
наладон: выхода
регистрац: войти
цех: коллега
модуляц: амплитудной
цикл: долгожданный
цел: одну выпустить
отремонтирова: купленной
цен: уронили снижению
повышайк: параметров наворотов
середин: периферия
кажд: скачивания
радост: изоленты
дзен: яндекс
десктоп: миниатюрные
триберг: города
краеведческ: помещении
комплектова: необычных
использова: встречались упало
логик: чипа
музыкальн: технику интересных
желез: железо
стратег: такя
достаточн: использовал
пройт: работоспособностью
повседневн: наших
примерн: достичь
установк: удивительное
сюд: героем
настоя: накопитель
список: список
сказа: ролике
энерг: компьютерное
знаком: моих
тематик: ноутбучной
след: ватт
расконсервац: принтере
нашел: сетевых
дизайн: дизайн
экспозиц: неплохая
так: рассмотрим пути получились
пыл: барахла
видеотехник: выпуска
блошин: увидел
баз: девайсы
техническ: богата языка
мощн: воткнуть
моторол: прошивки
фев: пригодиться
сбереч: удалось
товар: основная
лабиринт: игра
привлекательн: неожиданно
звуков: антагонист
обсуд: пишите
некотор: производителя провел детства
рассмотр: итак
аккумулятор: мкими
клавиатур: тачпадом стиль
удивительн: создав
количеств: количество
служб: срока
обвязк: минимальной
соглашен: документы
солом: предки
древн: кат
попа: знаю
валенс: воскресной
шнур: внутри
добав: голосов
просмотр: просмотров
зна: эпохи ищу
оставл: штуки
перерыв: долгого
услов: домашних
конфигурац: частая потребление
копеек: хочу
представля: очередь париже
друг: лазерный
роутер: питание вольтам встроенным
дракон: бита
запущ: памятью
компан: данной сайта компании нетбуков
степен: иной
программ: образовательные
выглядел: диск
разбира: гараже
соответствен: стоимости
обеспечива: провайдера
велик: просторы
привел: появление
струйн: советском советский
элемент: энергия
приезжа: стараюсь
привет: барахолке
израильск: несмотря
бесперебойн: источниками смотреть
имеют: мников
изуч: некоторое коллектив
чехард: падениями
созда: замен
ран: отремонтированной
ролик: разн
стол: случай
отдельн: предоставляет
гик: лайфхаки
сохранен: диапазон
интернет: обеспечить подключения
предоставля: провайдер
необычн: собрать линейку
помещен: подвальном
игров: игры приобрел
тем: копеек
великобритан: поделка
уделя: авторов
администрирован: администрирование
фотограф: возможно
питан: элементы бесперебойное
десят: работал
комментар: закладки краткими комментариях
находк: кое
приступ: обсудим
глин: соломы
прош: поэтому
компьютер: ставить настольные наладонном
работа: проверю узнаем посмотреть
сильн: пониманием
кодобред: программирование
песочниц: хабы компьютеры
долг: служат систем
долж: ч
блок: подключить комплекте
услуг: конфиденциальность
телефон: красивые
блог: блог
числ: электронике
модел: использования долларов
сложност: сложности
параметр: примерно
вниман: уделяющих
комнат: украшением
девайс: айфоны таких
посредств: подключаемый
автор: авторы уважаемых автором
очеред: первую архитектуре
пойм: ретроспективу
футуристичн: давайте
чита: сделать
виде: музыки
превраща: выходами
тарелок: фарфоровых
фирмен: материалов
минувш: привет
быстр: аккумуляторами
зуд: графоманскому
тип: экзотику
взлет: деятельности
портативн: фэнтези сохранности
стки: настоящий
реш: компания пройти
окончан: металлолома
бит: техники
несоизмерим: памяти
набор: свой
недел: посещаю
побыва: февраля
электроэнерг: перебоях
контактн: обычная
включ: людей
повод: собственно
сред: заняли
лайфхак: питания
мног: сделай ним интересные
тачпад: полноценным
люб: многие
восстанавлива: евы
потреб: обвязкой
язык: настройка
фэнтез: жанре
стопта: кастрюль
нумерологическ: каббалистическую
стил: фирменный
критикова: любят
чердак: бесперебойного
зеркалк: первая
правд: верой
фарфоров: грудой
разн: собер цеху
дожд: благо
люд: пошел
пылесос: робот
графоманск: предпосылкой
производител: смартфоны силами
год: долгие опыта
груст: радость
потребля: терминал
физическ: стоимостью
эвм: звук
встроен: снабжают
клюшк: данных
волн: средних
одн: преследовала интернету
блин: диске
задержива: накопителей
мар: новости
настольн: видеотехника
реклам: медийная
корпоративн: услуги
пода: коммуникаторы
мегабайт: сотни
инструмент: музыкальные музыкальных
итак: компанией
уникальн: многом
электрон: развитие
смотрет: комментариями
десятк: мкость
использован: делают
платформ: закрытость
поскольк: консолей
покупок: находок
войт: аккаунт
массов: появлением вернуться
процессор: слот цикл появлению
конечн: зависит банкротством позаботиться
аккаунт: лучших
состав: конфигурации
глаз: хватает
деятельн: направлений
сраз: терминалов
производ: устройства
смартфон: моноблок
вечн: мыслями прошлый
печата: учим
упомина: некие
похож: реинкарнацией
яндекс: мегапроекты
новост: комментарии
перв: сопровождение условиях
мник: транзисторные большинство радиопри
прогнозирова: дождь
добр: пользователя интересно
поиск: поиск
преобразовател: вариант
образовательн: проекты
как: упоминании
эдак: форме
стареньк: сапог
детств: мники
подвальн: шварцвальд
голос: читать
герман: промышленности
кат: пожаловать коллекции
встреча: последствии
прошл: германии нного картой
гаджет: гаджеты старых
втор: набор
точн: забвением
точк: сказав
мобильник: производители
пузат: выпускать
форм: делать
избав: полностью
ретроспектив: небольшую ретроспектива
компьютерн: винтажной настолку старая руками
продукт: историю
термина: роутера конфигурация
найт: смог
преобразован: нумерологическую
провер: диском
влиян: большое
успел: тематики
конц: место
ждет: катом
дорог: достаточно несоизмеримо накопители
предлага: дешевле неделю
линейк: целую
маленьк: полноценный
геро: сегодняшним
обзор: детальный
качан: попытки
электроник: консоли слабость
случа: случалось чердаке коробках
появ: являлись внезапно поста
практическ: рублей
доступ: софт
продавц: включая
вернут: перерыва
выяв: стремится
сетев: инструментов
удач: испытать
схемотехник: прототипирование
сапог: женских
предк: торгуясь
мил: последней
единствен: случае
вольт: преобразователи ти
прототипирован: древних
преврат: углу
потреблен: мо
основательн: процессоры
дава: винтажных эвм
х: середине
ч: единственное
поэт: пост
отправ: менялся
мин: мин
вариант: следующий комнаты
отнест: прошу
памят: мб обычной
мир: современном
изолент: синей
каббалистическ: такими изучил
исследован: фев
диск: стким стком сткий
феврал: воскресенье
рто: пот
украшен: навсего
сообщен: скрытые
провед: появилась
получ: поколения
приобрел: оправдывает
французск: популярное
перевод: начинающих
провел: вернувшись
город: музея
дозвон: годов
рук: своими
час: временно часов
чат: халява
внутр: повышайками
сектор: промышленном
надпис: машина
могл: дисплеи
нетбук: планшеты популярности
дешевл: модели
софт: компьютера
больш: оказала компьютерная
мест: оставлено
иде: картинках
собер: эстетики
длительн: актуально
направлен: сменами
игр: драконов лабиринт делюксовая
миниатюрн: превращал
устанавлива: микросхема
представлен: установка
загубл: которое
видел: покупок
мерк: тонкий
пина: сильно
забвен: итоге
навс: являются
мод: компьютере
сокращен: новых
разыска: некоторые
полноцен: станциями фактически
сотн: десятки
смог: картинки
халяв: сидения
основн: пораньше
вышл: поиграть
премиальн: корпус
инвертор: блоки
крышк: ртой
неплох: обнаружилась клавиатуры предлагали
кле: мокрой
торгу: практически
средн: средний длинных
личн: ностальгия
домашн: обзор цен
ужасн: моторолы
удачн: самых
советск: далее печатать
меня: прогноз
хаб: публикации
вылож: товара
опыт: личного поделюсь
красив: пузатые меркам
экскурс: основательного
чрезмерн: критиковать
павел: зовут
настройк: дзен
обнаруж: триберг
дал: мся столь
накопител: твердотельных полупроводниковый х
богат: оказалась
пониман: отнестись
документ: компаний
прочтен: прочтение
ссылк: ссылку
оправдыва: стратегия
дан: идея потоке производились
имел: расширения
весьм: некогда
поделк: странная
коммуникатор: телефоны
детальн: клавиатурный
снабжа: сразу
вывезл: севера
пожалова: добро
соединен: модемного
мся: верн
ностальг: вопросу
пошел: прогнозировали
понадоб: будущем
гольф: клюшки
предлож: могла
кпк: кпк
звук: графику
спасен: песочницы
сохран: ещ степени
перебо: длительных
подключ: зарядкой
вмест: устанавливался
принтер: картриджей струйный струйном вечные
банкротств: собственников
позабот: должен
чип: потребует
достич: шнура
увидел: впервые
обнов: обновить
име: теме
разработк: разработка
закладк: добавить
паден: планшетов взлетами
перифер: схемотехника
начал: думаете
стара: покупателей
заня: нетбуки
поколен: седьмого
худш: худшее
полупроводников: представила
белоснежн: перебрались
воскресен: минувшее
пост: упоминаю данного спустя
вернувш: прошлого
коллекц: моей
корпус: красивый
итог: конечном
обеспеч: позволяют
коллект: французский
ночн: дозвоны
вопрос: внимание
устройств: навороченном портативное уникальные избавиться
развлечен: повседневных
полност: позволяет
несмотр: блинами
покупк: аудиотехника
срок: сокращение
собствен: видео
станц: инвертору док зарядную
уда: многим
экономичн: становиться
расширен: микросхемы
безраздельн: пк
материал: премиальных
мегапроект: стартапам
хабр: хабр
угл: каждом
седьм: процессоров
смен: инновациями
куп: роутер нашел разыскали удачу
коробок: вывезли
куч: превратились
посмотрет: успели
общедоступн: соответственно
мысл: мнение
последн: инноваций устройств
сам: одна
коннект: цель
куплен: дополнение
стартап: программы
туториа: гиков
дик: станции
бубн: гаджетов
жанр: вторая
подключен: технология
потребител: конечный
длин: диапазоны
работоспособн: неочевидной
неожида: устройство
нашл: переехать
эмалирова: тарелок
уважа: послужили
антагонист: компьютерный
ненормальн: вычислительная
сиротлив: рынке
нетрадицион: экскурса
век: гомеопатия
начина: электроника
лезв: эдаких
очередн: гольфа
вер: моделей
вс: радовать
прогноз: погода
популярн: научно падением
сопровожден: звуковое
начн: процессорах
простор: белоснежные
картридж: службы
воткнут: вольт
научн: кодобред
сво: обеспечивающего игр терминала
предшествова: поймем
программирован: ненормальное
порог: порог
станов: пауэрбанк
лежа: сиротливо
попробу: логики
значительн: привело
прода: родители
кручен: ждет
планшетн: появления
явля: мире вовсе
появлен: предшествовало десятых великобритании окунемся
вещ: разбираем
юност: годы
дорогостоя: купить
шварцвальд: отпуска
развит: влияние
представ: израильская
груд: нке
сайт: информация
обеспечен: потребитель
оборудован: сво
научпоп: научпоп
технолог: туториал поддержкой остальные
предсто: ужасно
происход: роутером
пользова: планшетных
хвата: предлагает
неочевидн: блоком
сегодняшн: поддержки нетрадиционных разобраться
ев: спасение
металлолом: кучу
нног: провед
истор: приступим изучая история
зовут: здравствуйте
укв: которым
зрен: точки
ещ: вс
конфиденциальн: соглашение
аськ: чаты
диапазон: имеют чм
долгожда: очереди
прошивк: зрения
неэффективн: дико
стрем: машину
инновац: техническими удачных
позволя: последних технологии
урон: глины
эпох: начале
хоч: павел
рейтинг: рейтинг рейтинга
док: комплектовались
упоминан: представляете
дом: продали
покупател: продавцов предложить
послуж: зуду
сторон: обеспечение
взам: прибор
эстетик: сохранением
ладон: коннект
поток: сообщения потоки
кратк: найти
поддержк: техническая дорогие окончания
остальн: электроэнергией
предпосылк: посредством
ценител: знакомых
стоимост: задерживалось тройка сравнении
хорош: валенсией
мким: станцию
ин: той
наш: среди
ватт: составило
слабост: имея
пользовател: конечного
ретр: какую
зарядн: дорогостоящую
зарядк: быстрой
ищ: рынки
большинств: сожалению
сил: сути
трансформер: планшет
робот: зеркалка
син: бубна
борт: имел
доллар: появились
обзорчик: конце
тройк: властвовала
прибор: антикварный
информац: песочница
барахл: моего
замет: фотографиях
скрыт: выявить
спуст: соединения
замен: трансформер
находок: испанской
погод: хорошая
дополнен: купил
испыта: решил
ко: века
упа: экономичным
поговор: статье
соперник: вечный
собра: точно попробуем
закрыт: чрезмерную
ассоциац: преобразований
служат: правдой
коллег: покупателю
наворочен: весьма
нативн: реклама
музык: качания
мб: стоимость
стран: инструменты вышла
вол: доброй
мо: оказалось появился коробок неэффективно
консол: игровые игровых
мс: принтер
местн: экспозиция
сист: необычную сегодняшний
сиден: ночные
душ: сердце
ноутбук: винтажный
пригод: девайсов
комплект: крышке
вычислительн: каббалистическая представляет
наскольк: знаем
пиш: посте
раздел: регистрация
радова: продолжают
настолк: похожа
нек: заметите
об: ранее
лучш: вклад лучшие
мокр: лежала
микросхем: вместо контактная маленькой
космическ: мегабайт
небольш: позволю
дума: типа
интересн: немало пользоваться насколько
возможн: давало обзорчика
модемн: грусть
понын: базе
форум: аська
молод: молоды
коробк: роемся
твердотельн: дорогими
планшет: разных массовых заменил
сердц: согревал
пк: цены
тематическ: тематических
властвова: безраздельно
выпуск: норвежского
моноблок: футуристичный
отпуск: прошлом
выпуст: решила
архитектур: массовой
гараж: пылилось
диспл: неплохие
ноутбучн: развлечений
откр: открыть
скачиван: доступен
норвежск: расконсервация
ро: вещи
источник: оборудование
амплитудн: волн
xx: xx
ps: ps
mechnix: mechnix
ruvd: ruvds
ssd: ssd
droman: droman
irobot: irobot
cambridg: cambridge
workabout: workabout
px: px
bio: bios
dragon: dragons
qc: qc
twitter: twitter
stillo: stillo
electron: electronics
revo: revo
modem: modem
pretec: pretec
pet: pet
ii: ii
wifi: wifi
roverbook: roverbook
mafranc: mafrance
texa: texas
intel: intel
pnp: pnp
system: systems
mikeveng: mikeveng
spectrum: spectrum
mattel: mattel
saba: saba
habr: habr
seri: series
zx: zx
flash: flash
compaq: compaq
diskonchip: diskonchip
nintendo: nintendo
psion: psion
appl: apple
transformerpad: transformerpad
artefact: artefact
youtub: youtube
rss: rss
bodyawm: bodyawm
arduino: arduino
pavel: pavel
wumpu: wumpus
mypal: mypal
surfac: surface
dial: dial
cf: cf
alizar: alizar
facebook: facebook
iru: iru
kerenskii: kerenskiy
dungeon: dungeons
googl: google
partner: partner
ti: ti
isa: isa
motorola: motorola
tm: tm
holmogorov: holmogorov
atom: atom
dataart: dataart
tr: trs
dc: dc
asu: asus
compact: compact
usb: usb
slavanikolski: slavanikolsky
dii: diy
nano: nano
sloniki: sloniki
dip: dip
mikejum: mikejum
microsoft: microsoft
wilelf: wilelf
cloud: cloud
school: school
mc: mc
commodor: commodore
sinclair: sinclair
sega: sega
hunt: hunt
selectel: selectel
hdmi: hdmi
mx: mx
moto: moto
tandberg: tandberg
tashafridrih: tashafridrih
vk: vk
gpon: gpon
dlinyj: dlinyj
amd: amd
intellivis: intellivision
gear: gear
scienc: science
game: game
eee: eee
skillfactori: skillfactory
android: android
fm: fm
timeweb: timeweb
atari: atari
instrument: instruments
organis: organiser
netbook: netbook
rom: rom
wp: wp
tandyvis: tandyvision
lunathecat: lunathecat
ereinion: ereinion
evo: evo
slvr: slvr
polaroid: polaroid
rybn: rybn
dataghost: dataghost
telegram: telegram
symbian: symbian
master: master
audioman: audioman
pc: pc
hc: hc
