обрат: обработкой
обыча: обычаями
заявк: заявки
банк: банка
понима: понимается
вступа: вступать редакция
информацион: службу рекламных
образ: образом
учет: учетом
предлага: инструментов
местонахожден: местонахождения
соглас: согласен согласий согласия согласие
отметк: отметку
случа: случае случаях исключением выразил
удал: предоставленную удалит
последств: значимые
реализова: учетную средствами
работ: работа работы
рекламн: таргетинга рекламная
дополнительн: дополнительно выполнены
доступ: доступа доступ
затрагива: последствия
правов: правовые возможности существует
получен: уведомлениях получению
пол: пол возрасту поле
комбинац: комбинацию
размеща: размещать
основан: осуществлял основания правовое
обновлен: обновление
экра: экрана
осуществлен: окончания
то: той
мобильн: мобильном
п: п
должн: должна
суд: запросу
поэт: поэтому
котор: которую отозвать которыми
осозна: осознает
отредактирова: момент
усмотрен: усмотрению
исследован: статистических
совершен: лог стороны
прав: осуществления правила уступку правом имеет
связа: кабинет
обратн: блог
подписыва: подписываются
организатор: являясь
орга: государственного
уч: уч
либ: либо
связ: поддержки привлечением
свяж: свяжитесь
феврал: направлены
выраз: третьим
профил: профиль профиля
сообщен: электронных
получ: получена использовании
договорн: существуют
режим: режиме
таргетинг: указанным
верс: версия
рся: рся
абонентск: почту
исключен: аналогичным
защ: совершения
город: город
авторизова: авторизованным
неопределен: неопределенному
прост: простой
прием: фактах
прям: прямо
правомерн: повлияет
проверк: проверку результатах
свободн: свободной свободно
возражен: имеются
зап: запись
могл: могла
лиц: лицо лиц лица лицам лицами
повышен: обновляет
действительн: остаются
специфик: определенной
нов: уведомления силу
нарушен: интересов
мест: место
част: частью
счет: счет
порядок: порядок
субъект: субъектов дальнейшей
направлен: предлагает
обезличен: обезличенном обезличенных обезличенные
аналогичн: аналогичное иным
полезн: общественно
сопровожда: сопровождающемся
определен: определения ограничивающих определенная действительными
сдела: сделана
доставк: передачи
отзыв: которое
рожден: рождения
запреща: возражать
устанавлива: устанавливать
уточнен: уточнение
извлечен: извлечение
пут: путем
толкован: толкование
операцион: операционной
заполнен: заполнения
доктрин: доктриной
систем: системы
процедур: установленной пройти
индивидуальн: индивидуального
должност: должность
возража: обрабатывались
отз: отзыва
узна: анализируются
государствен: уполномоченного
момент: течение любой
персональн: персональная персональным персональные персональных персональной персональную
охран: обеспечивает
систематизир: систематизирует
дистанцион: дистанционном
привлечен: нотификации
обрабатыва: переносить требуются запрещать
процесс: процессе
основа: основанного определение
почт: почты почте электронную
требован: требования
решен: субъектом
размест: разместившим
передава: передавать
медиатор: медиатор
актуальн: актуальном
провод: узнать периодически
личн: личном ним личную
номер: номер абонентскому
лог: хранить
прекращ: изменена
аналитическ: аналитических
приложен: приложению приложения приложении приложением
выполня: выполнять
юрисдикц: органу
результат: результате основываясь
введ: введено
заключ: заключая
настройк: предоставляемого
дал: далее
текст: тексту доставки
уполномочен: иного
документ: документ документами
желан: желанию
идентификатор: идентификатор идентификатором
ссылк: ссылкой
нотификац: качества
ключ: ключа
интерес: интересах процедуры
средств: средств автоматизированными
дан: данные данных данным
дат: дата
идентификац: идентификация процедуру
указа: основе номеру указанные указанному
связыва: связывается
раскрыт: раскрытие конфиденциальность
осуществля: осуществляет осуществляется правомерность
закон: договорные собственных
станет: станет
зарегистрирова: зарегистрироваться
регистрац: регистрации
несанкционирова: охрану
имеет: отношении
счита: считаете
обновля: полученных
отсутств: отозвано законных
предусмотрен: предусмотренные
привяза: привязан
используем: настройки широко
цел: целях целей цели удаления
доступн: доступной доступного
кажд: каждого
звук: изображений
оспарива: точность
кпп: кпп
возраст: материалов возрасте
систематизац: систематизация
политик: политика политики политикой политику политике
взаимодейств: взаимодействует
неверн: исправлять
несет: несет
налич: наличия
настроек: настроек
использова: использовать
запрашива: запрашивает запрашиваются
отчеств: отчество
направл: регистрационный
логин: логин связан
продолжен: отсутствуют необходимость
значим: юридически
программн: программному программных программного программное
пройт: попросить
установк: установки
метрик: метрика
настоя: настоящей настоящая настоящий настоящую
лтд: паблишинг
кабинет: кабинете личный
след: следующие следующих ограничивается
вправ: вправе
вопрос: вопросы
организац: организации
сохраня: регламентами
внутрен: несанкционированного
переход: перехода
ответ: своевременно юрисдикции ответы
так: такую такого таком таких таким
письмен: письменное письменного
публикова: публиковать
усил: усилия
собствен: полезных пользование удалить
течен: пользователях
редакц: новая новой
техническ: оказание
переписк: переписки
хран: собранная хранит защиты
измен: учетной
надзорн: соответствующему
обезличиван: обезличивание
дет: детей детям
неотъемлем: неотъемлемой
материал: информационных
собира: систем
уведомлен: предварительного проверки
хабр: хабру хабр хабром хабра
аналитик: аналитики
некотор: запросы
авторизац: авторизации
отношен: права поддерживает
безотлагательн: безотлагательно
удовлетворя: ответ
служб: обращения
соглашен: соглашение соглашением соглашения
осмотрительн: осмотрительно
общедоступн: общедоступной
специальн: направления
ряд: основано
услов: условиях условиями условия
объем: объеме
поддержан: поддержанию
представля: представляет
друг: полу
переда: передаются
сбор: сбору сбора сбор право
компан: компанией
точност: запретить
наименован: наименование
получа: получать
действ: действия действие действиями редакцией действий действует действиях
делов: делового
соответствен: соответственно
добросовестн: добросовестно
предпочтен: разделах
фамил: фамилия
обеспечива: защите
юридическ: профилирование
заключа: заключаемых заключаемыми
состоян: состоянии
использ: использует используются
имеют: продолжения
отозва: собраны любое
научн: научной
созда: создает
учетн: собственную реализовать
сво: отредактировать своему своими получить
отдельн: отдельных
отобража: отображает
специалист: специалистов
машиночита: используемой
передач: приема любыми специфики передачу
станов: становится
выполн: отношения
интернет: интернет
предоставля: предоставляет предоставляться предоставляемой технология предоставлять
хранен: хранение законные
реализац: реализации
явля: является
достигш: достигшим
применя: применяемого
помеч: помечена
сведен: сведения
полн: полном
неправомерн: обработка
развит: развитие
журнал: журналов
пользовательск: пользовательского
почтов: почтовый
предусмотр: предусмотрено
сайт: сайте сайта
определя: определяется определяются
анализир: собираются
периодическ: применимого
обеспечен: обеспечения обеспечению обеспечение
уничтожен: уничтожение
технолог: раскрытой
файл: файлы
задач: исполнении
обществен: задач
рамк: рамках
пользова: пользоваться
различн: проводят
уступк: третьего
адрес: адрес паролем адресу
трет: собственность третьих третьими передача
задан: дополнительные
проф: профили
запрет: неполные
правообладател: правообладатель правообладателями
исключительн: решения
пар: пара
услуг: услуг
огрнип: огрнип
телефон: телефона телефонный
оказан: оказания адресом
треб: неправомерно
необходим: необходимые необходимых необходимо вынужденная необходима необходимого
блог: февраля
инициал: инициалы
числ: числе
автоматизац: автоматизации
период: хранится
требуем: разрешенного
факт: распространения
вынужден: отсутствует
исправля: своим
посредств: посредством
конфиденциальн: конфиденциальности сохраняется
сет: сети сеть сетей
вид: виде видов
виде: звуков
односторон: прекращена
обслужива: обслуживающего
положен: требуемого положения
разрешен: разрешение собрана
защит: правовой
явл: законодательства
оста: проводит
заключен: совершенных заключенным заключение нарушением заключения
вконтакт: вконтакте
нескольк: нескольких
блокирован: блокирование
договор: договора договоры договорами договоров договорам
принима: принимаете принимает принимаются
тип: тип
предоставлен: предоставление своем обрабатывает
расчетн: расчетный
распространен: организатором
проставл: проставляя
бик: бик
известн: известно
общ: общие
структурирова: основание
сторон: стороной исполнением
окончан: момента
указыва: указываются
полаг: полагая
предостав: предоставить предоставил
поддержк: технической
обслуживан: информационного
поддержива: следующим
прилага: прилагает
включ: включая
профессиональн: профессиональное
обм: обмена открытый
предусматрива: используемого
соста: состав
оборот: оборота
социальн: социальных
ин: суда иными иных иные иное инн затрагивает
применительн: применительно
пользовател: пользователи пользователем сообщений пользователя пользователей пользователям пользователь обмен пользователю
люб: пользователями любые заключенных продолжении
зависим: зависимости
сил: вступает
регламент: правилами
обязательн: обязательно обязательная
содержа: содержащие
сервис: сервиса сервисы сервису сервисе
фактор: ряде
информац: информацию информацией информация информации
описа: способами
соверш: совершены
удален: удаленная удаление требовать
использу: используя
предварительн: одностороннем
владен: передачей
конкретн: конкретных
добавлен: добавленная
требова: основании
парол: логином пароль
законодательств: предпочтениях законодательством
физическ: физическое
обработк: идентификации обработки обработку автоматизированной оспаривается
применен: случаи
размещен: размещенного размещения
неограничен: неограниченному
собра: удовлетворяет достижения целям
младш: младше
разреша: разрешается разрешает
блокчейн: находится
запис: записи
правил: внутренними
самостоятельн: самостоятельно
широк: структурированной
регистрацион: лтд
реклам: рекламы
основыв: хранения
корпоративн: корпоративный
обращен: связи
соответств: соответствии обратиться
попрос: некоторых
инструмент: инструменты реализованы
достоверн: достоверности
сообществ: сообщество
профилирован: обработке
тно: тной
польз: прав
ответствен: ответственность
уникальн: уникальный
электрон: связь электронной видео электронными
ограничива: включает применения
вол: волей
использован: использование сборе использования использованием
запрос: запроса пользу ответит
включа: включают включать факторов
сист: указанных
войт: войти
огрн: огрн
качеств: качестве улучшения
своевремен: описанными
состав: составу
подпис: подписи подписью
предпринимател: предпринимателя
производ: производится
порядк: порядке
намерен: намеренный
раздел: различных
автоматическ: автоматическом
пользован: владение
вытека: вытекает
яндекс: яндекс яндекса
существ: случаев существа задания
орган: надзорному
достижен: периода
относ: относятся
операц: операций операции
проведен: признакам
изменен: изменение
возможн: возможностей возможность повышения
автоматизирова: исключительно предоставленные
дальн: возражения дальнейшего
основ: исследований
открыт: предусматривают
отображен: отображения
исполнен: обрабатывал исполнения исполнение заключением
маркетингов: проведение
дает: даете
противореч: противоречие
перенос: машиночитаемой
функциональн: функциональных
пиксел: пиксели
непосредствен: непосредственно непосредственного
неполн: неверные
страниц: страницах
повлия: отзыв
раскрыва: раскрываемые раскрывать
паблишинг: блокчейн
применим: применимым положениями
информацию: информациюя
круг: кругу
обязательств: обязательств
рол: роль
корреспондентск: корреспондентский
ребенк: ребенке ребенка
изображен: текста
установлен: органа установленным установленных
статистическ: маркетинговых
способ: способом способы специального
форм: форме
браузер: браузера
наход: действующая
улучшен: обслуживания
признак: другим
термин: термина термины
источник: источник
firebas: firebase
offic: office
nicosia: nicosia
cooki: cookie
adsens: adsense
flat: flat
cypru: cyprus
diagor: diagorou
english: english
floor: floor
info: info
doubleclick: doubleclick
agreement: agreement
criteo: criteo
facebook: facebook
ip: ip
dfp: dfp
appmetrica: appmetrica
confidenti: confidential
analyt: analytics
googl: google
blockchain: blockchain
yandex: yandex
build: building
fabric: fabric
kermia: kermia
publish: publishing publishers
habr: habr
http: https
user: user
support: support
account: account
