термина: терминал терминала
максимальн: максимально
найт: найти
оценк: оценкой оценке
говор: говорить
велосипед: велосипед
охлажден: охлаждения
информацион: информационная
лев: левого
расскаж: расскажу
образ: образом
стат: стать статье статей статьи статья
обычн: обычном обычным
оказа: оказался
стар: старую
износ: износ
геймпл: геймплее
окн: окна
ремейк: ремейк
конц: концу
перееха: переехал
составлен: составление
си: си
интерпретир: интерпретируется
удал: удалить
реализова: реализовать реализовано
един: единому
работ: работа работы
центр: центра
запуска: запускается
дополнительн: дополнительный дополнительные
показыва: показываются
доступ: доступ доступе
домен: доменных
вернут: вернуться
сетев: сетевые
терминал: терминале терминалом
привлеч: привлечь
абапер: абапера
учебн: учебный учебного
сто: стоит
та: тае
приятн: приятный
тв: тв
финальн: финальной
критическ: критически
менеджмент: менеджмент
каса: касается
ультр: ультра
экра: экрана
макрос: макросом
преврат: превратить
поисковик: поисковик поисковика
н: н
ожида: ожидают ожидает
мобильн: мобильных
должн: должны
ошибок: ошибок
структур: структуры структур
публикац: публикации
ч: ч
подел: поделиться поделюсь
логическ: логического
показа: показал
сезон: сезон
поэт: поэтому
котор: которую которым котором которому
здач: здачах
провест: провести
вариант: вариант
памят: памяти памятью
писа: писать
видеокарт: видеокарты
назначен: назначению
связа: связанная
прав: правого
безопасн: безопасность
этап: этапе
уч: учиться учусь
диск: диск
проект: проектов проекты проект проекта
дебютн: дебютные
лид: лиды
вперв: впервые
опас: опасен
профил: профиль
дела: делался делать делается делаем
ооп: ооп
байт: байт
шутк: шутку
модн: модные
режим: режиме
кодировк: кодировке кодировкой
вывернул: вывернул
перевод: перевода перевод
алабуг: алабуга
продела: проделать
сводн: сводную
лайтов: лайтовый
верс: версию
вывел: вывел
исключен: исключением
шкал: шкале
устраива: устраивался
майнер: майнер майнеры
нна: нная
маркетинг: маркетинг
книг: книги книге
приед: приеду
увеличива: увеличивает
рук: руки руками
час: час
прост: простой
врем: времена
движк: движка
просмотрел: просмотрел
позвол: позволяя
зам: замена
индустр: индустрии
занима: занимается занимать
могл: могли
васильев: васильева
уровен: уровень
нов: новую новые новых новая
придума: придумать
клавиш: клавиши
выделя: выделяет выделяются
больш: большую большими
медийн: медийная
част: часть
иде: идея
динамическ: динамически
антивирусн: антивирусная
предполож: предположим
карьер: карьера
литератур: литература
слов: словами слово
пригодн: пригодность
длительн: длительного
инженер: инженеров
игр: игр игры
полезн: полезных полезными полезная
постоя: постоянно
придумыв: придумывая
сдела: сделать
телегр: телеграм
эффективн: эффективных
особен: особенность
сложн: сложных
представлен: представлением
пут: путь пути
пример: примерах примера пример
русск: русской русского
операцион: операционная
методолог: методологии
граб: грабить
персонал: персоналом
систем: система системы
выход: выходит
мог: могу
тимбилдинг: тимбилдинг
должност: должность
вкладыва: вкладываться
полноцен: полноценный
класс: класс
мож: можем
пыта: пытать
переводчик: переводчик
неизмен: неизменным
момент: момент момента
персональн: персональных
основн: основные основной
трудн: трудный
сожален: сожалению
курс: курсе курсов
читател: читателями
лобов: лобовую
ресурс: ресурсами ресурсы
метод: методы метода
машин: машиной
процесс: процессами процесс процессе процессов
пойма: поймал
шел: шел
перемен: переменные
утечк: утечки
решен: решению решение решений
хотел: хотелось
провож: провожу
агрегац: агрегация
личн: личный
средн: средний
комфортн: комфортного
кулис: кулисами
обраща: обращается
случайн: случайным
меня: меняются менять
бесплатн: бесплатный бесплатные бесплатной
хаб: хабы
продвижен: продвижения
материа: материал
выбира: выбирать
помощ: помощью помощи
приложен: приложений приложения
климат: климат
разработчик: разработчиков
опыт: опытом опыта
красив: красивым красиво
наполнен: наполнения
политех: политех
настройк: настройка настройками
витрин: витрин
дал: далее
текст: текст текста
пониман: понимание
документ: документы
предложен: предложения
будущ: будущего
декоратор: декоратор
навык: навыков
тверд: твердое
прочита: прочитав прочитать прочитал
нул: нуля
интерес: интересуются
дан: данных
программист: программистом
минимальн: минимальным
менеджемент: менеджементом
протяжен: протяжении
подавля: подавляющее
вкус: вкус
отправьт: отправьте
код: код кода
помогл: помогли помогло
паттерн: паттернов паттерн паттерна
модул: модули
регистрац: регистрация
бальн: бальной
тестирова: тестировались
зим: зиму
имеет: имеет
служебн: служебную
поисков: поисковый поисковая поисковой
счита: считаем
отладк: отладка
отсутств: отсутствует
функц: функция функций функции
причин: причин
используем: используемых
новостн: новостных
цел: целом цель целей
построен: построения
старт: старте
вирус: вирусы вирусов
кажд: каждому
дзен: дзен
остров: острове
множеств: множество
взаимодейств: взаимодействует
создава: создавал создавать
покупа: покупать
обнов: обновить
объект: объектам объекту
завершен: завершенным
разработк: разработкой разработку разработка разработки
использова: использовать использован использовал
графическ: графических
увидет: увидеть
жил: жилье
загружа: загружал
начал: начале
захламлен: захламления
программн: программного
достаточн: достаточно
руководств: руководства руководстве руководство
примерн: примерно
добавля: добавлять добавляет
сюд: сюда
хейт: хейтить
настоя: настоящие
кра: края
список: список
пост: посты посте
ввест: ввести
ориентирова: ориентированное
замечательн: замечательная
реляцион: реляционные
минут: минут
дел: дело
дизайн: дизайн дизайне
студ: студии
рассказа: рассказать рассказав
бюджет: бюджет
концепц: концепцию
устройств: устройство устройства
попыта: попытаюсь
попробова: попробовать попробовал
усил: усилий
творческ: творческого
проектирован: проектирования
нажат: нажатию
срок: сроком
собствен: собственный
баз: баз базу базы
техническ: техническая технических
уменьша: уменьшает
хран: хранятся
измен: изменяя
бал: бали
понрав: понравившейся
фишек: фишек
наполн: наполнить
уда: удал
алгоритм: алгоритм алгоритмы
адаптиру: адаптируем
фев: фев
людьм: людьми
мегапроект: мегапроекты
хабр: хабр хабра
аналитик: аналитиков аналитики
синдр: синдром
рутин: рутинных
обсуд: обсудить
некотор: некоторую некоторые
монитор: монитор
рассмотр: рассмотрим
иска: искать
ширин: ширину
куп: купил
зависан: зависаниями
количеств: количество
соглашен: соглашение
куч: кучи
квалифицирова: квалифицированным
добав: добавить
специальн: специальности
зна: знаю
месяц: месяцев
сам: самое
объем: объемами объемы
стро: строя
скаж: скажу
качествен: качественный
представля: представляет
анатом: анатомия
виртуальн: виртуальной виртуальным
друг: другими
стартап: стартапам
возвраща: возвращал
зон: зону
приход: приходится
инач: иначе
правильн: правильное
задава: задавать
сбор: сбора
абсолютн: абсолютно
народ: народе
кластер: кластер
выполнен: выполнением выполнения
компан: компаний компании
программ: программе программы
управлен: управление управлением
получа: получал
зайт: зайти
разбира: разбираться
принят: принято
главн: главное
представл: представлено
созд: созда
заключа: заключалась
элемент: элементов
начина: начинают начинающей
привет: привет
популярн: популярными популярной
покаж: покажу
дич: дичь
использ: использую используют
визуальн: визуальной
изуч: изучить
цвет: цвет
созда: создает создать
магазин: магазина
читаем: читаемость
сво: свой
веб: веб
программирован: программирование программирования
распознава: распознавал
нача: началась начало начал
отобража: отображается
слаб: слабых
машиночита: машиночитаемые
станов: становится
коворкинг: коворкинги
интернет: интернет интернете
предоставля: предоставляющего предоставляемые
значительн: значительно
реализац: реализацией
явля: являются
комьюнит: комьюнити
игров: игровые
оптимизац: оптимизация оптимизации
тем: темы темой
официальн: официальных
полн: полная
администрирован: администрирования администрирование
развит: развито
знат: знать
тимлид: тимлида тимлид
приглашен: приглашение приглашения
наизнанк: наизнанку
сайт: сайта сайтов сайт
определя: определяемой
обеспечен: обеспечения
научпоп: научпоп
технолог: технологий технологии
задач: задачах задач задача задачи
комментар: комментариях
происход: происходит
пользова: пользовался
рамк: рамках
различн: различные
задан: задание
адрес: адреса
сочетан: сочетание
компьютер: компьютера компьютер компьютере
смогут: смогут
самозванц: самозванца
пал: пал
сертификац: сертификация
долг: долгое
песочниц: песочнице песочница
блок: блок
пар: пару
услуг: услуги
искусств: искусство
базов: базовый
треб: требуется
высококачествен: высококачественного
необходим: необходимые необходимо необходимым необходимое необходимость
блог: блог
зовут: зовут
истор: историю
автоматизац: автоматизацию автоматизации
мышлен: мышления
интерфейс: интерфейс
тепл: тепло
чист: чистого чистым
подозрева: подозревать
исследова: исследовать
пробл: проблем
сложност: сложности
вниман: внимание
полноправн: полноправными
посредств: посредством
автор: авторы автору автором авторов
чита: читать
жд: жд
конфиденциальн: конфиденциальность
подход: подхода
однотипн: однотипных
попада: попадают
защит: защита
явл: являясь
науч: научиться
явн: явно
тестирован: тестирование
оценива: оцениваю
возникновен: возникновения
оста: остается
быстр: быстрым быстрее быстрый быстром
типичн: типичным
бизнес: бизнес
стрем: стремиться
тип: типы типов
юлдаш: юлдашев
рдо: рдо
позволя: позволяет
памя: память
платн: платный
хоч: хочу
распространен: распространенных
удобств: удобства
переезд: переезда
дом: домен
реш: решил решили
стандартизац: стандартизация
доп: доп
известн: известного известных известную
общ: общем
виснут: виснуть
обойт: обойтись
поток: потоки
честн: честно
поддержк: поддержка
зада: задать
остальн: остальные
любов: любовь
включ: включая
шуток: шуток
профессиональн: профессиональная
хорош: хороший
библиотек: библиотеку
анонимн: анонимны
ид: идею
удобн: удобным удобно удобный
сред: среда среди
переделыва: переделывать
им: имен
пользовател: пользователи пользователей пользователем пользователю
мног: многое многих многие
кайфов: кайфовый
интерпретируем: интерпретируемый
объектн: объектно
люб: любого любой
язык: язык языка языки
большинств: большинстве большинство
криптовалют: криптовалюты
сил: силы
тимлидств: тимлидству тимлидстве
тко: тко
ремесл: ремесла
окошек: окошек
разрабатыва: разрабатываются
фот: фото
обязательн: обязательно
сервис: сервиса сервисов
таблиц: таблицам таблицу таблицах
оперативн: оперативной
стил: стиль стилю
фактор: фактором
упор: упор
информац: информацию информация информации
составля: составляющей
злоумышленник: злоумышленников
разн: разных
замет: заметил
освоен: освоение
люд: людей
дожд: дождей
разв: развилось
спуст: спустя
клон: клона клон
нюанс: нюансы
открыва: открывается открывают
лют: лютый
добавлен: добавлением
критер: критериев
понят: понятия
сборк: сборке
мессенджер: мессенджеры
переосмыслен: переосмысление
обработк: обработки
создан: создания создании создание созданию
особ: особо
вывод: выводе
русскоговоря: русскоговорящее
производств: производства
например: например
постара: постараемся
одн: одна одним
мар: мар
широк: широкий
коллег: коллега
живут: живут
классн: классными
чеса: чесались
реклам: рекламе реклама
псевдоним: псевдонимы
прид: прид
корпоративн: корпоративный
рекомендац: рекомендации
запуск: запуск
нативн: нативные
инструмент: инструменты
выда: выдали
муча: мучать
огромн: огромные огромное
команд: командой командами
итак: итак
сообществ: сообщества
справл: справлюсь
познаком: познакомился
проживан: проживания
стран: странная
инструкц: инструкции
движок: движок
январ: января
использован: использования
отлич: отличие
запрос: запроса запросом запрос запросов
консол: консоль консоли
включа: включает
сист: систем
войт: войти
исходн: исходный
качеств: качестве
процессор: процессоры
аккаунт: аккаунт
комплект: комплектующих комплектующие комплекте
предпринимател: предпринимателя
протокол: протокол
выбор: выбор
сраз: сразу
наскольк: насколько
проблем: проблемы проблемами проблема
обнаружен: обнаружения
исключ: исключить
сервер: сервер
бот: бот
упомина: упоминает
раздел: разделы раздел
пицц: пиццы
транслир: транслируется
азат: азат
жела: желаемом желающих
яндекс: яндекс
новост: новостей новости
воврем: вовремя
существ: существующему
перв: первого первом
управля: управлять
предвзят: предвзятость
небольш: небольшой
дума: думал
крайн: крайне
написа: написать
поиск: поиска поиск
возможн: возможность возможности
оп: опыт
неудобн: неудобно
кодирован: кодирования
коробк: коробки
основ: основе
выбра: выбрана выбрать
линукс: линуксе
голов: головой
образовательн: образовательного образовательные
хочет: хочется
как: каком какие
участник: участниками
функциональн: функциональность
турист: туриста
крут: крутить
содерж: содержится
пк: пк
каф: кафе
встреча: встречаются
взгляд: взгляда
тся: тся
род: роде
втор: втором
лома: ломаются
изначальн: изначально
становлен: становлению
риск: риск
контент: контентом
напрасн: напрасно
стандартн: стандартной стандартным
откр: открыть
миллион: миллион
напрям: напрямую
продукт: продукт
компьютерн: компьютерных компьютерного
studio: studio
flappi: flappy
data: data
express: express
dn: dns
microsoft: microsoft
reactj: reactjs
qa: qa
twitter: twitter
java: java
bird: bird
opencart: opencart
visual: visual
vim: vim
api: api
nix: nix
zip: zip
python: python
termin: terminal
gozl: gozle
impala: impala
manag: manager
eksmo: eksmo
javascript: javascript
ipv: ipv
getcost: getcost
node: node
memori: memory
vk: vk
http: http
habr: habr
abap: abap
tilda: tilda
uniti: unity
engin: engineering
ru: ru
code: codes
access: access
scientist: scientist
js: js
ocstor: ocstore
zsh: zsh
arpa: arpa
sql: sql
youtub: youtube
pop: pop
mint: mint
getdescript: getdescription
pizza: pizza
decor: decorator
linux: linux
typescript: typescript
hadoop: hadoop
seo: seo
gnome: gnome
erp: erp
os: os
powerlevel: powerlevel
facebook: facebook
telegram: telegram
cm: cms
clean: clean
commerc: commerce
excel: excel
django: django
googl: google
mtproto: mtproto
cpython: cpython
window: windows
