смешн: смешными
обрат: обратили
готов: готовы
оценк: оценка оценки
посчастлив: посчастливилось
успет: успеть
слух: слухам
заявк: заявку
информацион: информационная
найм: найма
стат: стать статью статье статей статьи статья
сравн: сравнили
стар: старого старую
оказа: оказалась
конц: конце концу
эмиграц: эмиграция
стал: стала
мнен: мнения мнение
окт: окт
маленьк: маленькая
обзор: обзор
появ: появился появилась
работ: работы работу работе
запуска: запускаем
рекламн: рекламный рекламные
показыва: показывать
практическ: практические
вернут: вернуться
учебн: учебный
сто: стоит
основан: основания
обновлен: обновлений
тв: тв
послед: последующих
лен: ленится
янв: янв
д: д
менеджмент: менеджмент
заполня: заполняем
местоположен: местоположение
мобильн: мобильных
личност: личностью
впер: впер
суд: судей
публикац: публикаций публикации публикация
скопирова: скопировать
заморозк: заморозкой
карт: карты
подел: поделиться
коротеньк: коротенький
показа: показать
отправ: отправили
бессон: бессонные
ощущен: ощущение
благодар: благодарят
назван: названием
котор: которое
карм: карму
мин: мин
осен: осень осенью
заголовок: заголовок
миф: мифы
поотвеча: поотвечать
совершен: совершенный совершенно
знают: знают
идеальн: идеальный
прав: правило правила
организатор: организаторов
уч: учиться учить
опрошен: опрошенных
проект: проекты проекта
коллективн: коллективном
весн: весной
впитыва: впитывает
относительн: относительно
профил: профиль профиле
дела: делаешь делай делать
приветств: приветствуются
получ: получилось получились
читальн: читальный
верс: версии версию
устраива: устраивают
маркетинг: маркетинг
списк: списки
декабр: декабря
прост: простой
млн: млн
технотекстов: технотекстовые
прям: прям
зал: зал
индустр: индустрии
занима: занималась
лиц: лицах
хабровск: хабровский
повышен: повышение
уровен: уровень
нов: новый новые новых новым новому
придума: придумали
познакомл: познакомлю
вкладк: вкладки
больш: большие больших большом
контекстн: контекстная
медийн: медийная
мест: места
част: частые часть
наде: надеемся
ждат: ждать
существу: существуем
алекс: алексей
спрашива: спрашивают
карьер: карьере карьера
сорва: сорваться
направлен: направления
модерац: модерация модерации
полезн: полезных
попаст: попасть
стартова: стартовал
сдела: сделать сделай
отзыв: отзывам
эффективн: эффективнее
прота: протащим
пробова: пробовали
дают: дают
поработа: поработало
вспомн: вспомнили
страшн: страшно
фуршет: фуршет фуршеты фуршета
совет: совет советами
видел: видели
примен: применить
исправ: исправим
работодател: работодателей
сердечн: сердечно
активн: активнее
пример: примерами
ноч: ночи
идт: идти
бьют: бьются
беспочвен: беспочвенны
декабрьск: декабрьский
персонал: персоналом
должност: должность
технотекст: технотекст технотекста
мож: можем
пыта: пыталась
рефакторинг: рефакторинг
приглас: пригласили
момент: моментах
обсужден: обсуждении
выж: выжить
частн: частном
нонстоп: нонстопа
перебра: перебрали
пообща: пообщаться
труд: труд
трудн: трудно
вышл: вышла
курс: курсах
читател: читателей читатели
осмел: осмелимся
ресурс: ресурсы
лиша: лишаются
оставлен: оставленные
неплох: неплохо
процесс: процессе процесс
помогут: помогут
дошл: дошло
европ: европу
достойн: достойная
немногословн: немногословный
нововведен: нововведения нововведение
актуальн: актуальнее
продолжа: продолжаем продолжать
нафталинов: нафталиновым
секрет: секрете
помоч: помочь
меня: меняться
помога: помогать
хаб: хабы хабам
советова: советовалась
помощ: помощью
эйчар: эйчары
складир: складируются
приложен: приложений приложение
мент: менти
разработчик: разработчиков разработчики
результат: результат
вызыва: вызывают
утрирова: утрированы
опыт: опыте
красив: красивый
рынок: рынок
ваканс: вакансии
настройк: настройка
дал: далее
текст: тексты
печал: печалюсь
документ: документы
прочтен: прочтение
предложен: предложения
желан: желание
мечта: мечтала
ссылк: ссылку
разум: разуме
нуж: нужен
ироничн: ироничная
сменя: сменяются
профильн: профильным
масштабируем: масштабируемый
дан: данных
борьб: борьба борьбе
дат: дать дата
бездн: бездну
протестирова: протестировали
картинк: картинке
хвал: хвалят
заявок: заявок
станет: станет
взаимн: взаимно
код: кода код коду
зарегистрирова: зарегистрированных
росс: россии россия
осторожн: осторожная
регистрац: регистрация регистрации
заканчива: заканчиваются
заглядыва: заглядывайте
недоразумен: недоразумение
пожалова: пожаловать
числен: численность
задейству: задействуем
каза: казалось
тума: туманное
причин: причины
шорт: шорт
жалоб: жалобы
раздража: раздражают
мте: мте
новичк: новички
калейдоскоп: калейдоскоп
сообща: сообщают
ошиба: ошибаетесь
досадн: досадное
номинац: номинациям номинации
конверс: конверсии
эк: эка
выходн: выходными
дзен: дзен
множеств: множества множеством
вмест: вместе
уезжа: уезжают
спор: спорят
обнов: обновить
разработк: разработка разработки
закладк: закладки
логик: логике
увидет: увидеть
уверен: уверенности
начал: начале
пройт: пройти
изнутр: изнутри
сюд: сюда
высш: высшим
настоя: настоящей
список: список
пост: посту посты посте пост постов
знаком: знакомы
жалееш: жалеешь
пристраст: пристрастием
лист: листы
будн: будний
итог: итог итогами итоги
след: следующий
совпаден: совпадения
клетк: клетка
веет: веет
дек: дек
вопрос: вопросы вопрос
объявля: объявляется
дизайн: дизайн
рассказа: рассказать
помим: помимо
устройств: устройство
коротк: короткие короткий
бэкенд: бэкенд
ответ: ответить ответами ответы
так: таким
нормальн: нормальная
обижа: обижают
уязвим: уязвимостях
проектирован: проектирование
событ: события
баг: багах
сталкива: сталкиваются
грабл: грабли
техническ: техническая
держа: держали
фев: фев
август: августа
конкурс: конкурс конкурса
минус: минусов
мегапроект: мегапроект мегапроекты
собира: собираются
превращен: превращения
хабр: хабре хабр хабра
аналитик: аналитике аналитика
пишут: пишут
обучен: обучение
некотор: некоторыми некоторые некоторых
подума: подумал
удивительн: удивительной
количеств: количество
служб: служба
соглашен: соглашение
твор: творится
куч: кучу
услыша: услышать
добав: добавить
просмотр: просмотров
мысл: мысли мыслями
акул: акула акул
посмотрел: посмотрели
последн: последняя
невидал: невидаль
зна: знаю
месяц: месяц месяце
набира: набирают
зне: знее
представля: представляем представлялись
друг: другими друг другу
стартап: стартапам
друж: дружим
помеша: помешает
выглядет: выглядеть
задава: задаваемые
ментор: менторов
тайн: тайных
поня: поняли
поглоща: поглощают
образован: образование образованием
менеджер: менеджером
компан: компаний компании компания
рассказыва: рассказывали рассказывает рассказывают рассказываем
длин: длинными
анонс: анонсы анонс
программ: программы
управлен: управление
получа: получается
влож: вложить
главн: главные
разбира: разбираются разбирались
нервн: нервная
фич: фичи фичах
вовлечен: вовлеченных
батал: баталии
октябр: октябрь
предполага: предполагает
привет: привет
обязан: обязанностей
вер: верят
вс: вс
отдел: отдел отдела
сеньор: сеньоров
неинтересн: неинтересные неинтересная
чаян: чаяния
присыла: присылают
сво: сво своим
уеха: уехать
программирован: программирование
нача: начать
отдельн: отдельном
специалист: специалистов
необычн: необычной
значительн: значительная
оглянут: оглянуться
вещ: вещами
неудивительн: неудивительно
завяза: завязаны
узн: узна
тем: тема теме
законч: закончить
питонист: питонистов
пришл: пришли
гид: гид
администрирован: администрирование
развит: развития
груб: грубят
тимлид: тимлид
неприкрыт: неприкрытой
анонсирова: анонсировали
сайт: сайте сайта сайт
дн: дн
знан: знаний
рыбк: рыбки
знал: знали
научпоп: научпоп
продолж: продолжим
комментар: комментарии комментариях
ежемесячн: ежемесячно
рамк: рамках
каракул: каракулов
сотрудник: сотрудники сотрудников
хвата: хватает
трет: третью третьи
работа: работают работает работала
проф: профи
песочниц: песочница
аспирант: аспирантов
долж: должен
человекочитаем: человекочитаемость
исключительн: исключительно
услуг: услуги
подписчик: подписчики
лендос: лендос
блог: блог блоге
числ: числе
зовут: зовут
истор: историй истории история
интерфейс: интерфейсе
чист: чистый
модел: модели
ещ: ещ
сложност: сложности
вниман: внимание
исправля: исправляемся
шут: шутить
маршрут: маршруты маршрутов
автор: авторы автором авторам авторов автора
реакц: реакция
менторств: менторство
сер: серь
чита: читать читает читаешь
сет: сети
вид: видим
жд: жд
представител: представитель
конфиденциальн: конфиденциальность
подход: подходит
пойд: пойд
попада: попадались
сборник: сборником
экосистем: экосистема
ноябр: ноябрь ноября
разумн: разумные
рев: ревью
расписа: расписаны
оброс: оброс
быстр: быстро
эксперт: эксперты
спрос: спрос
договор: договоримся
повтор: повторили
победител: победителей
обеща: обещал
бизнес: бизнес
хот: хотим
рдо: рдо
пережива: переживал
дне: дней
человекочита: человекочитаемый
хоч: хочу
эволюц: эволюция
дни: дни
рейтинг: рейтинг
реш: решил решившие решили решено
известн: известно
сторон: стороны
поток: потоки
смотр: смотрим
поддержк: поддержка
набор: набором
недел: недели
докручив: докручивая
принцип: принципами
хорош: хороша хорошим
прикреп: прикрепить
ид: идеи
срез: срез
сред: среди
социальн: социальные
предыдущ: предыдущий
наш: нашей
ин: иные
улучш: улучшить
мног: многих
пользовател: пользователями пользователи пользователей
люб: любим любит любые любят
непрофессионализм: непрофессионализма
над: надеюсь
сюрприз: сюрприз
язык: языка
умн: умная
сил: сил
захочет: захочет
робот: роботы
план: планы
обязательн: обязательно
сервис: сервис
стил: стилем
информац: информация
утомля: утомляют
разн: разное
ультимативн: ультимативный
впуст: впустую
завтр: завтра
люд: людей
объяв: объявим
предварительн: предварительных
конкретн: конкретные
критер: критерии
интерв: интервью
беспоко: беспокоить
инсайд: инсайдами
особ: особым
аудитор: аудитория аудитории
собра: собрать
вывод: выводы
развея: развеять
релокац: релокации релокация
дискутир: дискутируют
антон: антон
понедельник: понедельник понедельникам
знает: знаете знает
постара: постарался
волн: волны
одн: одни одно
инсайт: инсайтами
мал: малые
самостоятельн: самостоятельный
коллег: коллег коллеги
классн: классный
реклам: реклама рекламой
разбер: разберу
вымучен: вымученных
хабракод: хабракода
рассылк: рассылка рассылками
корпоративн: корпоративном корпоративный
понятн: понятный
бэклог: бэклог
пода: подать
запуск: запуск
нативн: нативный нативные
глубж: глубже
подборк: подборки
помощник: помощником
инструмент: инструмент
низверж: низвержена
команд: команда команды команде командой команд
ведущ: ведущим
лад: ладить
сообществ: сообществом сообщества
увольнен: увольнений
ма: мая
апрел: апреля
познаком: познакомиться
участ: участия
январ: января январь
прислуша: прислушаться
десятк: десятки
уровн: уровни уровня
платформ: платформа
мо: моей
потрат: потратить
дух: духом
топов: топовых
душ: души
войт: войти
соедин: соединили
аккаунт: аккаунт
модератор: модераторы модератором модератор
эмоц: эмоций
номинант: номинантов
сраз: сразу
обма: обмана
благодарн: благодарности
сража: сражаются
порядк: порядка
пиш: пишу
подробн: подробности подробно
но: ноя
айтишник: айтишников
поближ: поближе
забрасыва: забрасывают
упомина: упоминаются
раздел: разделы разделе
половин: половины
радова: радовать
вполн: вполне
нек: некое
яндекс: яндекс
новост: новости
лучш: лучшие
перв: первую первой первых первого
небольш: небольшая
формат: форматы
дума: думаете думают
ок: окей
написа: написал
добр: добро
навязчив: навязчивости
гайд: гайд
поиск: поиск
оп: опыт
интересн: интереснее интересное интересные интересных интересно
возможн: возможность
предновогодн: предновогодний
изменен: изменений изменения изменениями
выбра: выбрал
открыт: открыто открытым
мед: медиа
выйдет: выйдет
ласк: ласк
образовательн: образовательные
участник: участниками
как: каким
функциональн: функциональных
крупн: крупнейший
голос: голосов голоса
крут: крутые крутой
кат: кат катом
раскрыва: раскрываем
встреча: встречаются
прошл: прошли прошлом прошлых
выпуск: выпуск
наверн: наверное
сосла: сослаться
буклет: буклеты
втор: второго
забега: забегал
точн: точнее
контент: контент
откр: открыть
июл: июля
миллион: миллиона
русскоязычн: русскоязычный
никак: никаких
career: career
io: ios
android: android
facebook: facebook
boomburum: boomburum
upd: upd
exospher: exosphere
telegram: telegram
team: team
youtub: youtube
brutto: brutto
twitter: twitter
rss: rss
bu: bus
dream: dream
vk: vk
faq: faq
habr: habr
factor: factor
ancotir: ancotir
apoltavcev: apoltavcev
