нейрон: нейронной нейронах нейронов нейронная
максимальн: максимальную максимальная максимальное максимального
готов: готово
преобразован: преобразование
понима: понимают
оттуд: оттуда
образ: образом
значен: значения значение
стат: стать статье статьи статья
оказа: оказалось
обычн: обычные
стар: старую
рабоч: рабочий рабочей
стаж: стажа
стад: стадий
см: см
случа: случае
став: ставим
реализова: реализовать реализованы реализовали
работ: работа работу работы
рекламн: рекламные
частичн: частично
практическ: практической
дополнительн: дополнительными
упрощ: упрощен
вернут: вернуться
получен: получение полученные полученной
инфраструктур: инфраструктуре
сто: стоит
основан: основании
человек: человеком
схем: схема
словар: словарь словаре словаря
менеджмент: менеджмент
вектор: векторы вектора векторами векторов вектор
единствен: единственной
неприятн: неприятная
должн: должны
публикац: публикации
х: х
сообщ: сообщить
показа: показала
поэт: поэтому
котор: котором
карм: карма
провест: провести
мин: мин
вариант: вариантов
писа: писать
исследован: исследовании
рассчитыва: рассчитывает
шаг: шаге шаги
этап: этап этапе
проверя: проверяется
отмет: отметить
числов: числовые числовых числовому числовой
проект: проекты проектов проекте
классическ: классическая классически
усредня: усредняет
профил: профиль
дела: делает делал делают делаю
сообщен: сообщения
сут: сути
провед: проведена
аналог: аналоги
получ: получили получено получены получилось получить
верн: верно
перевод: перевод
верс: версии версий версию версия
важн: важно
исключен: исключением
маркетинг: маркетинг
обознача: обозначаться
час: часов
прост: простой простая
предобучен: предобученных предобученной предобученная
языков: языковых
позвол: позволило
заодн: заодно
проверк: проверка
занима: занимается
уровен: уровень
продуктов: продуктовой продуктовую
кстат: кстати
больш: большие большом
медийн: медийная
мест: месте
несбалансирова: несбалансированная
част: части
иде: идея
предсказан: предсказание предсказания
слов: слов словам слову слова
вход: вход входе
длительн: длительное
полезн: полезный
одновремен: одновременно
постоя: постоянная
сдела: сделанная сделать сделал сделана
телегр: телеграм
особен: особенность
развернут: развернуть
извлечен: извлечения
капот: капот
представлен: представлении представлению представления
сформулирова: сформулировать
пут: пути путем
активн: активно
русск: русском
пример: примером
заполнен: заполнения
расчет: расчета
систем: системе
выход: выходом выходе
упрощен: упрощения
класс: классы класс классом
момент: моменту
эмбеддинг: эмбеддингов эмбеддинга эмбеддинги
дополн: дополнить дополнен
смог: смог
обрабатыва: обрабатывать обрабатываются
категор: категории
ресурс: ресурсы
машин: машинное машинного
метод: метод методов
процесс: процесс
единиц: единиц единицей единицу единицы
свойств: свойства
подготов: подготовить
напрашива: напрашивалась
смещен: смещений смещение
требован: требования
решен: решение решения
хотел: хотел
бинарн: бинарная
подготовлен: подготовленных
входн: входного
средн: средний средняя
предобработа: предобработать предобработаны
нужн: нужного нужное нужны
разметк: разметка
хаб: хабы
описан: описание описания
материа: материала
повыс: повысить
помощ: помощью
выш: выше
выполня: выполнять
результат: результате результаты
разработчик: разработчик
опыт: опыта
вычислен: вычислениями вычисления
трудоемк: трудоемкий
ваканс: вакансии вакансий
настройк: настройка
дал: далее
матричн: матричными матричные матричная
текст: текст тексту тексты текстов текста
показател: показатель
последовательн: последовательности
документ: документы
прочтен: прочтение
идентификатор: идентификатор
рисунк: рисунке
наоборот: наоборот
профильн: профильное
нул: нулей нулями
портал: порталов
сыр: сырому
гиперпараметр: гиперпараметра
имел: имела
дан: данные данных данной данном данная
сравнен: сравнения
потребова: потребовалось
фильтрац: фильтрация фильтрации
установ: установить
векторн: векторных векторного
тэг: тэгов
протестирова: протестирована
плох: плохая плохих
положительн: положительным
код: код кода
целочислен: целочисленные
помогл: помогла помогло
росс: россия
модул: модуль модуля
регистрац: регистрация
сократ: сократим
предобработк: предобработки
кол: кол
убед: убедился
причин: причинам
функц: функцию функции
используем: используемых
лемматизац: лемматизацию лемматизация лемматизации
загрузк: загрузку загрузкой
новостн: новостных
цел: целом целью
сигмоид: сигмоиду
кажд: каждом каждого каждому
пройд: пройден
выходн: выходного выходной
дзен: дзен
сохран: сохранить
разбор: разбора разбор
коммерческ: коммерческая
создава: создавать
искусствен: искусственный
обнов: обновить
име: имеем
разработк: разработка
неважн: неважно
закладк: закладки
использова: использовать использовал использовалась использовались использовалось
разработа: разработать
заня: занять
достаточн: достаточно
векторизац: векторизация векторизацию
примерн: примерно
установк: установки
метрик: метрики метрика
список: список
наглядн: наглядно наглядности
токенизац: токенизацию
корпус: корпуса
повыша: повышает
итог: итоге
меньш: меньшей
типов: типовая
след: следующим следующей следующий следующего следующая следующее следующие следующих
минут: минут
напомн: напомню
нашел: нашел
вопрос: вопроса вопрос
дизайн: дизайн
вектр: вектро
производительн: производительность
умножен: умножение
устройств: устройство
попробова: попробовать
размер: размер размера размером
текстов: текстового
так: таком таким
изучен: изучения
перевест: перевести
полност: полностью
переписа: переписал
баз: базе
техническ: техническая
условн: условный
чатбот: чатбот
материал: материалов
собира: собираются собирать
мегапроект: мегапроекты
хабр: хабр
смен: сменить
выравниван: выравнивания
пишут: пишут
обучен: обученную обученной обучения обучении обучение
извлека: извлекать
обуча: обучается
количеств: количество количестве
соглашен: соглашение
посмотрет: посмотреть
добав: добавить
просмотр: просмотров
специальн: специальность
последн: последнего
объед: объедены
дополня: дополняем
конфигурац: конфигурации конфигураций
сам: самое
интеллект: интеллектом интеллект
качествен: качественной
представля: представлять
сутк: сутки
стартап: стартапам
туториа: туториал
предсказател: предсказателя
поня: понять
вероятн: вероятно
компан: компаний компании компания
длин: длину длина
ограничен: ограничение
программ: программы
точност: точность
получа: получает получают получаемые
главн: главное
принят: принято
стемминг: стемминг
привел: привел
элемент: элементов
вес: веса весов
плотн: плотные
популярн: популярных
рав: равен
использ: используется
имеют: имеют
семантическ: семантические
вручн: вручную
парсер: парсер
созда: создана создаем создать
стоп: стоп
сво: свой
ран: ранее
помн: помним
гб: гб
отдельн: отдельно
реша: решать решают
отобража: отображать
сохранен: сохранение
станов: становилась
выполн: выполнить
интернет: интернет интернете
значительн: значительные значительно
го: го
тест: теста
реализац: реализацию реализации реализация
тег: теги
явля: является
применя: применять применяем
пришл: пришлось
полн: полный
администрирован: администрирование
предостаточн: предостаточно
различа: различать
сайт: сайта сайтов сайт
определя: определяем
научпоп: научпоп
задач: задаче задачи задача задачах
комментар: комментарии
различн: различных
трехмерн: трехмерный
задан: задание
умножа: умножаем
работа: работающей работает работать
диалогов: диалоговый
долг: долгих долгое
песочниц: песочница
останавлива: останавливались
пар: пару
услуг: услуги
треб: требует требуется
необходим: необходимо необходимости
блог: блог
числ: числа число числе
индекс: индекс индексом индексов индексы
истор: истории
обуч: обучить обучили обучены
зрен: зрения
модел: моделях модель моделей модели
сложност: сложности
параметр: параметры параметров параметром
привед: приведена
автор: авторы автор автором авторов
убра: убрать
сет: сеть сети
вид: вид вида виде
конфиденциальн: конфиденциальность
подход: подходили
тензор: тензоры тензор
разумн: разумно
тестирован: тестирования
оценива: оценивает
естествен: естественным
заключен: заключение
размерн: размерности
назнача: назначает
тип: типа
позволя: позволяет
рейтинг: рейтинг
реш: решил
стандартизац: стандартизацию
способн: способность
обойт: обойти
поток: потоки
преобраз: преобразуется преобразует
указыва: указываем
поддержк: поддержка
остальн: остальные
зада: заданную
состо: состоит
реж: режим
включ: включая
принцип: принцип принципу
хорош: хорошая
профессиональн: профессиональным
классификац: классификация классификации классификацию
валидацион: валидационной
библиотек: библиотеками библиотека библиотеки
подвид: подвид
сред: среду среде
предыдущ: предыдущем
наш: нашем
мног: многих
нулев: нулевой нулевыми
успешн: успешный
люб: любую
сущност: сущностей
язык: языке языка
большинств: большинстве
заказ: заказу
заглянут: заглянуть
обязательн: обязательно
таблиц: таблицу
регулярн: регулярные
информац: информация информации
составля: составляет составляют
разн: разных разным разного
выгляд: выглядит
анализ: анализа
удален: удаление
спуст: спустя
отфильтрова: отфильтровать
очистк: очистку очистки очистка
целев: целевой
рисунок: рисунок
требова: требовалось
критер: критерии критерию
сборк: сборки
максимум: максимум
поступлен: поступления
создан: создания
вывод: выводы вывод выводит
привод: приводит
разрежен: разреженные разреженную разреженной разреженными разреженная
например: например
одн: одна
рис: рис
агрегатор: агрегатор агрегаторы
дублирова: дублировал
реклам: реклама
запуст: запустить
корпоративн: корпоративный
подобра: подобрали подобрать подобрано подобранным
соответств: соответствующей соответствует соответствующего соответствующих соответствующее
синтаксическ: синтаксические
нативн: нативные
одинаков: одинаковое
соотношен: соотношения
инструмент: инструмент
итак: итак
команд: команды
плюс: плюс
сло: слой слои слоя слое слоев
мусор: мусора
уникальн: уникальным уникальных
ограничива: ограничивает
смотрет: смотреть
десятк: десятков
уровн: уровня
использован: использование использования
отлич: отличите
мо: моем моей
свер: сверить
релевантн: релевантности
местн: местного
матриц: матрицами матрица матрицы матрицу
войт: войти
исходн: исходные исходного
качеств: качества качестве качество
вынес: вынесено
аккаунт: аккаунт
прошел: прошел
категориальн: категориальные
вычислительн: вычислительные
выбор: выбор выбора
подробн: подробного
поступа: поступает
опытн: опытным
бот: ботов
упомина: упоминаемый
раздел: разделы
автоматическ: автоматической
похож: похоже похожие
выражен: выражения
яндекс: яндекс
новост: новостей новости новость
владимир: владимир
лучш: лучшие
перв: первая первой
дума: думаю
операц: операциями операции
промежуточн: промежуточные
поиск: поиски поиск поисков
оп: опыт
возможн: возможно
интересн: интересно
заказчик: заказчика
равн: равной равна
короч: короче
выбра: выбрал выбрана выбранный выбрать
образовательн: образовательные
как: какие
все: всей
классификатор: классификатора классификатор
преобразова: преобразованная
неполн: неполной
голос: голосов
страниц: страница
встреча: встречающихся
загруз: загрузить
самоконтрол: самоконтроля
высок: высокое
реальн: реальной
выборк: выборка выборки выборку выборке
добавл: добавлены
точн: точные точно
точк: точки
любительск: любительский
установлен: установленного
стандартн: стандартный стандартными
откр: открыть
способ: способен
форм: формой
улучшен: улучшения
признак: признаки
никак: никакого
лояльн: лояльна
источник: источника
intermedi: intermediate
def: def
lgbmclassifi: lgbmclassifier
tun: tunning
pymorphi: pymorphy
fit: fit
output: outputs output
score: score
loss: loss
sequenc: sequence
number: numbers
twitter: twitter
vova: vova
axi: axis
len: len
model: model
embed: embedding
text: texts text
exp: exp
rang: range
crisp: crisp
ram: ram
init: init
python: python
shape: shape
dens: dense
dtype: dtype
input: input inputs
openai: openai
size: size
av: av
globalaveragepool: globalaveragepooling
habr: habr
kera: keras
lightgbm: lightgbm
word: word
logisticregress: logisticregression
forest: forest
optim: optimizer
dot: dot
sentenc: sentences
epoch: epochs
crossentropi: crossentropy
hot: hot
compil: compile
sgdclassifi: sgdclassifier
layer: layers layer
youtub: youtube
robert: robert
valid: valid validation
propag: propagation
scipi: scipy
tensorflow: tensorflow
rss: rss
beautifulsoup: beautifulsoup
vector: vectorize
chatgpt: chatgpt
vocabulari: vocabulary
max: max
facebook: facebook
token: tokens
tf: tf
googl: google
metric: metrics
binaryaccuraci: binaryaccuracy
char: char
config: config
return: return
open: open
standard: standardization standardize
data: data
featur: features
num: num
dm: dm
dim: dim
threshold: threshold
float: float
mode: mode
split: split
fine: fine
dict: dict
html: html
train: training train
new: news
adam: adam
sequenti: sequential
test: test testing
adapt: adapt
batch: batch
weight: weights
idf: idf
multinomialnb: multinomialnb
gpu: gpu
fals: false
core: core
vk: vk
final: final
upsampl: upsampling
activ: activation
reshap: reshape
numpi: numpy
histori: history
emb: emb
tfidfvector: tfidfvectorizer
scienc: science
np: np
import: import
arrai: array
sentan: sentanence
tini: tiny
scientist: scientist
binari: binary
vocal: vocal
sklearn: sklearn
relu: relu
extractor: extractor
fp: fp
ltsm: ltsm
random: random
load: load
textvectorizaion: textvectorizaion
tolist: tolist
vocab: vocab
predict: prediction predict predictions
json: json
predictor: predictor
dump: dump
class: class
sam: sam
custom: custom
length: length
telegram: telegram
bert: bert
label: labels
tensor: tensor
int: int
textvector: textvectorization
kneighborsclassifi: kneighborsclassifier
print: print
unk: unk
django: django
yandex: yandex
sigmoid: sigmoid
bia: bias
append: append
avarag: avarage
