готов: готовы готовых готово
случ: случиться
говор: говоря говорят
ру: ру
компромисс: компромиссы
впоследств: впоследствии
криптограф: криптография
фактическ: фактическим
расскаж: расскажу расскажем
мерчант: мерчанты
образ: образ
стат: стать статью статье статьи статья
стар: старую
рабоч: рабочие рабочих
конц: конце
дорог: дорогой
мнен: мнение
аспект: аспекты
предлага: предлагаю
обзор: обзор
электроник: электроникой
появ: появилась
случа: случается
последств: последствия
един: единого
реализова: реализовать реализовали
работ: работа работы работе
запуска: запускается
показыва: показывают показывать
дополнительн: дополнительные
практическ: практически
доступ: доступа доступен
сценар: сценариев
вернут: вернуться
затрагива: затрагивается
под: подах
сетев: сетевую сетевые
принос: приносит
инфраструктур: инфраструктуры инфраструктура инфраструктурой инфраструктуре
александр: александра
обновлен: обновления обновление
тд: тд
критическ: критически
лен: лень
децентрализова: децентрализованные
специализирова: специализированных
менеджмент: менеджмент
единствен: единственным
интеграц: интеграции
топик: топика
галочк: галочками
лутковск: лутковской
н: н
неприятн: неприятность
р: р
структур: структуру
публикац: публикации
скопирова: скопировать
дава: давайте
подел: поделиться
ш: ш
показа: показать
запас: запасами
модификатор: модификаторах
котор: которое
денег: денег
мин: мин
пор: порой
вариант: вариант
сборок: сборок
изолент: изоленты
реализовыва: реализовывать
конспект: конспект
повторяем: повторяемостью
ум: ум
мультитенантн: мультитенантными мультитенантной мультитенантном
связа: связанные связанных
прав: права прав правило
безопасн: безопасности
этап: этапе
манифест: манифестам манифестов манифесты манифестами манифеста
проверя: проверяем проверял
отмет: отметить
вовс: вовсе
либ: либо
проект: проектов проектам проекты проектами
ива: ивана
появля: появляется
строков: строковых
зад: зада
разветвл: разветвл
профил: профиль
дела: делать
бекенд: бекенде
получ: получили получить
синхронизац: синхронизации
ритейлер: ритейлеру
верн: верно
режим: режиме
перевод: перевод
компенсир: компенсируют
верс: версию
подводн: подводные
важн: важно
устраива: устраивал
защ: защите
маркетинг: маркетинг
город: городах
книг: книга
разобра: разобраться
декабр: декабре
каноничн: каноничной
час: час
прост: простой простое
трафик: трафика
конфигурируем: конфигурируемого
нно: нной
альтернатив: альтернативы
задачк: задачки
позвол: позволят
индустр: индустрии
занима: занимающегося занимаемся
каталог: каталогов
возражен: возражения
могл: могли
следова: следовать
лиц: лице
встрет: встретила встретить
эксплуатац: эксплуатации
повышен: повышению
уровен: уровень
нов: нового новым новая новый новой новые новых
ног: ногу
продуктов: продуктовые продуктового
внешн: внешних
нод: ноду нодами
больш: большой
медийн: медийная
мест: местами
част: часть
иде: идеями идея
алекс: алексей
опубликова: опубликована
карьер: карьера
слов: слова
инженер: инженер инженеров
вход: входа
направлен: направлений
постоя: постоянно
системн: системное
существен: существенные
внимательн: внимательно
сдела: сделать сделал
эффективн: эффективным
особен: особенность
мерф: мерфи
сложн: сложный сложных сложные
мягк: мягко
исправлен: исправлений
представлен: представление
камн: камни
генерац: генерации генерация
иерархическ: иерархические иерархических
примен: применить
пут: пути путь пут
окружен: окружения
пример: примеры примере
методолог: методология
аутентификац: аутентификации
систем: системы системе система системах
бесполез: бесполезен
мож: можем
затрон: затронем
обсужден: обсуждение
дополн: дополнил
круглов: круглова
основн: основные основном основной
микросервис: микросервисов
трудн: трудно
заворачива: заворачивается
вышл: вышло
курс: курсы
ресурс: ресурса ресурс ресурсы ресурсов
метод: методов
машин: машины машин
лидер: лидерами
процесс: процессы процессов процесс
основа: основанные основан
свойств: свойства
техник: техникой
неудач: неудачи
требован: требования требованиями
решен: решения решением
хотел: хотелось хотел
культур: культуры
средн: средний
продолжа: продолжается
нужн: нужные
поздн: поздно
вакуум: вакууме
подряд: подряд
хаб: хабы
описан: описания
помощ: помощью помощь
мемпул: мемпула
приложен: приложение приложениями приложения приложениях приложений
командн: командной
красив: красиво
довольн: довольна
бессердечн: бессердечной
ваканс: вакансиях вакансии
настройк: настройка настройки
вклад: вклад
дал: далее
проталкива: проталкивающем
товарн: товарными
пониман: понимании
документ: документы
прочтен: прочтение
пересел: пересел
ссылк: ссылку
серверн: серверное
навык: навыков навыки
заманчив: заманчивые
нуж: нужен
средств: средств
дам: дамой
дан: данной
финуслуг: финуслуги
займет: займет
охват: охват
состоя: состоящим
осуществля: осуществлять осуществляется
закон: закону
любопытств: любопытство
хват: хватить
код: код кодом
паттерн: паттерны
модул: модули модулей модулями
регистрац: регистрация
кол: кол
четырех: четырех
кон: коня
перевел: перевела
имеет: имеет
генератор: генераторах генераторы
митап: митапы
владеющ: владеющий
формирован: формирования
отсутств: отсутствии
функц: функцию функций
внесен: внесения
упрост: упростить
заменя: заменять
мся: мся
цел: целом целей
цен: ценой
построен: построения построенной
отлича: отличаться
кажд: каждого каждой
нагрузок: нагрузок
следован: следовании
дзен: дзен
политик: политики политику
вмест: вместе
уход: уходят
отличн: отличные
спот: спотах
жив: живые живое
обнов: обновить
донастройк: донастройка
разработк: разработкой разработке разработка разработки
закладк: закладки
ведет: ведется
налич: наличии
использова: использоваться
настроек: настроек
юл: юлии
стратег: стратегий
программн: программного программных
поколен: поколения
контейнер: контейнеров контейнерах
установк: установка
добавля: добавляется добавлять
метрик: метрик
сюд: сюда
релиз: релизе
глобус: глобус
список: список
пост: посте
поехал: поехалиии
отполирова: отполированного
итог: итоге
меньш: меньшей
след: следили следующем
напомн: напомним
строк: строки
дел: деле
вопрос: вопросе вопрос
организац: организациям
дизайн: дизайн
концепц: концепции
пошагов: пошаговую
устройств: устройство
договарива: договариваться
ваш: вашей ваших вашими
пустяков: пустяковое
так: такими таки
пространств: пространств пространстве пространствах пространства
собствен: собственно
флант: флант фланте
техническ: техническая
дьявол: дьявол
оплат: оплату
красот: красотой
держа: держать
фев: фев
расширен: расширений
заметк: заметке
материал: материалах материалов
минус: минусы
мегапроект: мегапроекты
хабр: хабр
некотор: некоторые
рассмотр: рассмотрим
потенциальн: потенциальный потенциальные
ртыван: ртывание ртыванием ртывания
количеств: количество
эльдорад: эльдорадо
соглашен: соглашение
ам: ами
полез: полезен
логичн: логичностью
добав: добавить добавив
щелкнут: щелкнуть
просмотр: просмотров
специальн: специальное
практик: практик практики
мысл: мысль
последн: последние
замечан: замечаниям
конфигурац: конфигурация конфигурациями конфигураций
сам: самое самых
представля: представляют представляет
манипулирова: манипулировать
виртуальн: виртуальных
настраива: настраиваемый
стартап: стартапам
туториа: туториал
приход: приходят
подключен: подключении
оказыва: оказывается
бекап: бекап
называ: называемом
кластер: кластерами кластере кластер кластера кластером кластерах
менеджер: менеджер
компан: компанией компаний компании
выполнен: выполнения
программ: программами программы
управлен: управление управления
ежедневн: ежедневные
предназначен: предназначенного
разбира: разбираемся
действ: действие
фундаментальн: фундаментальные
предъяв: предъявить
жутк: жуткой
митигирова: митигировать
умолчан: умолчанию
стандарт: стандартом
привет: привет
внедр: внедрить
очередн: очередной
состоян: состоянием состояние
поможет: поможет
вс: вс
высокоуровнев: высокоуровневому
рад: рад
использ: используются
имеют: имеют имеются
магазин: магазин магазинов
созда: создан создать
сво: свой
ран: ранее
объясня: объясняем
кейс: кейс
программирован: программирование
отдельн: отдельный
реша: решать решают
отобража: отображаемые
порог: порог
сохранен: сохранения
выполн: выполнить
значительн: значительными
тест: тестами
реализац: реализации реализация
истин: истины
явля: является являются
узл: узлами узлам
тем: темы теме
освет: осветить
выступлен: выступления
применя: применяются
пришл: пришла пришли
администрирован: администрирования администрирование
трансформац: трансформация трансформации
де: де
знат: знать
криптомат: криптоматы
разграничен: разграничению
представ: представить представилось
легковесн: легковесного
анонсирова: анонсировали
определя: определяет
сайт: сайта
знан: знания
обеспечен: обеспечения
суперадминистратор: суперадминистратора
научпоп: научпоп
технолог: технологиями технология технологии
терп: терпим
продолж: продолжим
задач: задачу задачи задач
комментар: комментарии
файл: файлов файлы
праздн: праздное
тренинг: тренинги
рамк: рамках
пользова: пользовался
различн: различные различных
сотрудник: сотрудники
хвата: хватало
инженерн: инженерных инженерная
приступ: приступить
увольня: увольняются
прош: прошу
компьютер: компьютером компьютерами
работа: работать работал работающее работалось работает
детал: деталях
песочниц: песочницы песочница
сегодняшн: сегодняшнем
долж: должен
тарифн: тарифного
коснут: коснуться
вызва: вызвала
блок: блоки
нкин: нкина
услуг: услуги
безболезнен: безболезненно
базов: базовые
натягива: натягивается
платежн: платежные
блог: блог
необходим: необходимо
истор: истории история
зовут: зовут
автоматизац: автоматизацию автоматизации
ход: ходе
увлекательн: увлекательная
кваш: кваш
интерфейс: интерфейс
скрипт: скриптами
манася: манасяна
пробл: проблему
сложност: сложности
факт: факто
ещ: ещ
параметр: параметров
автор: авторы автором авторов автора
нагружен: нагруженных
функционал: функционалу
сер: серии
чита: читать
сет: сети
конфиденциальн: конфиденциальность
собеседован: собеседований
виде: видео
подход: подходах подхода подход
защит: защитить
организу: организуем
придет: придется
экосистем: экосистемы
науч: научиться
разумн: разумно
нескольк: нескольких несколькими
быстр: быстро
вышеперечислен: вышеперечисленных
реальност: реальность
спрос: спросить
бизнес: бизнес
принима: принимает
криптообменник: криптообменники
тип: типов
позволя: позволяют позволяет
хоч: хочу
внедрен: внедрения
рейтинг: рейтинг рейтинга
распространен: распространенных
статическ: статических
реч: речь
реш: решил решили решить
известн: известными
общ: общем общее
сторон: стороны сторонних
поток: потоки
виртуализац: виртуализация виртуализации
поддержк: поддержкой поддержки поддержка
остальн: остальные
угодн: угодно
набор: набора набор наборы
поддержива: поддерживаются
барыков: барыкова
брокер: брокера
конфигурацион: конфигурационные
ид: идей
удобн: удобно
сред: сред
лицензирован: лицензирования
им: имен
ин: иной
наш: нашего
сия: сияет
мног: многое многие многих
пользовател: пользователя пользователь пользователем
транзакц: транзакции транзакциям транзакцию
посвящен: посвященных
люб: любом любого любой
зависим: зависимости зависимостей
компонент: компонентов
язык: языку языка
потреб: потребуются
согласова: согласованных
криптовалют: криптовалюты
син: синей
план: плана плане
крупномасштабн: крупномасштабными
содержа: содержащие
сервис: сервиса сервисы сервис
тита: титан
соответствова: соответствовала
описа: описать описал
информац: информация информации
фронтенд: фронтенде
облачн: облачные
разн: разному
биткоин: биткоине
ключев: ключевых
способств: способствующей
удален: удаление удаленного
продакт: продакт
разв: разв
замен: заменить
дополнен: дополнениям
гравитац: гравитация
ожидан: ожиданиям
интерв: интервью
ко: кое
поговор: поговорим
применен: применение применения
админ: админа админу админом
хуж: хуже
создан: создание
собра: собрали
вывод: выводу
храня: хранящихся
прич: прич
конвейер: конвейеров
привод: приводятся
волк: волков
антон: антона
например: например
подготовк: подготовку подготовка подготовки
одн: одним одно
выстрел: выстрелят
широк: широкой широко
мар: мар
коллег: коллеги
согласн: согласно
классн: классной
реклам: реклама
неприемлем: неприемлемо
разбер: разбер
перенасыщ: перенасыщен
корпоративн: корпоративный
понятн: понятно
нагрузк: нагрузки
функциона: функционала
соответств: соответствующее
запуск: запуска
нативн: нативные
шаблон: шаблона шаблоны шаблонах шаблонов
расширя: расширяем
инструмент: инструмент инструменты
надежн: надежности
команд: команда команды команде командой команд командам
плюс: плюсы
польз: пользы польза
познаком: познакомиться
стек: стек стеком
стран: страны
инструкц: инструкцию
использован: использование использования использованием
отлич: отличия
платформ: платформе платформы
сист: систем
душ: душа
безагентск: безагентским
войт: войти
исходн: исходным
аккаунт: аккаунт
разделен: разделение
газпромбанк: газпромбанк
неподтвержден: неподтвержденные неподтвержденным
протокол: протоколу
прохожден: прохождения
выбор: выбора
счаст: счастью
сэкономлен: сэкономленных
проблем: проблемы
репозитор: репозитории
подробн: подробностями
излага: излагается
сервер: серверов сервера
поближ: поближе
сов: сова
раздел: разделить разделы
автоматическ: автоматически
намн: намного
яндекс: яндекс
унифицирова: унифицированно
новост: новости
лучш: лучшие лучших
перв: первая
механизм: механизм
управля: управляемым управлять управляемого
спотов: спотовыми
небольш: небольших
приня: принять
разворачива: разворачивал
написа: написать написал
поиск: поиск
возможн: возможности возможно
интересн: интереснее интересное интересными интересные интересно интересную
изменен: изменений
дальн: дальнейшем
артефакт: артефактов артефакты
неудобн: неудобной неудобно
основ: основе основам
открыт: открытым
выбра: выбрать выбранными
позвольт: позвольте
голов: голове
кафк: кафке
боя: боялся
образовательн: образовательные
как: каком какие
определ: определить
функциональн: функционального функциональное
крупн: крупных
сконфигурирова: сконфигурированных
голос: голосов
кат: кат
рассматрива: рассматривали рассматривать
тся: тся
взгляд: взгляд
тематическ: тематический
высок: высокими
бывш: бывшие
реальн: реальная
кроет: кроется
архитектур: архитектуры
риск: риски
сфер: сферой
откр: открыт открыть
способ: способен
узел: узел
кнопк: кнопку
карапет: карапета
термин: терминах
конференц: конференции
источник: источником источник
polina: polina
backup: backup
osminog: osminog
devop: devops
argocd: argocd
ansibl: ansible
ssh: ssh
helm: helm
sso: sso
healthcheck: healthcheck
twitter: twitter
statefulset: statefulset
faq: faq
teamview: teamviewer
lock: lock
api: api
aa: aas
sokol: sokol
manag: manager
nuxt: nuxt
otu: otus
node: node
sli: sli
nativ: native
aw: aws
slide: slides
kafka: kafka
spot: spot
rbf: rbf
slo: slos slo
singl: single
habr: habr
pod: pod
standalon: standalone
document: document
avvolkov: avvolkov
js: js
secret: secret
anydesk: anydesk
yrepear: yrepear
youtub: youtube
rss: rss
jsonnet: jsonnet
kustom: kustomize
web: web
southbridg: southbridge
terragrunt: terragrunt
packag: package
typescript: typescript
art: art
set: setting
ci: ci
facebook: facebook
nest: nest
zubarek: zubarek
commerc: commerce
zepar: zepars
googl: google
seasadm: seasadm
reliabl: reliability
apach: apache
manassian: manassian
instanc: instances
fee: fee
lyova: lyova
sign: sign
namespac: namespace
anna: anna
deploy: deployment
cloud: cloud
vuej: vuejs
implement: implementing
andrei: andrey
vek: vek
replac: replace
mvideo: mvideo
yaml: yaml
golovind: golovinds
askobin: askobin
distol: distol
nabdullin: nabdullin
nginx: nginx
spa: spa
averina: averina
amazon: amazon
core: core
servic: service services
vk: vk
mdo: mdos
gitlab: gitlab
amorev: amorev
terraform: terraform
primetalk: primetalk
deckhous: deckhouse
biryukov: biryukov
book: book
kubernet: kubernetes
docker: docker
chemtech: chemtech
saa: saas
git: git
wimbo: wimbo
aigrychev: aigrychev
json: json
sam: sam
shurup: shurup
kvin: kvin
agil: agile
gm: gms
moex: moex
custom: customization
sre: sre
kvap: kvaps
telegram: telegram
gitop: gitops
step: step
olegchir: olegchir
bitcoin: bitcoin
