нейрон: нейронных
найт: найти
провинциа: провинциал
говор: говоря говорят
банк: банке
расскаж: расскажу
рассказ: рассказ
независим: независимых
стат: стать статье статьи статья
обычн: обычного
стар: старую
инвестор: инвесторам
вызов: вызовов
дорог: дорогой
стал: стала стали
вуз: вузов
гибкост: гибкости
кибз: кибза
обзор: обзор
стад: стадии
см: см
появ: появилось
случа: случае случаях
наподоб: наподобие
работ: работа работе работы работу
завис: зависят
рекламн: рекламных рекламные
нейронк: нейронки
показыва: показывать
практическ: практически
вернут: вернуться
принос: приносила
пол: полях
приглаша: приглашаем
учебн: учебный
сто: стоит
омн: омни
монобренд: монобрендов
схем: схема
д: д
менеджмент: менеджмент
прототипирован: прототипирование
разговор: разговор
то: той
н: н
мобильн: мобильных мобильного
ошибок: ошибок
исследовательск: исследовательской
структур: структуру
публикац: публикации
скопирова: скопировать
карт: карты картам карта
макс: макс максим
ч: ч
подел: поделиться поделимся
поэт: поэтому
ы: ы
назван: названия названию
котор: которое которыми
ув: увы
мин: мин
вариант: вариантов
дискуссион: дискуссионные
мир: мир мире
исследован: исследованиями исследования исследований исследованиях
шаг: шаги
прав: правил правила
связа: связано связанные
нестандартн: нестандартно
обратн: обратную
географическ: географические географических
сниппет: сниппетов
уч: учиться
проект: проектов проекты проект проектами
почерпнул: почерпнул
связ: связи связь
лид: лид
феврал: февраля
профил: профиль
шутк: шутки
проектн: проектным
получ: получила получить
застря: застрял
публик: публики
перевод: перевод
читальн: читальный
верс: версию
маркетинг: маркетинг маркетинга
рван: рвано
книг: книги
библиотекар: библиотекари
час: час
прост: простое простого прост простой простейших
зал: зал
сосед: соседа соседей
зам: замены
проверк: проверке
индустр: индустрии
занима: занимается
каталог: каталоге
могл: могли
встреч: встречах
лиц: лицам
подруж: подружиться
встрет: встретился
псб: псб
уровен: уровень
нов: новую новые новых новое новая
специфик: специфике
продуктов: продуктовые продуктового продуктовый продуктовом
сверх: сверх
медийн: медийная
расскажет: расскажет
част: часть частые
иде: идея
цифров: цифрового
алекс: алексей
карьер: карьера
офис: офис
вход: входит
направлен: направлением
игр: игра
модерац: модерации
кана: канал
полезн: полезного полезных полезное
парен: парень
постоя: постоянно
сдела: сделать сделают сделал
телегр: телеграм
рожден: рождения
эффективн: эффективного
сложн: сложный
демографическ: демографическом
представлен: представление
совет: советы совет
генерац: генерации генерация
видел: видели
примен: применить
пут: путь
ост: оста
виден: видение
активн: активности
пример: примеров примерах
штук: штуки
сформирова: сформировал сформировалось
систем: система системы
кастомизирова: кастомизировать
рефакторинг: рефакторинг
узна: узнаете
невероятн: невероятно
сотн: сотнях
баннер: баннеры
фаворит: фавориты
дополн: дополним
развива: развиваются
конве: конвея
основн: основных основную
курс: курсах
категор: категория категории
сможет: сможете
плиточн: плиточная
читател: читатель
ресурс: ресурсы
миха: михаил
метод: метода
машин: машинное
неплох: неплохой
процесс: процессы процесс
основа: основано
групп: группы группах групп группа
помогут: помогут
окрестн: окрестности
окружа: окружающих
витк: витком
хотел: хотел
культур: культуры
актуальн: актуальности
средн: средний
личн: личных лично
продолжа: продолжаем
комфортн: комфортной
нужн: нужный нужна
подряд: подряд
помоч: помочь
меня: меняли
помога: помогает
хаб: хабы
рынк: рынка
нрав: нравится
помощ: помощи помощью помощь
кредитн: кредитного
слайд: слайды
гугл: гугл
приложен: приложений приложения
выполня: выполнять
разработчик: разработчиков разработчиком разработчика
умира: умирает
результат: результат
банковск: банковская банковского
продвинут: продвинутый
здоров: здоровье
опыт: опытом опыта
киберпанк: киберпанк
ваканс: вакансии вакансий
настройк: настройки настройка
вклад: вклад
дал: далее
промышлен: промышленный промышленного
генеративн: генеративного
пониман: понимании
документ: документы
прочтен: прочтению прочтение
будущ: будущее будущего будущем
ссылк: ссылку
навык: навыкам навыков
калькулятор: калькулятор калькулятора
пенсионер: пенсионеры
эволюционирова: эволюционировал эволюционировала
лпр: лпр
дам: дам
дан: данная данной
франциск: франциско
удивля: удивляться
картинк: картинками картинках картинку
дизайнер: дизайнером дизайнер дизайнера дизайнеров дизайнерам
протяжен: протяжении
состоя: состоялась
код: кода
рост: роста
регистрац: регистрация
коп: копаясь
извест: известен
гипотез: гипотез гипотезами
многоуважа: многоуважаемого
поисков: поисковой
цикл: циклы
спортмастер: спортмастер
счита: считается
функц: функциях функций функции функциям
различ: различая
упрост: упростят
используем: используемых используемыми
цел: целый целом
построен: построения
кажд: каждым
мур: мура
руководител: руководитель
возраст: возраст
шаблонизац: шаблонизация
почтен: почтенным
продемонстрирова: продемонстрировать
полин: полина
дзен: дзен
вмест: вместе
эх: эх
телеэфир: телеэфира
создава: создавать
отличн: отлично отличных
искусствен: искусственный
утилит: утилиту утилиты
жив: живых
обнов: обновить
дюжин: дюжины
гончаренк: гончаренко
разработк: разработка
закладк: закладки
графическ: графическую графический
использова: использовать использовали
богда: богдана богдан
направл: направлены
начал: начале
поколен: поколениями поколения
руководств: руководство руководством руководству
сюд: сюда
професс: профессии
карьерн: карьерные
слеп: слепые
список: список
пост: пост посте поста
рекомендова: рекомендовано
итог: итоги
клетк: клетки клетка
возобнов: возобновил
дел: делимся деле делюсь
строк: строке
дем: демо
дизайн: дизайна дизайном дизайне дизайн
рассказа: рассказать
невозможн: невозможно
пошагов: пошаговая
макет: макетов
устройств: устройство
пришел: пришел
клиент: клиент
коротк: короткий коротко
ваш: вашей
зрелищн: зрелищных
так: такими таких таки
ответ: ответ
общен: общению
никт: никто
усил: усилия
полност: полностью
семейн: семейное семейные
проектирован: проектирование
собствен: собственные
грабл: грабли
баз: база базы
техническ: техническая
условн: условны условные условных условными
мощн: мощнее
алгоритм: алгоритмы
фев: фев
дет: дети
людьм: людьми
проведут: проведут
авде: авдеев
заметк: заметки
материал: материалов материалы
слыша: слышали
собира: собирали собирал
мегапроект: мегапроекты
описыва: описывает
хабр: хабр хабра
смен: сменил
аналитик: аналитикой
обучен: обучение
некотор: некоторых
фрейм: фреймам
удивительн: удивительно
количеств: количество количеством количества
такс: такси
соглашен: соглашение
рома: роман
куч: кучу
добав: добавить добавил добавим добавили
просмотр: просмотров
практик: практиков практики
методик: методикой
посмотрел: посмотрели
дополня: дополняются
автомат: автоматов автомата
сам: самый самое самых самые
сан: сан
представля: представляет
качествен: качественных
интеллект: интеллект
скаж: скажу
цветов: цветовых цветовые цветовым
настраива: настраивать
стартап: стартапам
туториа: туториал
выглядет: выглядеть
правильн: правильном
поня: понять
образован: образование
называ: называют называется
менеджер: менеджеры менеджеров менеджерам
семушин: семушин
компан: компаний компании
рассказыва: рассказывали рассказывают рассказываем
извин: извините
программ: программа программы
управлен: управление
проектиру: проектируем
интеракт: интерактив
получа: получает
главн: главное
лендинг: лендингов
обеспечива: обеспечивают
вед: веду
руковож: руковожу
элемент: элемента
двумерн: двумерного
привет: привет
рубеж: рубежом
состоян: состояния
стоя: стояла
немног: немногая
популярн: популярное
вс: вс
отдел: отделы отдел отдела
покаж: покажу
дайджест: дайджесте
начн: начнем
имеют: имеют
визуальн: визуальной
област: области
научн: научно
цвет: цветами цвета цветов
созда: создать
магазин: магазина
инвалидн: инвалидностью
фигурирова: фигурировали
кирилл: кирилл
объясня: объяснять
веб: веб
кейс: кейс
программирован: программирование
исход: исходя
нача: начать
отдельн: отдельным отдельных
рисеч: рисече
порог: порог
реализ: реализуются
станов: становились
гк: гк
интернет: интернет
необычн: необычных
реализац: реализации
московск: московский
плеч: плечо
явля: является
чуточк: чуточку
комьюнит: комьюнити
виктор: виктор
игров: игровой
вещ: вещей
тем: тема теме
применя: применять
спроектирова: спроектировал спроектировать
брендинг: брендинг
администрирован: администрирование
развит: развития развитие
консультац: консультации
контроллер: контроллер
перед: передо
сайт: сайта сайтов
знан: знаний
контрол: контроля
колледж: колледжей
научпоп: научпоп
комментар: комментарии
задач: задачу задача
пользова: пользоваться
рамк: рамках
спаса: спасайтесь
хвата: хватает
задан: задания
нейросет: нейросети
проч: прочее
смотрител: смотрители
работа: работают работаем работает работаю
сильн: сильно
спринт: спринты
песочниц: песочницы песочница
пар: пару пары
услуг: услуги
тред: тред
заинтересова: заинтересованным
треб: требуется
доработа: доработать
необходим: необходимых необходимые
блог: блог
истор: истории
зовут: зовут
прод: прода
подходя: подходящую
мышлен: мышления
разрез: разрезе
запартн: запартн
интерфейс: интерфейсы
адепт: адептов
тепл: теплов
модел: модели
клуб: клубы
сложност: сложности
ещ: ещ
привед: приведу
автор: авторы автор автором авторов
чита: читать
лонгрид: лонгрид
представител: представителей
сет: сети сеть сетей
челлендж: челленджи
конфиденциальн: конфиденциальность
виде: видео
положен: положение
защит: защиты
казахста: казахстан
науч: научится
реб: ребят
рев: ревью
счастлив: счастливее
быстр: быстрого быстрой быстрее
эксперт: эксперт
хот: хотим
уточн: уточни
характеристик: характеристики характеристиках характеристиками
внедрен: внедрении
рейтинг: рейтинг рейтинга
статическ: статических
компетенц: компетенции
реш: решила
известн: известного
специализац: специализации
поток: потоке потоки
пута: путано
импульс: импульс
честн: честного честно честным
смотр: смотры
поддержк: поддержка
недел: неделе
тысяч: тысячах
принцип: принципов
профессиональн: профессионального
пуст: пустой
ид: идеи идей
никит: никита
удобн: удобно
сред: среди
заглавн: заглавных
социальн: социальные
наш: нашим нашей
может: можете
редактор: редакторов
мног: многое многих
пользовател: пользователя пользователи
просьб: просьбе
именован: именования
зависим: зависимости
авторск: авторский
компонент: компоненты
язык: языке язык языка
план: плане
таблиц: таблице
сервис: сервиса
стил: стилей
евген: евгений
описа: описаны
нотац: нотацией
информац: информация информации
составля: составляющей составляющую
взят: взять
фронтенд: фронтенд
анализ: анализ
продакт: продакт
трат: тратить
математическ: математических
люд: людей
подмет: подметила
разв: развить
ка: ка
ровн: ровно
отвеча: отвечают отвечаем
погод: погоды
использу: используем
предварительн: предварительное
максим: максимов
конкретн: конкретно конкретном
открыва: открывайте
интерв: интервью
расставля: расставляем
куратор: куратор
сбер: сбер
поговор: поговорил
слоупок: слоупок
создан: создания создании
клеточн: клеточных клеточного
потеря: потерялся
собра: собрал
дворов: дворовый
спас: спас
запис: записи
рил: рились
антон: антонов
любимц: любимцы
финтех: финтех
например: например
знает: знает
одн: одну
инсайт: инсайты
мам: мамы
правил: правилам правиле
картинок: картинок
мар: мар
коллег: коллегам
светлот: светлоту
наблюден: наблюдений
увеличен: увеличения
реклам: реклама
запуст: запустил
настольк: настолько
корпоративн: корпоративный
рекомендац: рекомендации рекомендацию
обращен: обращении
пуговиц: пуговицы
нарис: нарисует
запуск: запуска
нативн: нативные
библ: библу
шаблон: шаблоне шаблон
инструмент: инструменты инструментами
доклад: докладов
полиста: полистать
огромн: огромном
команд: команды команде
локализац: локализация
итак: итак
ведущ: ведущий
сообществ: сообществе сообществом сообщества
зрелост: зрелости
объединя: объединять
типаж: типаж типажами
любопытн: любопытно любопытный
учат: учатся учат
диджита: диджитал
предупрежда: предупреждаю
январ: января
десятк: десятки
запрос: запросы запросов запрос
поскольк: поскольку
сист: систему систем
горазд: гораздо
стилизац: стилизации стилизация
войт: войти
нечт: нечто
качеств: качестве
выживан: выживания
пригод: пригодятся пригодиться
тон: тон
процессор: процессоры
пил: пилим
аккаунт: аккаунт
модератор: модератора
глаз: глазами
комплекс: комплекс
выбор: выбор
лан: ланит
наскольк: насколько
сраз: сразу
благодарн: благодарны
онлайн: онлайн
насыщен: насыщенность
порядк: порядка
пиш: пишу
проблем: проблемы
подробн: подробно
сервер: сервера
раздел: разделилась разделы
подростк: подростки
выражен: выражениями выражения выражений
исследовател: исследователей
продума: продумать
яндекс: яндекс
обработа: обработает
новост: новости
лучш: лучшие лучших
существ: существует существующих
перв: первого первом
дума: думать
ок: окей
облегч: облегчили
крайн: крайне
гайд: гайд
написа: написать
поиск: поиск
возможн: возможности возможно возможностях
изменен: изменения
интересн: интересно интересных
оп: опыт
наращива: наращивать
равн: равно
молод: молодые
воспоминан: воспоминаний
новосел: новоселов
маркетингов: маркетинговую
образовательн: образовательные
хочет: хочет
как: какие
функциональн: функциональность
крупн: крупные
неполн: неполных
голос: голосов
страниц: страницы страниц странице страницам
смешива: смешивать
отвертк: отвертку
бенчмаркинг: бенчмаркинга бенчмаркинг
кат: катом
преодолен: преодоления
взгляд: взгляд
тся: тся
прошл: прошлой
респондент: респондентов
реальн: реально
портфол: портфолио
взглян: взглянем
втор: втором
креативн: креативной
точн: точно
непрозрачн: непрозрачность
изображен: изображений
сфер: сфера сферу
улучша: улучшаются
стандартн: стандартным стандартные
брызгал: брызгалов
откр: открыт открыть
способ: способ
бесчислен: бесчисленным
наход: находятся
напрям: напрямую
продукт: продуктов продукте продукт продукта
одежд: одежды
конференц: конференции конференция
satur: saturation
sourc: source
css: css
ruvd: ruvds
sfjazz: sfjazz
intellig: intelligence
landau: landau
baragol: baragol
lab: lab
artifici: artificial
hadi: hadi
cloud: cloud
sdui: sdui
twitter: twitter
redcollar: redcollar
dall: dall
limmm: limmm
ui: ui
function: functions
html: html
commun: community
adob: adobe
vip: vip
meetup: meetup
designop: designops
digit: digital
tech: tech
conwai: conway
ux: ux
nginx: nginx
upd: upd
ivansychev: ivansychev
usabl: usability
javascript: javascript
vd: vds
mordatyj: mordatyj
light: lightness
vk: vk
epam: epam
habr: habr
maslukhin: maslukhin
ozon: ozon
rr: rr
adrior: adrior
game: game
tlhe: tlhe
ru: ru
denissidak: denissidak
color: color
lilia: lilia
sportmasterlab: sportmasterlab
lanait: lanaite
timeweb: timeweb
interact: interactive
linkedin: linkedin
life: life
uxuitelno: uxuitelno
anti: anti
youtub: youtube
br: br
notion: notion
rss: rss
hous: house
figma: figma
design: design
kit: kit
sportmast: sportmaster
podust: podust
unixspv: unixspv
kiril: kirill
alizar: alizar
center: center
facebook: facebook
telegram: telegram
xd: xd
getrend: getrender
gfk: gfk
lead: leading
slam: slammed
lizapri: lizapris
tutme: tutmee
ipso: ipsos
anatoli: anatoly
shutterstock: shutterstock
alexefremo: alexefremo
opac: opacity
wedmashka: wedmashka
zgalov: zgalov
hue: hue
sketch: sketch
open: open
