найт: культовой
банк: банкам
рф: рф
найм: найма
образ: образом
стат: стать статьи
строител: инженер
смеша: водители
европейск: европейским
обычн: вернутся водителей
стар: вернуться
федеральн: федеральная
конц: космонавтика
дорог: дорогах дорогам
стал: сах
кевин: кевина
предлага: которую предлагает предлагают
соглас: согласия
сброс: сброс
северн: северная
электроник: электроники электроника
случа: случае
появ: появиться
центр: центр
работ: работа работе работ сол
показыва: показывать
дополнительн: дополнительно
мозг: мозга мозг
вернут: порога поддержка
получен: получения
пропаж: пропажу
учебн: учебный
обновлен: обновления обновление
критическ: критическим
санкц: санкции
д: д
вообщ: вообще
менеджмент: менеджмент
финанс: финансы
и: ии
лет: опцию
экра: экран
й: й
л: прив
мобильн: мобильных корпоративные
должн: должном
публикац: разделы
скопирова: скопировать
студент: студентов
означа: прежнему буквально
график: графикой
сообщ: сообщило
показа: показала
котор: концепция
денег: денег
учт: учтены
тейлор: тейлор
мин: мин
вариант: зеленому
мир: мире
моделирован: моделирования
видеокарт: видеокарт видеокарты
проверя: консоль
статистик: статистику
проект: автор нативные
связ: связи поддерживать
вперв: впервые
феврал: конце
зав: персеверанс
координирова: эффективно
профил: профиль
получ: дерош получило получить
режим: режиме
верс: старую
маркетинг: маркетинг
байд: байдена
документальн: выход сняла
кров: крови
час: часы часов часа
мексик: европе
чат: чат
голлум: голлум
традиц: февральской
нно: нной
опр: опру
издан: интервью издание
позвол: диапазоне
озвучк: покашлял
мкс: космонавты
проверк: проверке
следова: скажет машин
лэйдло: марк
высокоточн: высокоточные
движен: смешанном зеленый
проинформирова: движения
уровен: уровень
нов: новые новой
больш: большой сходящимся
софт: софт
медийн: корпоративный
сценарист: бывший
инженер: автономных инженеров
хэнкс: хэнкса
опц: тестировать опцией опциями
игр: вортигонта лучей
дональд: дональда
одновремен: одновременно
автомоб: автомобили
вортигонт: всезнающего
сдела: сделать
определен: упадет перекрестках
выдава: выдавать
эффективн: позволит
устанавлива: устанавливать устанавливаются
персеверанс: марсоход
камн: первого
генерац: генерации
примен: применить применили
паскал: директор
активн: активности
вперед: беспилотником
культов: разработки
операцион: операционную операционной
приоритет: отдавая
дерош: паскаль
систем: системы
тайваньск: тайваньский
выход: марта
персонаж: персонажей
шерлок: шерлок
свифт: свифт
проезд: проездом
осак: осаки
заблокирова: заблокировала
сша: компаний
машин: обычных машинное
процесс: процесса факте процесс
обам: обаму
гейб: глава
почт: почтой почты
заезд: заезд
европ: странах возраст
хайбабай: али
написан: написании
нных: нных
перекресток: движущимися
продолжа: остановится
отч: отч
смерт: смерти
подряд: подряд
хаб: хабы
бесплатн: бесплатный бесплатно
скажет: движение
неизвестн: изданию
кредитн: кредитных
приложен: приложений приложения
дав: количеством
настройк: настройкам дзен
обнаруж: обнаружили
дал: далее
текст: тексте
сигнал: послужит
документ: авторов
прочтен: прочтение
будущ: будущее будущем
ссылк: ссылку
эсс: эссе
фас: фас
сходя: приоритет
транспортн: транспортном необходимости беспилотными транспортных транспортные
средств: транспортными транспортным средства средств
потребова: потребовалось
отключ: отключ
гипотетическ: гипотетическом
дат: дата
евробанк: евробанками
связыва: связываться
фаз: белой
плох: плохой плох плохи
эвердин: эвердин
рост: л условия
росс: россии
регистрац: войти
поручен: поручений
кол: возит
тестирова: европы
камен: попал
автомобил: автомобилям следовать
кор: южной
числен: численности
гигант: гигант
отсутств: отсутствие
функц: функций функции
канадск: рассказывает
предлож: предложила
упадет: перекрестке
руководител: проекта
возника: возникает
возраст: проверять
канад: мексике
продемонстрирова: продемонстрировала
российск: российских
мира: миран
дзен: мегапроекты
канал: найти
порносайт: канадского
вмест: вместо
финансов: заявил
преподавател: преподаватели
директор: финансовый
искусствен: искусственный
ошибк: ошибки
обнов: обновить
разработк: разработка процессе
закладк: закладки
использова: сша использовали
марсоход: рейтинг традицией
перифер: периферия
установк: установка
электропикап: электропикапа
электрогрузовик: электрогрузовика
сюд: пристыкованный
полупроводников: полупроводниковый
высш: высшей
китнисс: китнисс
список: список
йод: йода
энерг: энергия
обеспеч: спрос
абонент: числа
организац: организаций организации
дизайн: дизайн
рассказа: лэйдлоу
концепц: впереди
луч: трассировки
устройств: информация
вымышлен: вымышленных
клиент: клиента клиентов
леброн: леброна
зелен: остановку желтому
сигнализирова: сигнализировать
так: таких таким
ответ: ответы
сниз: снизить
баз: базе
оптимальн: рекомендации
техническ: языка
бейонс: бейонсе
станц: космической
джо: джо
февральск: стало
перенесл: мкс
драйвер: драйвера
беспилотник: автомобилем
пристыкова: корабля
мегапроект: стартапам
уведомлен: уведомления
остановк: означать
хабр: хабр
передов: передовых
подбира: марсохода
дидд: дидди
обучен: обучение
космонавтик: камень
обуча: обучать
сах: кол
обща: общаться
космонавт: сиквела
количеств: количество большим
служб: служба
ал: строитель
соглашен: документы
покашля: спел
попа: попавших колесо попавшим
встро: встроила
каролин: каролина
добав: добавить
просмотр: просмотров
мысл: мысль
ряд: ряды
транспорт: транспорт
нанима: нанимает
услов: условиях хорошие
вливан: вливание
беспроводн: ним
интеллект: интеллект
настраива: настраивать
всезна: озвучке
друг: ещ связь друг
стартап: образовательные
вырос: фоне
школ: школы
вейдер: вейдер
запущ: запущена
называ: развязок
компан: компании запрет компания
рассказыва: фильма
попутчик: подбирать
программ: программы
управлен: управление
вчер: вчера
сбо: сбоем
смысл: смысла
элемент: элементы
жно: жной
внедр: внедрили
стандарт: стандарты
млрд: млрд
популярн: популярное
использ: фазой
ложемент: перенесли
научн: научно
цвет: цвет
движущ: средствами
имеющ: имеющейся
плагин: плагин
ран: ранее
сигна: сигнал
занов: заново
порог: порог определенного
замеча: замечают
гк: яндекс
возникл: возникла
носим: носимая
игров: сценарист игры
появлен: солов
дуэйн: дуэйна
официальн: официальный
администрирован: администрирование
почтов: почтового
заводск: заводским
анонсирова: анонсировала
дарт: дарт
питан: питания
бел: белый называем
сайт: устройство
научпоп: научпоп
продолж: ведущий
бэтм: бэтмен
комментар: комментарии
штат: штата
клиентск: клиентских
рамк: рамках
пользова: пользоваться
сотрудник: сотрудников
задан: задание
нейросет: нейросети
компьютер: компьютеры компьютер
работа: работало работают работать
запрет: порносайта запретить запрета
песочниц: публикации
услуг: конфиденциальность
джонсон: джонсона
телефон: мобильные
платежн: платежные
блог: сюда блог
необходим: проинформированы
истор: игр истории
числ: роста
ход: ходом
ес: ес
модел: модель
факс: факсом
тайтл: игровых
ещ: зав
факт: неизвестном
грузов: грузовым
автор: авторы участие сайта автором
биологическ: биологических
спел: ньюэлл
гэндальф: гэндальф
чита: читать
сет: сети
конфиденциальн: соглашение
барак: барака
регулятор: регуляторы
едут: едут
красн: перекресток обычному
корпорац: японии
диапазон: определенном
разумн: разумно
слетет: слететь
водител: водителям сигналом многие
пробок: пробок
спрос: вырос росту
наук: наук
вышел: вышел
разреш: разрешил разрешили
бумаг: бумагой
рейтинг: рейтинга прошлого
скорост: оптимальной
портативн: консоли
альтернативн: альтернативными
известн: известных
гарр: гарри
международн: международной
общ: общее общей общий
послуж: беспроводной
знаменит: знаменитость
поток: потоке потоки
поддержк: поддержкой получила техническая
состо: состоит
призна: признала
поддержива: хайбабайе
включ: включая включ
евросоюз: евросоюза
хорош: обеспечило
путаниц: путаница
оператор: абонентов
опира: опираться
социальн: социальные объявила
наш: нашим
ит: борту
пользовател: пользователи пользователей
мног: многих скорости
уинфр: уинфри
плат: плат
светофор: светофор другом светофоры светофоров светофора
язык: настройка
криптовалют: криптовалюты
фон: сотовая
умн: умные
останов: автономный означало
син: синий
план: планах
снял: варианту
борт: камня
сервис: сервисы
стил: стиле
сит: каналах
информац: информации песочница
облачн: облачные
криптобирж: криптобиржа
люд: людей
реконструирова: реконструировать
отдав: координировать
спуст: февраля
отвеча: отвечать
автономн: автономные остановитесь автономным мощность
тност: тности
объяв: объявил корпорация
использу: используя
добавлен: добавленный
интерв: рассказал
законодательств: законодательство
мессенджер: мессенджеры
обработк: обработка
создан: создания
трамп: трампа
расход: расход
производств: производство
предстоя: предстоящим
волн: волне
продаж: продажами
настольн: настольные
реклам: рекламы медийная
настольк: настолько
рассылк: рассылки рассылку
прид: прид
корпоративн: спроса услуги
рекомендац: давая
прив: использовать
рецесс: рецессии
нативн: реклама
эколог: экология
инструмент: инструментами
распространя: распространяется
ведущ: продолжайте
маск: маска
обстоятельств: обстоятельствах
сообществ: сообщества
трассировк: поддержку
австрал: корее
наня: нанять
рассмотрен: рассмотрении
союз: ложемента мс
мощност: вычислительную
воз: марсе
корабл: станции
рассмотрет: рассмотреть
электрон: электронной
стран: социальной
участ: принял
смотрет: смотреть
свет: красный
ньюэлл: гейб
запрос: запросы
консол: портативная игровые
южн: канаде
мс: союза
сист: систему
марс: работы
япон: австралии
возникнут: возникнуть
передвига: передвигаться
март: фильм
войт: аккаунт
том: тома
оживлен: оживленным
аккаунт: ланит
глав: попутчика
марк: тайтлов
состав: составит
вычислительн: использует
лан: гк
сраз: сразу
жных: жных
желт: красному
смартфон: смартфоны
проблем: проблема
бот: бот
заяв: оператора
раздел: регистрация
исследовател: исследователи
сол: итого спустя
яндекс: блоги
университет: университета
новост: новости
лучш: лучшие
перв: первые появления
космическ: союз
управля: управляют
развязок: предлагаем
перекрестк: светофорами продолжит перекрестка
приня: сити
антимонопольн: антимонопольная
поиск: поиск
возможн: возможность возможностей возможно
ос: ос
джеймс: джеймса
молод: молодых молодой
беспилотн: следовали беспилотных
планир: планирует
основ: основе
сотов: телефоны
сиквел: руководитель
буквальн: средством
харт: харта
образовательн: проекты
определ: определ
голос: голосов
смарт: смарт
судебн: судебного
топлив: топлива
пк: пк
тся: тся
фильм: документальный документального
поттер: поттер
прошл: летом
круз: круза
легков: легковым
бывш: история
гаджет: гаджеты
выпуст: выпустили
колес: друга
холмс: холмс
изображен: изображений изображения
прежн: свет
откр: открыть
способ: способен способами
илон: илона
потер: потерю
travi: travis
data: data
monei: money
ruvd: ruvds
tesla: tesla
pornhub: pornhub
deck: deck
instagram: instagram
blender: blender
cloud: cloud
twitter: twitter
tiktok: tiktok
elf: elf
swift: swift
app: app
io: ios
selectel: selectel
bluemail: bluemail
push: push
grvelvet: grvelvet
shotgun: shotgun
otu: otus
miran: miran
av: av
vk: vk
meta: meta
amd: amd
habr: habr
firstvd: firstvds
tmsc: tmsc
amazfit: amazfit
whatsapp: whatsapp
valv: valve
appl: apple
bsod: bsod
timeweb: timeweb
netflix: netflix
cybertruck: cybertruck
life: life
shot: shot
youtub: youtube
rock: rock
deni: denis
rss: rss
zepp: zepp
paper: paper
blix: blix
adrenalin: adrenalin
southbridg: southbridge
steam: steam
semi: semi
chatgpt: chatgpt
stabl: stable
vice: vice
tsmc: tsmc
os: os
macrif: macrif
center: center
facebook: facebook
telegram: telegram
ftx: ftx
store: store
bing: bing
stori: story
reuter: reuters
offici: official
window: windows
diffus: diffusion
georgkdeft: georgkdeft
