случ: случившаяся
говор: говорят
оценк: оценке
банк: банке
расскаж: расскажу
значен: значение
стат: стать статью статье статьи статей статья
экспорт: экспорта
имитир: имитирующих
стар: старую
мнен: мнение
составлен: составление
объясн: объясню
чанг: чанга
работ: работа работе работу работы
общепринят: общепринятой
центр: центра
показыва: показывать
сценар: сценариев сценарии
прошлогодн: прошлогодний
впечатлен: впечатление
тб: тб
человек: человека
менеджмент: менеджмент
пункт: пунктов
интеграц: интеграции
мобильн: мобильных
знакомств: знакомства
снижен: снижение снижения
публикац: публикации
скопирова: скопировать
карт: карты
макс: макс
график: графикой
подел: поделиться поделюсь
готофоб: готофобия готофобией
кристалл: кристаллов
жестк: жестких жесткие
котор: котором которым
времен: временах
адресн: адресное
эксперимент: эксперименты эксперимента экспериментов
пузырьк: пузырьком
проект: проекты проект проектами
относительн: относительно
профил: профиль
приветств: приветствую
документац: документации
дискусс: дискуссия
проблемн: проблемных
верс: версиями версию
читальн: читальный
маркетинг: маркетинг
увеличива: увеличивают
вирусн: вирусный
разобра: разобрали
прост: простой простых
трафик: трафика
рубл: рублей
зал: зал
вред: вреде
занима: занимаюсь
свободн: свободное
лиц: лиц
уровен: уровень
нов: новые новый
ног: ногах
клавиш: клавиш
внешн: внешней
медийн: медийная
анимац: анимацией
част: части частью частей часть
слож: сложилось
алекс: алексей
нну: нную
одновремен: одновременным
постоя: постоянно
отказ: отказов
системн: системного
нны: нный нные
сдела: сделать
картошк: картошки
невнимательн: невнимательность
сложн: сложный сложных
автотест: автотестов автотесты
примен: применить
дающ: дающий
пут: путем
активн: активно
пример: примерами примеров примерам примеры примера
ноч: ночи
квантов: квантовые квантовой
расположен: расположенном
персонал: персоналом
систем: системы
узна: узнать узнаем
итерац: итераций
частн: частных
недособра: недособранной
текущ: текущие текущим
перехватчик: перехватчиков
читател: читатель
метод: методы методов
машин: машинное
тохок: тохоку
процесс: процесса
видеозапис: видеозаписи
групп: группы группа
помогут: помогут
проигнорирова: проигнорирован
постепен: постепенно
хотел: хотел
написан: написание написанием
предпочит: предпочитая
подготовлен: подготовленным
неужел: неужели
подряд: подряд
помоч: помочь
бесплатн: бесплатная
помога: помогает
рынк: рынка
нрав: нравится
продвижен: продвижением
помощ: помощью помощи
современ: современного современном
ассемблерн: ассемблерный
приложен: приложений приложение приложения
разработчик: разработчики
здоров: здоровье
заключ: заключен
довольн: довольного
текст: текстом текст текста
показател: показателям показатели
желан: желаний
прочита: прочитав прочитал
средств: средства
дисциплин: дисциплина
программист: программистов программист программистом
потребова: потребоваться
борьб: борьбе
картинк: картинки картинку
битн: битное битного
фаз: фазу
механик: механики
регистрац: регистрация
убед: убедить
ситуац: ситуаций
поисков: поисковые
причин: причин
съед: съеден
упрост: упростить
цел: цели цель
павленк: павленко
лент: ленту
кажд: каждой
руководител: руководитель
миграц: миграции миграция
настро: настроить
выходн: выходного
дзен: дзен
эр: эры
множеств: множеством
коммерческ: коммерческом
директор: директор
искусствен: искусственный
завершен: завершение
загрузчик: загрузчика
использова: использовать
желез: железо
примерн: примерно
коммьюнит: коммьюнити
сюд: сюда
список: список
импорт: импорта
затронул: затронули
знаком: знакомится
энерг: энергию энергии
наглядн: наглядно
тематик: тематику
пыт: пытаясь
дизайн: дизайн
концепц: концепции
экспериментир: экспериментирую
попыта: попытаюсь
попробова: попробовал
плейлист: плейлист
так: таких
уязвим: уязвимых
баг: багами
баз: базы
техническ: техническая
дешевеют: дешевеют
заметк: заметку
контролируем: контролируемых
аналитик: аналитик
рутин: рутинного
застав: заставить
рассмотр: рассмотрен рассмотрим рассмотрена
потенциальн: потенциальные
подума: подумал
количеств: количество
соглашен: соглашение
попа: попали
встро: встроить
добав: добавить
богатств: богатство
просмотр: просмотров
содержан: содержание
методик: методика
друз: друзей
пентест: пентест
оставл: оставляя
услов: условиях
объем: объемы
интеллект: интеллект
друг: другую другим
правильн: правильно
сбор: сбора сбор сбору
тайн: тайное
дракон: дракона
компан: компаний компании
степен: степень
программ: программы
вчер: вчера
наслажда: наслаждаться
разбира: разбираем
поклонник: поклонников
фундаментальн: фундаментальной
страда: страдающие
элемент: элементы
привет: привет
поможет: поможет
отдел: отдела
дайджест: дайджестами дайджестом дайджест
использ: используют
кейс: кейс кейсов
отдельн: отдельное отдельно
гик: гиков
нелегк: нелегко
передач: передачи
реализац: реализации
тем: тему теме
применя: применяется
фрик: фриком
полн: полной полный
администрирован: администрирование
пользовательск: пользовательские
бен: бена
дэйв: дэйва
выстро: выстроить
комментар: комментарии комментариев
рамк: рамках
физик: физика физик
адрес: адресов
работа: работал работает работать
сильн: сильно
проф: профит
песочниц: песочницы песочница
услуг: услуги
блог: блоги блог
фреймворк: фреймворки фреймворков
числ: числе
плоск: плоских
несколбьк: несколбько
модел: модели
регрессион: регрессионного
сложност: сложности сложность
исправля: исправлять
привед: приведем
автор: авторы авторов автором
снижа: снижаются
футпринтинг: футпринтингом
чита: читать
масахир: масахиро
остр: острое
локальн: локальной
подход: подходов подхода подход
возник: возник
попада: попадалась
тестирован: тестированию тестирование тестирования
спрос: спроса
бизнес: бизнеса бизнесов бизнесе
выручк: выручки
внедрен: внедрения
статическ: статически
удобств: удобством
реш: решила
общ: общую
объ: объем
фоб: фобии
недел: недель
включ: включая
емкост: емкости
брокер: брокер
серг: сергей
глеб: глеб
удобн: удобные
тестов: тестовый тестовых
социальн: социальные
вдохновл: вдохновл
лайфхак: лайфхаки
редактор: редактор редакторы
жерд: жердев
чувств: чувство
нулев: нулевому
посвящен: посвященное посвященный
люб: любой
язык: языке языка
таблиц: таблицы таблиц
воспа: воспал
фактор: фактор
злоумышленник: злоумышленник злоумышленники
правд: правда
соверш: совершить
инициативн: инициативная
незапамятн: незапамятных
разб: разбил
производител: производители производителей
использу: используя
парол: пароля
зачаст: зачастую
куратор: кураторы
применен: применение применению применением
избега: избегают
самозанят: самозанятых
одн: одному
продаж: продаж
четырехглаз: четырехглазых
согласн: согласны
реклам: реклама
корпоративн: корпоративные корпоративных корпоративный
функциона: функционал
подборк: подборкой
инструмент: инструменты инструмент
инфоповод: инфоповоды инфоповодов
доклад: докладов
команд: команда команде
сообществ: сообщество сообщества
обустро: обустроить
стел: стелю
электрон: электронных
инструкц: инструкции
смотрет: смотреть
устран: устранить
снаруж: снаружи
использован: использования
выхлоп: выхлоп
поскольк: поскольку
войт: войти
конечн: конечные
аккаунт: аккаунт
сомнен: сомнения
состав: составе
генерируем: генерируемого
глаз: глаза
протокол: протокол
сраз: сразу
отложен: отложенного
подробн: подробности подробно подробностей
похож: похоже
именуем: именуемую
жела: желаемого
выпит: выпито
яндекс: яндекс
университет: университета
новост: новостей новости
перв: первую первой первые первых первого
перешагнул: перешагнул
проведен: проведение проведения
перехват: перехвату
написа: написать написал
добр: доброе
поиск: поиска поиск
изменен: изменений
основ: основе основы
образовательн: образовательные
как: какие каких каким
определ: определ
недостаточн: недостаточного
голос: голосов
кат: катом
шлюз: шлюз
встреча: встречаются
прибега: прибегать
прошл: прошлых
род: родить
реальн: реальные
гаджет: гаджеты
точк: точки
установлен: установленных
разведк: разведки
мер: меры
доказа: доказать
продукт: продуктом продукту
компьютерн: компьютерное компьютерной
улучшен: улучшению
клик: клик
найт: найти
готов: готовы
максимальн: максимальное
провер: проверить
информацион: информационная информационной
независим: независимых
образ: образом
учен: ученые
конц: конце
дорог: дорогой
предлага: предлагаю
блендер: блендеру
соглас: согласует
обзор: обзор
электроник: электронику
появ: появились
трудозатрат: трудозатрат
запуска: запускать
доступ: доступа
вернут: вернуться
выяв: выявить
миг: миг
сетев: сетевой сетевые сетевая сетевого
колосс: колосс
александр: александр
схем: схема
легкомысл: легкомыслия
загружен: загруженных
п: п
хакинг: хакинг
показа: показана показать показали
поэт: поэтому
сочн: сочный
мин: мин
редактирова: редактировать
одинок: одиноко
сбыва: сбывается
памят: памяти
мир: мире мир миру
писа: писать писал писали
исследован: исследование исследования
приручен: приручение
совершен: совершенный
безопасн: безопасностью безопасность безопасная безопасности
диск: дисков диски
скор: скором
феврал: февраля
версион: версионная версионной
сообщен: сообщение сообщений
телепортац: телепортации
шутк: шутка
приобрел: приобрела
вложен: вложения
перевод: перевод
несут: несут
одиночеств: одиночества
провел: провела
майнер: майнеров
тестировщик: тестировщикам тестировщиков
списк: списками списка списки
телепортир: телепортируют
час: час часов часа
чат: чат чате
индустр: индустрии
могл: могли
хотт: хотта
повышен: повышением повышение повышения
жарен: жареной
больш: большей
предполож: предположил
карьер: карьера
инженер: инженеры инженеров
направлен: направление направленная
игр: игры
полезн: полезные полезных
ясн: ясным
видет: видеть
развернут: развернуты
отказоустойчив: отказоустойчивость отказоустойчивости
плавн: плавно
департамент: департамента
жизн: жизнью жизни
сформирова: сформированный
аутентификац: аутентификации
пыта: пыталась
затрон: затронем
хохл: хохлов
основн: основной
микросервис: микросервисов
гейт: гейта
вышл: вышло
сможет: сможет
основа: основанных
отб: отбились
сознан: сознания
привест: привести
входн: входных
провод: проводить проводит
средн: средний
вакуум: вакуум
шата: шатают
носител: носителей
хаб: хабы
описан: описание
повыс: повысить
сорс: сорс
результат: результат результаты
опыт: опыту опыте
полож: положил
наполнен: наполнением
заговор: заговор
настройк: настройка
дал: далее
контекст: контексте контекста
накопител: накопителей накопители
сортировк: сортировке
документ: документы
прочтен: прочтение
карма: карман
позволен: позволения
ссылк: ссылки ссылку
жертвова: жертвовать
дан: данных данной данную дано данная
сподвигл: сподвигла
дат: дать
джет: джет
указа: указать
привязан: привязанности
код: код кода
живш: жившим
модул: модуль
сократ: сократить
дефицит: дефицита
пайчарм: пайчарма
митап: митапе митап
функц: функций функции
новостн: новостную
построен: построения
новичк: новичкам
предлож: предложен
доступн: доступные доступность
возника: возникает
границ: границах
продемонстрирова: продемонстрированы продемонстрировать
редирект: редиректов
чатгпт: чатгпт
минимум: минимуму
разбор: разбором разборе
покупа: покупают
увидел: увидел
обнов: обновить
свитер: свитерах
объект: объект объекте объектов
разработк: разработкой разработка
закладк: закладки
паден: падение
настроек: настроек
увидет: увидеть
экспертн: экспертного
руководств: руководство
преимуществ: преимущества
пост: посте
обеспеч: обеспечить
завест: завести
дел: делятся
вопрос: вопрос вопросы
рассказа: рассказать
жит: жить
сохраня: сохранять
эрик: эрика
цитат: цитаты
устройств: устройство устройства
пришел: пришел
размер: размер
хакер: хакеры
ваш: вашу
суперлайфхак: суперлайфхаков
проход: проходит
изучен: изучении
никт: никто
несовершен: несовершенны
пространств: пространство
полност: полностью
проектирован: проектирования проектирование
собствен: собственном
ручн: ручным
суток: суток
алгоритм: алгоритмы алгоритмов алгоритма
материал: материалов
глинян: глиняных
вентиляц: вентиляции
мегапроект: мегапроекты
хабр: хабр хабра
калабин: калабин
обучен: обучение
интроверт: интроверту
посмотрет: посмотреть
мысл: мысли
практик: практике
последн: последние последний
искрен: искренне
месяц: месяцев месяц
сам: самая самое
бд: бд
стартап: стартап стартапам стартапа
туториа: туториал
возвраща: возвращается
жанр: жанрах
выполнен: выполнения
управлен: управление управления
сиайк: сиайку
уважа: уважаемое
удобочитаем: удобочитаемостью
небрежн: небрежность
сбо: сбоям
тарелк: тарелка
вер: верю
постел: постель
прогноз: прогнозы прогноз
популярн: популярное
вс: вс
покаж: покажу
ускор: ускорить
дич: дичи
научн: научно
плагин: плагинов
сво: своими
веб: веб
программирован: программирование программировании
распределен: распределенных
нача: начал
первостепен: первостепенное
непониман: непонимания
специалист: специалист специалистам
порог: порог
просто: простоя
станов: становится
гк: гк
тест: тесты тест
атак: атаки атак
значительн: значительным
истин: истинная
возникл: возникли
явля: является являющая
стрим: стрим
появлен: появлении
выступлен: выступления выступлений
теря: теряют
руперт: руперта
развит: развитие
первичн: первичный
сайт: сайта сайтов
научпоп: научпоп
технолог: технологий технологию технологии
продолж: продолжить
файл: файлов файлы
различн: различных
хвата: хватает
нейросет: нейросетей
сегодняшн: сегодняшнего
ледн: леднев
посвящ: посвящена
вин: вина вино
нног: нного
зовут: зовут
истор: историй истории
довер: доверию
ещ: ещ
сер: серии
сет: сети сетей сетями
конфиденциальн: конфиденциальность
сканер: сканер
защит: защиты защиту
чуж: чужого
инфосистем: инфосистемы
аномал: аномалия
договор: договор
натравлива: натравливаются
хот: хотят
зябк: зябко
хоч: хочу
рейтинг: рейтинга рейтинг
известн: известных известные
структурирова: структурировать
горяч: горячих
поток: потоки
интеграцион: интеграционного интеграционное интеграционные
поддержк: поддержка
остальн: остальное
угодн: угодно
платя: платящих
дня: дня
модульн: модульные
стоимост: стоимости
предназнач: предназначена
пуст: пусть
ид: иду
любим: любимый
ин: иной
наш: нашего нашей
улучш: улучшить
ит: ит
суммарн: суммарной
пользовател: пользователей
просьб: просьбой
компонент: компонентов компоненты
над: надеюсь
издел: изделия
разрабатыва: разрабатывать
попроб: попробую
публичн: публичных
сервис: сервисов
евген: евгений
информац: информацию информация информации
схож: схожих
станисла: станислав
боязн: боязнь
впуст: впустую
выгляд: выглядят выглядит
анализ: анализа анализ
мейер: мейера
стенд: стенд
пет: пет
теоретик: теоретик
обработк: обработка обработкой
сериа: сериала сериал
черн: черного
собра: собрали
например: например
артем: артемьев
самостоятельн: самостоятельно
увеличен: увеличением
вращен: вращение
соответств: соответствия
запуск: запуска
нативн: нативные
надежн: надежности надежность
огромн: огромные
польз: пользуются
рассмотрел: рассмотрели
похожест: похожести
стран: странных
включа: включает
сист: систем
япон: японии
качеств: качества качестве
распредел: распредел
форвард: форварда
лан: ланит
проблем: проблемы проблема
обнаружен: обнаружения
стейк: стейк
сервер: сервер
баланс: баланс
раздел: разделы
автоматическ: автоматически
сол: соло
аббревиатур: аббревиатура
выигрыва: выигрывают
лучш: лучшая лучшие
незнан: незнания
небольш: небольшое
дума: думаю
формат: формату
облегч: облегчить
побежда: побеждают
интересн: интересна
возможн: возможность возможности возможных
оп: опен
этичн: этичный
сортировок: сортировок
твердотельн: твердотельных
открыт: открытых
буквальн: буквально
проникновен: проникновение
неполн: неполной
крут: крути
бока: бокал
меша: мешает
взгляд: взгляд
потряса: потрясающих
круг: кругу
архитектур: архитектура
изображен: изображений изображения
контент: контент
откр: открыл открыть
источник: источников
css: css
sourc: source
obojealexand: obojealexander
pt: pt
ruvd: ruvds
ssd: ssd
intellig: intelligence
wysiwyg: wysiwyg
actiontext: actiontext
assembl: assembler
qa: qa
twitter: twitter
java: java
honyaki: honyaki
testcontain: testcontainers
action: action
ib: ib
text: text
trix: trix
testserv: testserver
posit: positive
ik: ik
python: python
freehabr: freehabr
ai: ai
normalisht: normalisht
makasin: makasin
node: nodes
otu: otus
habr: habr
rl: rl
firstvd: firstvds
engin: engineer engineering
offlinecrm: offlinecrm
mitig: mitigator
youtub: youtube
sd: sd
rss: rss
goto: goto
geonod: geonodes
southbridg: southbridge
chatgpt: chatgpt
kali: kali
dimitryabramov: dimitryabramov
bubbl: bubble
jethabr: jethabr
twitch: twitch
greiv: greiv
facebook: facebook
geometri: geometry
enterpris: enterprise
rabbitmq: rabbitmq
esc: esc
tl: tls
maycod: maycode
chao: chaos
open: open
asp: asp
sivchenko: sivchenko
soc: soc
rostislavdugin: rostislavdugin
cybercamp: cybercamp
blender: blender
mode: mode
cloud: cloud
technolog: technologies
ui: ui
scoff: scoffs
net: net
group: group
zetroot: zetroot
selectel: selectel
rail: rails
sort: sort
markati: markaty
rous: rouse
translat: translate
core: core
ingirov: ingirov
petrtamozhnii: petrtamozhniy
vk: vk
pycharm: pycharm
skillfactori: skillfactory
timeweb: timeweb
sergo: sergo
linux: linux
osint: osint
recoveri: recovery
dto: dto
crm: crm
delphi: delphi
stabl: stable
hdd: hdd
apiset: apiset
telegram: telegram
ddo: ddos
django: django
footprint: footprinting
window: windows
aykuli: aykuli
rubi: ruby
diffus: diffusion
