максимальн: описывается
готов: директивами
информацион: информационные информационных
фактическ: фактически
оттуд: оттуда
расскаж: расскажем расскажу
образ: образом
ивент: ивентов
стат: стать статье статьи статья
стар: новом вернуться избавляться
рабоч: рабочих
конц: легаси конце
перееха: переехал
мнен: мнение
маленьк: маленький маленькая
обзор: обзор
пропускн: пропускной
работ: работа работы работе
показыва: показывают показывать
доступ: доступа
наряд: наряду
вернут: поддержка
сетев: сетевая
инфраструктур: инфраструктурой инфраструктуры инфраструктура
сто: стоит
учебн: учебных
приятн: приятным приятные
схем: схем
коммуницир: отдельно
вообщ: версионировать
менеджмент: менеджмент
интеграц: интеграции
прототипирован: ненормальное
вкратц: вкратце
ошибок: ошибок
структур: структуру
публикац: разделы
скопирова: скопировать
график: графика
подел: поделиться поделимся
поэт: поэтому
котор: которому которыми
выгрузк: выгрузкой
мин: мин
вариант: вариантов
исследован: исследование
стриминг: стриминг
прав: правило правах
кухн: кухне
связа: связанно
проверя: поверьте
сниппет: сниппетов
проект: проект работаю проекте фуллстек десятки проектами проекта
связ: связи
феврал: феврале
классическ: добавился
профил: профиль
дела: делаем
столкнут: столкнуться
байт: байт
аналог: редактор
кэширован: кэширование
получ: хитростей
вложен: вложения
фуллстек: классические
перевод: перевод
верс: старой старую
важн: важнейших
провел: провели
маркетинг: маркетинг
списк: списке списка
комфорт: ним
рук: руки
избавля: мся
час: часов
чат: чат
прост: простой простое
прием: приемов
градиентн: сервере некоторых
чаш: чаше
ауд: аудио
рубл: рублей
зам: замены
здравств: здравствуй
индустр: индустрии
занима: занимаюсь
свободн: свободное
сплошн: градиентов
могл: комфортом
ощуп: ощупь
движен: движением
повышен: повышением
уровен: уровень
нов: новые новых поговорим
губан: данил
внешн: внешних
медийн: корпоративный
част: часть
иде: идея
ждат: ждать
карьер: карьера
аналогичн: аналогичные
полезн: полезных полезные
мультиязычн: мультиязычных
сдела: упростить сделано
доставк: доставки
определен: определенный
отзыв: отзывами
особен: особенностях
видет: видеть
грязн: грязных
сложн: сложный
хитрост: множество
представлен: представленных
поработа: поработал
плавн: плавно
генерац: генерации генерация
видел: видел
совет: советы
примен: применить
пут: пути путь
композиц: зно
пример: примера
версионирова: обсудим
хранилищ: хранилищ
итогов: итоговый
систем: система системы системах
кастомизирова: кастомизировать
упрощен: аналог
полноцен: полноценных
момент: момент
основн: основной основная
вышл: вышло
текущ: текущие текущим
ресурс: ресурсов ресурсы
процесс: процессов процесс
отб: отбились
скрыва: скрывается
помогут: помогут
свойств: конкретного
психологическ: приложение
приступа: приступайте
привест: привести
решен: решение решения
хотел: хотел
написан: написанию
актуальн: актуальных
мифл: олег
средн: средний
подряд: подряд
бесплатн: бесплатны
хаб: публикации
рынк: рынка
нрав: нравится
продвижен: продвижением
помощ: помощи помощью
хак: хаков
приложен: приложений приложения разработать
интернационализац: интернационализации
результат: результата
разработчик: губанов разработчиком
продвинут: продвинуться
красив: красивых
полож: положил
довольн: довольного
реализу: реализуем
настройк: настройки дзен
вклад: сюда
дал: далее
текст: тексты текст текста
показател: показателям показатели
самар: самаре
богат: богатые
последовательн: последовательно
сортировк: сортировки
документ: компаний
прочтен: прочтение
желан: желаний
карма: карман
фронтэнд: фронтэнде
ссылк: ссылка ссылку
серверн: достаточно
затащ: затащить
прочита: прочитал
немецк: немецком
памяток: памяток
интерес: интересует
агент: агентом
дан: данные данными данной данная прототипирование
программист: программист
фильтрац: фильтрации
пагинац: пагинацией
картинк: картинка
наслуша: наслушавшись
плох: плохие
станет: станет
код: код коде кодом кода существования
рост: ростом
регистрац: аккаунт
ситуац: ситуациях ситуацию
имеет: имеете
медлен: медленной
митап: митап
счита: считается
отсутств: боль
упрост: максимально
внесен: хранение
используем: используемых
загрузк: загрузки
мся: разбер
цел: поскольку
старт: стартом
новичк: новичка
отлича: отличаются
версионирован: готовим отсутствия
изолирова: изолированные
звуч: звучит
старш: старшим
валидац: валидации
кажд: каждой
шаблонизац: шаблонизация
настро: настроить
российск: российского российском
дзен: яндекс
множеств: теме
вмест: вместе
финансов: финансовом
разбор: фреймворках
создава: создавать
отличн: отличным
утилит: утилиту утилиты
кажущ: кажущейся
обнов: обновить
разработк: разработкой разработке разработку разработка разработки
серьезн: серьезность
закладк: закладки
использова: использовать
настроек: настроек
разработа: панов таблицу
увидет: увидеть
фрагмент: фрагментов
вебсокет: предоставляющий работающий
достаточн: базового
примерн: примерно
установк: установка установки
добавля: добавлять
отечествен: отечественном
сюд: поехали
карьерн: карьерные
список: список
пост: любом
замечательн: замечательной
минут: минут
след: следующие следующим
напомн: напомню
дел: делятся делится
строк: строк
организац: способов организации
вопрос: задают
дизайн: дизайн
рассказа: рассказано рассказать
студ: студию
жит: версии
эрик: эрика
внедря: внедрять
внутрен: внутренней
устройств: песочница
пришел: пришел
попробова: попробовал
упихнут: упихнуть
размер: размере
клиент: клиентов
бэкенд: фронтенд
ваш: вашей вашему
так: такую такого таких
изучен: изучении
срок: сроки
сталкива: сталкиваемся
грабл: грабли
оптимальн: оптимальную
техническ: технической языка
манипулирован: манипулирования
суток: суток
консультирова: консультировать
существован: конца
фев: фев
расширен: расширения
заметк: заметка
материал: материалами материале
товар: товаров
собира: собирались собирать
мегапроект: стартапам
описыва: редакторы описывает
хабр: хабр
обсуд: организовать
некотор: некоторый градиент
вебсайт: вебсайтов
авторизац: авторизации
подума: подумайте подумал
зно: серь
удивительн: удивительно
количеств: количество
введен: создание
соглашен: документы
кратчайш: кратчайшие
добав: финтех добавить
просмотр: просмотров
мысл: мысли
содержан: содержание
практик: практики
последн: последнее последние
друз: друзья
месяц: месяцев месяц
сам: самый самое самая самых
представля: представляю
стартап: стартапах стартапе программы стартап стартапа
друг: коммуницируют друг друга
возвраща: возвращается
туториа: туториал
ознакомлен: цель
приход: приходится приходилось
израил: израиль
организова: избежать
смежн: смежных
абсолютн: абсолютно
развертыван: развертывании
компан: компании устройство
рассказыва: рассказываем
программ: образовательные
управлен: способе управление
вчер: вчера
предназначен: предназначению
разбира: разбираемся
лендинг: быстро
ненормальн: точка
предполага: предполагается
начина: начинающий
привет: привет
вс: вс
популярн: популярных
покаж: покажу
начн: начнем
визуальн: визуальное
имеют: имеют
использ: используется используются
спикер: спикеров
простот: простотой
цвет: сплошных
созда: возможно созданная
учетн: учетными
сво: своими свой
веб: веб
помн: помнить
кейс: кейс
программирован: программирование
распределен: распределенная
нача: начать начал начался
отдельн: живут
реша: решать
порог: порог
нелегк: нелегко
предоставля: потребуется
валидатор: валидатор
хранен: хранения удобным
гит: гита
плеч: пишу
явля: является
виктор: виктор
туториал: туториале
тем: тему посте
тен: градиентные градиентных
выступлен: выступлений
спроектирова: спроектировать
легас: жить
руперт: руперта
администрирован: администрирование
развит: развитию развитие
спаст: спасти
тимлид: тимлидом
сайт: сайта сайте сайтах сайтов сайт
десят: проектом
знан: знания
контрол: контроля
дэйв: дэйва
научпоп: научпоп
технолог: технологию применения
комментар: комментарии
файл: файлах
ускорен: ускорения
пользова: пользоваться
сотрудник: сотрудникам
различн: различных
поеха: пойдет
хвата: хватает
прош: прошу
работа: работаем мифле работает могли виде
песочниц: хабы песочницы
лоскутн: лоскутный
сегодняшн: сегодняшний сегодняшнего
пан: герман
пар: пару
услуг: конфиденциальность
директив: управления
базов: базовый чистым
треб: требует
пособ: пособий
блог: блог
необходим: необходимые необходимостью
фреймворк: версионирование
истор: истории
зовут: введение
автоматизац: автоматизация
зрен: точки
чист: ознакомление
модел: модель
пробл: проблем
сложност: сложности
ещ: ещ
вниман: вниманию
автор: авторы авторов автором
функционал: функционалом
сер: тенях
чита: читать
легк: легким
сет: сети сеть
вид: видит упрощенном
конфиденциальн: соглашение
профессиона: профессионала
виде: видео
отдач: отдачей
локальн: локальную
подход: подхода зрения подход
экосистем: экосистемы
теор: теория
быстр: инструментах
бизнес: бизнеса
влия: влияет влияют
хот: хотят хотим хотите
тип: типа типы
позволя: позволяющей позволяющую
выручк: выручки
хоч: хочу
внедрен: внедрению
рейтинг: рейтинг рейтинга
статическ: статических
скорост: скорость
переезд: переезд
реч: речь
реш: решила
способн: способности
олег: организацией
структурирова: структурировать
поток: потоки потока
предостав: предоставят
поддержк: техническая
зада: заданных тени
недел: недель
платя: платящих
прилага: прилагается
глубок: глубокой
дня: дня
доб: добился
предназнач: предназначены
хорош: хорошие
библиотек: библиотеку библиотек библиотеках библиотека библиотеке
ид: иду идей
удобн: сделать
сред: среди
тестов: тестовых тестового
комплексн: комплексную
может: можете
редактор: табличный контент
суммарн: суммарной
пользовател: пользователям пользователь пользователей
посвящен: посвященный
люб: проверял любого
хостинг: хостинге
директ: композиции
потреб: серверной
избежа: испытал
язык: настройка
большинств: большинство
заказ: заказов
разрабатыва: разрабатывать
таблиц: таблицы таблицами формами
сервис: сервисы
холдинг: холдинге
свич: свичи
информац: информаций информация информации
описа: описана описаны описан
фронтенд: проекты фронтенду фронтенде
облачн: облачный облачные
латиноамериканск: латиноамериканского
правд: правда
продакш: продакшен
разн: разных
мейер: мейера
освоен: освоение освоения
натыка: натыкался
лоскуток: лоскуток
разб: разбил
герма: зовут
велосипедостроен: велосипедостроении
отталкива: отталкивались
стенд: стендов
пакет: пакет
пет: пет
конкретн: цветов
открыва: открывать
испыта: версионирования
сборк: сборку
зачаст: зачастую
обработк: обработки
применен: способами
поговор: директив
создан: создания внесение
собра: собрали
хук: хуке хуком хуков хуки
идет: идет
запис: записями
знает: знаете знает
предстоя: предстояло
битрикс: битрикс
финтех: проектов
одн: одна
самостоятельн: самостоятельно
мар: мар
согласн: согласно
живут: бэкенд
увеличен: увеличения
реклам: медийная
разбер: подходов
корпоративн: услуги
функциона: функционал
соответств: соответствующий
нативн: реклама
инструмент: инструменты точке
доклад: докладами докладов доклады
огромн: огромное
команд: команды команда
локализац: локализация
сконцентрирова: сконцентрироваться
познаком: вебсокетов
десятк: плечами
уровн: уровня уровней
использован: использовании
отлич: отличиях
платформ: платформы
запрос: запросов
поскольк: браузерах
вследств: вследствие
сист: систем
стилизац: стилизация
войт: войти
качеств: качестве
аккаунт: лучших
прошел: прошел
табличн: табличными разработаем
глаз: глазу
участк: участков
счаст: счастью
выбор: выбора
градиент: похожее создать
пиш: десяти
проблем: проблемы проблемой
подробн: подробно
репозитор: репозиторий
опытн: опытный
сервер: сервера вебсокетами
раздел: регистрация
похож: похожие получить
сол: соло
замедлен: замедленной
яндекс: мегапроекты
новост: новости
лучш: вклад лучшие
существ: способы существует
перв: первое
перешагнул: перешагнул
дума: думали
бол: другом
добр: доброго
пойдет: психологической
поиск: поиск поиске
изменен: изменений
возможн: возможности возможностью вопрос
интересн: интересно интересной
оп: опыт
дальн: дальнейшей
ремн: ремни
основ: основе
поверьт: свойства
ленив: ленивый
выбра: выбранного
открыт: открытия
фудтех: фудтех
образовательн: образовательных нативные
как: каких какие
участник: участников
функциональн: функциональных
поначал: поначалу
голос: голосов
страниц: страницу страницы страниц страницам
содерж: содержится содержит
покрыт: покрытием
кат: кат
меша: мешало
рассматрива: рассматривали
площадк: площадке площадки площадку
встреча: встречаю
потряса: потрясающих
прошл: прошлой
прежд: прежде
добавл: добавлен
архитектур: архитектура
выпуст: выпустил
контент: контента работать
изображен: изображения
точк: разработчик существуют кодить
стандартн: стандартным стандартные
откр: открыт открыть
способ: разбор вообще старом познакомиться
форм: лендинг
насмотревш: насмотревшись
справля: справляться
браузер: технологии
пристегн: пристегните
улучшен: улучшение
конференц: конференции
css: css
sourc: source
ruvd: ruvds
react: react
twitter: twitter
hook: hook
dev: dev
faq: faq
api: api
boumrz: boumrz
gener: generator
modul: module
cdn: cdn
manag: management
javascript: javascript
push: push
asimov: asimov
node: node
angular: angular
rostbutaev: rostbutaev
useinsertioneffect: useinsertioneffect
habr: habr
cmg: cmg
feder: federation
tabl: table
librari: libraries library
ru: ru
skyeng: skyeng
aio: aio
bright: bright
js: js
youtub: youtube
thisprogam: thisprogame
notion: notion
rss: rss
vite: vite
rko: rko
typescript: typescript
gabend: gabend
cd: cd
alizar: alizar
svg: svg
thoughtspil: thoughtspile
ci: ci
facebook: facebook
store: store
commerc: commerce
pull: pull
googl: google
php: php
samoi: samoyed
dmitri: dmitry
open: open
alexzfort: alexzfort
extern: external
rostislavdugin: rostislavdugin
bezrukov: bezrukov
reactj: reactjs
cloud: cloud
vuej: vuejs
school: school
websocket: websockets
yurii: yuriy
mdlufi: mdlufy
mf: mf
html: html
scoff: scoffs
itglob: itglobal
symfoni: symfony
glendemon: glendemon
nginx: nginx
edtech: edtech
vd: vds
translat: translate
skypro: skypro
vk: vk
grokru: grokru
sergeevich: sergeevich
devtalk: devtalks
code: code
skillfactori: skillfactory
timeweb: timeweb
bitrix: bitrix
content: content
network: network
grigoryvp: grigoryvp
json: json
sheet: sheets
olegmifl: olegmifle
backend: backend
ws: ws
olegbunin: olegbunin
shasoftx: shasoftx
unixspv: unixspv
nixi: nixys
crm: crm
bandityp: banditypes
usesyncexternalstor: usesyncexternalstore
gmtd: gmtd
telegram: telegram
npm: npm
spectr: spectr
pronskii: pronskiy
ilusha: ilusha
deliveri: delivery
xaoccp: xaoccps
