говор: говорите приходится
тридца: группы
понима: понимаю научившимся
стат: стать
обычн: обычная
оказа: несоответствие
стар: вернуться
рабоч: среднем
стал: проще
мнен: карточки совпадало расходились мнение
указан: указания
превыша: превышает
един: единого
повторя: повторяет
работ: мощь алгоритм
заход: первые
показыва: поиска молодым
деска: дескать
нка: нка
упрощ: машинами
под: пода чиновники
касс: переводчики
пол: полов
размеща: размещал
человек: человека общении
критическ: критически
тз: пишу
менеджмент: менеджмент
пункт: пунктом
лес: приятель
интеграц: вед
каса: аспект
пробел: пробелами
должн: должна
суд: судя
публикац: разделы
скопирова: скопировать
студент: группах
прогер: расходов
график: графике
человеческ: выглядит понимать
жестк: жесткий
холст: кусок
котор: которую которым язык которыми
уб: убь
ув: непонятно
времен: менты
осозна: осознать
изображ: карточку линия
эксперимент: человечески
пош: лесника
прав: право
кухн: п
бакс: отказался
обратн: обратное
подкручива: подкручивают
капч: короткоживущий
внезапн: внезапно
двига: двигается
проект: строк рода сложного проанализируй
ушл: баксов
профил: профиль
дела: делает соединяю бросаешь делать функции
лим: сожалению
сут: формулировать
извн: извне
верн: тов
режим: бывают
сводк: реддитам
полага: эксперта
тактичн: раза
верс: старую веб
маркетинг: маркетинг
подкручиван: подкручивания
прост: простой добавлял
альтернатив: альтернатива альтернативы
лин: вертикальная изображено совпадение
позвол: проверить
языков: больших видно
проверк: проверки якобы
ложн: выступить оказались
предупред: конец
карточк: первой линий показывали
уровен: уровень
очевидн: ложный очевидно очевидная карточках
нов: открыл абсолютно невозможным придумывать
медийн: блог
част: части часть
нок: нок
цифров: цифровой цифрового
всмотр: всмотритесь
слов: слова слово области
нну: нную
нны: нные
якоб: приглашали
сдела: н сомневаюсь
особен: особенности
сложн: решать помощь нанять
пример: примеры пример примере
синтезирова: синтезированные
подверж: подвержена
систем: спросом
процедур: подобная
узна: узнаем
итерац: первая
персональн: представьте
сожален: премиум
бесед: беседах беседы беседу
текущ: текущему задачи
конформизм: изучение
машин: существующем языках примитивными
аппарат: ожидали
групп: группу контрольной конформизма групп находился
окружа: окружающий
нных: упрощ
помога: текущем
нрав: нравятся нравится
современ: современном
помощ: пишется программиста
художествен: уровне
лог: грепа
гугл: гугл гугле запустить гуглу
приложен: сетей
лож: ложится ложь
разработчик: разработчиков разработчики
лоз: лоза
выступ: готовы
вычислен: памяти
попытк: попытки
отступ: отступы
броса: момент
текст: хороший
онлайнов: закону говорить
наоборот: наоборот
соединя: написал
выделен: выделенную
нуж: нужен
вертикальн: изображена
калькулятор: нету имея
эволюционирова: станет
считыва: дроны
средств: человеческий
программист: нанимал полагаю вангую
придумыва: проектов придумывает
отключ: дверью
минимальн: минимальной
закон: увы бизнесу
плох: плохо плохой
помог: грабят
регистрац: войти
извод: извод
допуст: тридцать голанг
ситуац: ситуации ситуацию ситуация
выдач: выдачи ограниченная
фирм: каждой
цикл: построенный
счита: считайте считают
беседова: чат
отсутств: отсутствуют отсутствии отсутствие
конкурент: конкуренты
заменя: простые
шедевр: холста
отменя: отменял
проанализир: языка
кажд: входа каждого
пройд: вычислений
настро: настроить
дзен: яндекс
искусствен: искусственный
отличн: отлично
параллельн: техническую
спор: споров спорю спорить
всяк: логов
налич: наличие
прекрасн: прекрасном
желез: популярными
юр: юрий
примерн: примерно
сказк: основном
добавля: выводы
професс: профессии
список: список
сочин: нынешний искусства
знаком: знакомые
терминолог: терминологии
контрольн: ложными
след: следующая следует следующее
ерунд: ерунда
напомн: половину
строк: слов допустим строке
дизайн: дизайн
невозможн: сделает
помим: вторых
попробова: прогера
непорочн: непорочное
так: такую таки работы таким взлететь
кардашья: кардашьян
общен: ровно
трансатлантическ: райт
поработ: поработит
абориг: аборигена
оптимальн: точнее
техническ: настройка выполняет
условн: условная
хран: фотографии
удовлетворен: удовлетворения
разниц: разница
заметн: платным заметной
откуд: откуда
рутин: проекта
некотор: некоторая некоторых некоторые
обуча: персональных
соглаша: поправляли
количеств: количество
соглашен: документы
собеседник: хорошему
диалог: истории
добав: забавно добавить
просмотр: просмотров
нанима: понравилось нанимать
зна: знаю знаем
объем: работает
интеллект: интеллект
дайнэмикс: бостон
виртуальн: виртуальной
друг: другому другим другую другу
закр: закрыл
искажа: искажает
приход: облаках
выглядет: выглядеть
сингулярн: сингулярность
правильн: первых правильным научится называли
сомнева: ценности
степен: степени
рассказыва: рассказывали
компан: хабы авторов
ограничен: ограничений фундаментальное питоне ограничения заметно
программ: образовательные
склоня: склонять
получа: диалогов месяц
голодн: волки
главн: главную главное
разбира: разбирается
фундаментальн: насколько
разрабытыва: специализованные
рас: рас расам
приезжа: ограбили
увол: сервис
имеют: имеют
визуальн: очевидное
вручн: полностью
раз: снижалась
кусок: превратит
стол: столь
испытуем: мнения зрения независимых несмотря
интернет: интернет
оригинальн: изменений
оптимизац: учитывать
тем: темы
сработа: новую
бега: оптимальный
поправля: верно
администрирован: администрирование
столет: столетиями
фотограф: пользователей
определя: многом
выстро: выстроить
знал: знал
бер: бер
плеяд: скоро
комментар: комментарии комментарий
поставлен: поставленный
прощ: притом
детал: деталях
работа: мура
сильн: мере
прос: просили
песочниц: авторы
подсказк: уходит
услуг: конфиденциальность
подписчик: подписчиков
оставля: полноправные
несоответств: визуальное
подведен: учитывались
блог: корпоративный
плоск: плоская
числ: числе
прод: всяких
подходя: ящык
модел: модели модель таких
требуем: прежде
дрон: вылетают
сложност: сложности
найдут: надеясь
пойт: пойти
полноправн: совершенно
шут: король шутить
видн: помимо
автор: компании сайта автором
снижа: совершения
очеред: очередь
чита: читайте читал
локальн: локальные доступен
пойд: куплет
явн: системы
реб: реб
оценива: оценивали
нынешн: убеждение своему
быстр: написать тз
эксперт: оператор напомнило
спрос: определяется
бизнес: хотят
короткоживущ: версией
эстрадн: эстрадная
реч: речь
реш: никаких
экспонент: экспоненте
вынос: фатальна
общ: общем
райт: братьев
недостатк: фатальном
самообслуживан: кассы
совпада: дискомфорт
зада: эксперт
хайп: хайп
хозяин: х
шуток: шуток
википед: википедии википедию
оператор: приезжает
социальн: социальную
может: можете
мног: прогресс
люб: результат любому
зависим: зависимости
язык: новый новых такого новые естественном нных
несложн: правильные
таблиц: таблица таблице
генер: генерить
правк: небольшие
правд: правда правды
гот: готов
взял: взяли
люд: людям людей
специализова: разработку
неадекват: неадекватом
отвеча: отвечать
конкретн: конкретную конкретной
открыва: открывают
ожидан: ожидание
критер: критерию
рассужда: рассуждали
облак: хранит
вывод: прод
разреша: разрешается
прич: причем прич
избега: избегает
звонок: звонок
расход: получалось допустил
волк: путника
знает: знает
прит: код
одн: варианта одну одно одним одни
широк: широкими
реклам: медийная
прид: котором
корпоративн: услуги
тов: перел
масс: массами
инструмент: инструмент инструмента инструменте
любопытн: кстати
анонимус: анонимуса
когнитивн: когнитивные
удивлен: удивления
использован: использования
запрос: получается
поскольк: несложно
неоптимальн: государством
песн: сказки
войт: аккаунт
процессор: алу
аккаунт: войдите
сраз: сразу
производ: дайнэмикс
гражданин: решит
порядк: порядку
войд: оставлять
примитивн: общаться
бот: тактичность бот
похож: похоже
половин: заменять фирме
пишет: пишет половина
вполн: вполне
яндекс: мегапроекты
корол: лесник
новост: публикации
существ: понимании любом
перв: первым первее проводилась правильный первую забывать разрабатываете размеру
приня: хозяин
написа: написанному стало написано оптимизации
добр: сделал
поиск: поиск режиме
изменен: изменение пара
ломбард: данные
равн: равно
мед: медиа
повер: поверил
образовательн: нативные
определ: определ предлагалось
как: какую
участник: линии подговоренные
голос: голосов
напомина: напоминает
рассматрива: рассматривать
тся: тся
искажен: искажения искажениям
прошл: прошлую
днях: песни
высок: контента
род: подходящий
втор: гражданин первого подпадает
лома: ошибок
точн: показывает
точк: точкой
мобильник: считываются
мифическ: мифической
способ: способен виде
мер: крайней
вирусолог: вирусолога
продукт: капча
быва: делал
найт: найти
готов: итоге мотив
провер: процессора
образ: образом
независим: мнениях
заверша: добавил
конц: думал
аспект: любопытный
предлага: помощью участникам
соглас: согласен согласитесь позволить
появ: появится
запуска: устанавливать
рейт: вменяемыми
практическ: практически
доступ: путаете
продавц: самообслуживания
мозг: мозга
вернут: поддержка
подкруч: подкручен
предел: пределах
приглаша: добровольцев
представьт: простоты
греп: запросы
вообщ: вообще
и: ии
единствен: единственным
соискател: соискателей
л: пош
преврат: симфонию
премиум: влезает
н: лес
личност: личности личность личностей
изменя: изменяет
ожида: беседовать
подпада: запускать
п: ломбардов
ошибок: допускает
прикажет: прикажете
предвз: улучшит
х: платить
ч: ч
показа: показать опыт
звезд: звезда
поэт: приложений
двер: неоптимально
мин: мин
вариант: неверного вариант выбирать
памят: объемов
мир: мире мир
писа: писать
исследован: аша исследования
совершен: вероятность разрабытываться
скор: скорее явно
конец: добрый
шутк: шутки напишите
получ: языке
аргумент: поведение
списк: вопросы
рук: окажется
час: платил часов
чат: итерация
шанс: шансов
издан: изданий
прям: прямо
отстуств: отстуствие
отнес: отнес
дискомфорт: крайний
кстат: забавное
больш: большой интеграция
миллиард: миллиардов
мест: местами
наде: домой
ммм: отключены
спрашива: испытуемого
вход: порог
опц: опцию
эффективн: самостоятельно
устанавлива: кодом
испытыва: испытуемые
представлен: представлениям
исправлен: ломает
генерац: генерация способности
видел: видели
исправ: исправиться
граб: чатжпт
опенсорс: идеале
питон: заставляю
актер: семью двум
озадач: ммм
мог: могу
переводчик: водители
сотн: сотни
момент: подсказки
принципиальн: принципиально существует
пообща: пообщаться
основн: составляющую
категор: вторую
поднимет: сильно
авторитетн: авторитетнее
формулирова: правильно
решен: принятия решения
вменя: бесплатен
владельц: владельцы
взлетет: вручную
удив: долларов
создател: создатели
провод: процедура
личн: личные
средн: среднего правки
нужн: нужному программисты
мот: оригинальный
аккуратн: аккуратно
чиновник: продавцы
хаб: новости
описан: описании
мощ: требуемая
выбира: указывали
сорт: второго
любл: рутины
мент: государство
выполня: списку
результат: результатам чьи получить
настройк: дзен
дал: далее
забавн: готово покушать
пониман: моем
поблагодар: путник
документ: компаний
прочтен: прочтение
увер: плеяда
ссылк: ссылку
подтянув: параллельно
нежелан: нежелание
дан: данных подтянув
подела: поделать
дат: языки
короновирус: короновируса
станет: железо
код: машинном опенсорс работу быстро
зацепл: зацеплюсь
функц: оптимизировать
камер: районе
отказа: попробовал
брат: аппарата
мся: мся
убежден: мо
построен: специфично
фраз: фразу
мур: закон
рядов: рукой
дво: испытуемых
чатгпт: поэтому
инфлюэнсерш: инфлюэнсерша
тезис: тезисом
минимум: принципиальная
уход: кода
ошибк: ошибку ошибки
обнов: обновить
име: собеседнику
неверн: заведомо
разработк: средство разработка разработки
закладк: закладки
сугуб: сервисом
направл: исследование
экспертн: ощутимый
добровольц: студентов
учитыва: результаты исправлений
инфлюэнсер: инфлюэнсеры
итог: большинства подведении
совпаден: поскольку
дел: дело дела
вопрос: задает вопрос вопросе вопросов
европейц: европейца
вылета: автоматически
внутрен: внутренний
десяток: пройд
устройств: песочница
размер: соответствует
повесточк: повесточке
ваш: вашим ваших
ответ: ответа ответ ответить ответов ответы
изучен: направлено
никт: никто
обществ: общества общество
полност: прид
несмотр: варианты
творческ: влияет
собствен: собственно
идеал: продуктом
измен: изменен изменить
понрав: онлайн
правдоподобн: правдоподобно
чатбот: чатбот чатботу чатбота
дообуча: дообучается
алгоритм: быстрый
дет: детей
мегапроект: стартапам
хабр: хабр
снима: снимается
пишут: пишут
арест: производят
обща: коде
ал: калькулятор
ам: ами
посмотрет: посмотреть
подговорен: захода
район: мобильники камер
последн: самую озадачил
аш: эксперимент
месяц: час
сам: самый спрашивали
настраива: настраивать
стартап: программы
шизофрен: шизофрению
оказыва: оказывается
подобн: подобные последнюю
абсолютн: предлагают
называ: участники
вероятн: вероятности двое
трезвон: трезвонить
управлен: кухне
толерантн: толерантной
характер: характер
принят: цикл
куплет: завершающий
уважа: уважаемый уважаемые
допуска: показал
представл: представлены
складыва: складывается
вед: согласиться
смысл: смысле
фатальн: сервиса онлайновость
начина: начинает очевидным начинают начинается
очередн: очередной
вер: верить верит
прогноз: прогнозы
популярн: станут популярном
вс: вс
лимит: рейт
заведом: придерживаться
област: сложно
элементарн: элементарном
простот: уволят
окажет: моделей
сво: предвзят свой
веб: ограниченной
программирован: языков
реша: решает эффективно
симфон: сочинит
порог: поднимет
фишк: фишкой
забыва: помогать
реализ: языковая
рывк: рывками
явля: является
появлен: человеком
сверхразум: сверхразум сверхразуму
хайпов: хайповом хайповый
зачат: зачатие
ощутим: лимитами
представ: представим
сайт: устройство сайт
станут: уверен
научпоп: научпоп
задач: задачу сложные
придержива: единогласно
путник: предупредил голодны
спаса: спасать
различн: различных различные
задан: задание
ценност: художественной
перел: трансатлантических
пар: английском
искусств: шедевр
базов: базовые
вин: касался
наброса: днях
истор: предвзятости
зрен: проверку
напиш: проекты конце
двум: одному
ящык: напиши
пробл: принять
ещ: ещ
факт: факты
внос: вносятся
довел: довелось
сем: группе
голанг: строках
вид: видится нынешнем
сет: сети языковых
эффектив: программист
конфиденциальн: соглашение
заставля: решений
науч: ушли машинам
естествен: дать
водител: нужны
реальност: реальность
повтор: повторюсь
прогресс: недостатке
влия: никак
хот: пользователи
платн: сугубо
хоч: хочу
дом: л
исправл: исправлен
способн: сочиню
известн: известный
сторон: стороны сторону
поток: потоки
пута: пользователя
указыва: актерам
чатжпт: временно
поддержк: техническая
угодн: угодно
призна: признал
тысяч: тысячи
конкурир: появление
покуша: найдут
единогласн: начинали
стоимост: стоимости стоимостей
хорош: честь набросал
пуст: пусть
опира: опираться
предыдущ: предыдущий
им: делаешь
ин: иного
улучш: сервисов
темп: сумасшедшими
ит: сводка
пользовател: пользователями большинство пользователь калькулятора рядового
плат: эффективен люблю
большинств: мнением запустите
робот: анализ
разрабатыва: проект
приятел: пойд
доллар: трачу
сервис: айтишников конкурирующих вынос онлайновости
соответствова: соответствовать
информац: информация
составля: творческую
лесник: поблагодарил текста
реддит: бегать
земл: земля
выгляд: экспертности
трач: рабочий
анализ: идет
выдума: выдуманные выдуманных
ровн: темпами
английск: шут
окаж: сорта
ко: ко
сумасшедш: эволюционировать
катастроф: катастрофе
идет: района
например: например
токен: лимит
воспитыва: воспитывают
самостоятельн: способ
запуст: локально гугла
соответств: определить
нативн: реклама
чест: боту
польз: пользуйся
наня: окажитесь
маргинализир: маргинализируют
уровн: высоком
мо: аргумент моим виной
специфичн: реализует
бостон: роботы
распредел: распредел
наскольк: сработает
государств: поди управление
онлайн: обучают
свойствен: свойственны
пиш: сути
проблем: проблемы проблема
айтишник: минимум
австралийск: австралийского
намерен: намеренно
раздел: регистрация разделе
автоматическ: помогите
ванг: итого
ограб: арест
нек: некие некую
предвзят: предвзятость имею
постправд: постправда постправды
нес: нес
небольш: делаю небольшой
дума: думаю последнего
нет: чатгпт
относ: относиться относитесь
ок: окей
примечательн: примечательно
крайн: испытывали программирования
возможн: возможно
оп: шутка
молод: итогов
бесплат: категорию
буквальн: буквально
крут: удивило
оптимизирова: круто
страниц: страницу странице
меша: мешало
взгляд: взгляд
чьи: актерами
прежд: десяток
поведен: поведению соглашался
ребенк: ребенка
контент: генерации
старад: старадь
откр: ним открыть
миллион: миллионами
наход: испытуемый
оффтопик: оффтопик
никак: проблем токенов никакой никакого
источник: источника источник источником
влеза: выдача
непонятн: ограничение
sourc: source
refus: refuse
depend: depends
sshikov: sshikov
challeng: challenging
intellij: intellij
type: types
feedback: feedback
twitter: twitter
hardcoin: hardcoin
fix: fixing
nasreddin: nasreddin
english: english
model: model
block: block
id: ide
api: api
exhibit: exhibit
moder: moderation
augur: augur
write: writes
posit: positives
instruct: instructions
work: work
ai: ai
declin: decline
ongo: ongoing
rg: rg
kenoma: kenoma
rh: rh
habr: habr
rl: rl
unsaf: unsafe
aid: aid
issu: issue
ru: ru
cautiou: cautious
dgn: dgn
youtub: youtube
rss: rss
nidale: nidalee
behavior: behavior
chatgpt: chatgpt
incorrect: incorrect
question: questions
cool: cool
facebook: facebook
blackmokona: blackmokona
vlad: vlad
expect: expect
answer: answers answer
demonstr: demonstrator
dmitri: dmitry
nonsens: nonsensical
plausibl: plausible
correctli: correctly
eager: eager
supervis: supervised
sound: sounding
mislead: misleads
blog: blog
alexdora: alexdora
ds: ds
onlinehead: onlinehead
neg: negatives
tab: tab
bias: biased
me: mes
dreesh: dreesh
rottingpolli: rottingpolly
train: training
getmatch: getmatch
ideal: ideal
gpt: gpt
fals: false
ve: ve
warn: warn
edo: edo
codec: codecity
vk: vk
http: https
collect: collect
request: requests
inappropri: inappropriate
harm: harmful
idea: idea
golang: golang
effort: efforts
compani: company
content: content
sql: sql
grumegargl: grumegargler
softwar: software
common: common
hodja: hodja
hadoop: hadoop
human: human
daddi: daddy
alexei: alexey
telegram: telegram
improv: improve
truth: truth
knowledg: knowledge
hue: hue
respond: respond
user: user
